"LSOA11NM","LSOA11CD","Age_group","Sex","2016","2017","2018","2019","2020","2016_20"
"Adur 001A","E01031349","0-4 years","Male",27,29,27,24,24,131
"Adur 001A","E01031349","5-9 years","Male",40,42,39,38,39,198
"Adur 001A","E01031349","10-14 years","Male",39,46,41,44,45,215
"Adur 001A","E01031349","15-19 years","Male",35,41,38,37,39,190
"Adur 001A","E01031349","20-24 years","Male",31,34,33,28,29,155
"Adur 001A","E01031349","25-29 years","Male",23,19,16,18,19,95
"Adur 001A","E01031349","30-34 years","Male",33,30,31,35,35,164
"Adur 001A","E01031349","35-39 years","Male",32,36,40,29,29,166
"Adur 001A","E01031349","40-44 years","Male",44,46,36,42,36,204
"Adur 001A","E01031349","45-49 years","Male",53,47,53,57,65,275
"Adur 001A","E01031349","50-54 years","Male",51,58,53,55,45,262
"Adur 001A","E01031349","55-59 years","Male",51,43,56,62,70,282
"Adur 001A","E01031349","60-64 years","Male",38,42,36,37,31,184
"Adur 001A","E01031349","65-69 years","Male",54,49,53,40,47,243
"Adur 001A","E01031349","70-74 years","Male",43,45,47,54,55,244
"Adur 001A","E01031349","75-79 years","Male",29,33,33,38,34,167
"Adur 001A","E01031349","80-84 years","Male",17,13,15,22,22,89
"Adur 001A","E01031349","85+ years","Male",11,16,16,11,11,65
"Adur 001A","E01031349","0-4 years","Female",25,21,23,23,20,112
"Adur 001A","E01031349","5-9 years","Female",27,28,29,32,33,149
"Adur 001A","E01031349","10-14 years","Female",41,42,40,43,40,206
"Adur 001A","E01031349","15-19 years","Female",27,28,32,34,33,154
"Adur 001A","E01031349","20-24 years","Female",27,26,24,22,26,125
"Adur 001A","E01031349","25-29 years","Female",29,30,27,22,27,135
"Adur 001A","E01031349","30-34 years","Female",24,21,21,21,24,111
"Adur 001A","E01031349","35-39 years","Female",40,48,50,43,40,221
"Adur 001A","E01031349","40-44 years","Female",56,53,64,63,66,302
"Adur 001A","E01031349","45-49 years","Female",45,49,39,44,44,221
"Adur 001A","E01031349","50-54 years","Female",49,52,58,61,53,273
"Adur 001A","E01031349","55-59 years","Female",49,45,40,42,47,223
"Adur 001A","E01031349","60-64 years","Female",41,43,40,43,43,210
"Adur 001A","E01031349","65-69 years","Female",63,48,47,43,44,245
"Adur 001A","E01031349","70-74 years","Female",42,52,52,51,49,246
"Adur 001A","E01031349","75-79 years","Female",31,31,41,45,41,189
"Adur 001A","E01031349","80-84 years","Female",21,23,14,18,25,101
"Adur 001A","E01031349","85+ years","Female",23,27,24,23,15,112
"Adur 001B","E01031350","0-4 years","Male",44,42,43,43,40,212
"Adur 001B","E01031350","5-9 years","Male",40,40,41,43,41,205
"Adur 001B","E01031350","10-14 years","Male",18,25,25,33,42,143
"Adur 001B","E01031350","15-19 years","Male",33,32,23,20,16,124
"Adur 001B","E01031350","20-24 years","Male",36,34,41,34,32,177
"Adur 001B","E01031350","25-29 years","Male",29,28,30,27,28,142
"Adur 001B","E01031350","30-34 years","Male",30,32,34,34,31,161
"Adur 001B","E01031350","35-39 years","Male",34,30,26,27,29,146
"Adur 001B","E01031350","40-44 years","Male",30,32,31,34,38,165
"Adur 001B","E01031350","45-49 years","Male",60,58,52,53,48,271
"Adur 001B","E01031350","50-54 years","Male",51,46,47,49,48,241
"Adur 001B","E01031350","55-59 years","Male",34,33,36,39,42,184
"Adur 001B","E01031350","60-64 years","Male",40,42,36,32,29,179
"Adur 001B","E01031350","65-69 years","Male",27,24,33,38,35,157
"Adur 001B","E01031350","70-74 years","Male",19,25,24,23,14,105
"Adur 001B","E01031350","75-79 years","Male",10,8,7,7,9,41
"Adur 001B","E01031350","80-84 years","Male",7,2,3,6,5,23
"Adur 001B","E01031350","85+ years","Male",14,15,14,16,11,70
"Adur 001B","E01031350","0-4 years","Female",34,29,26,31,31,151
"Adur 001B","E01031350","5-9 years","Female",33,38,42,47,39,199
"Adur 001B","E01031350","10-14 years","Female",37,39,38,27,29,170
"Adur 001B","E01031350","15-19 years","Female",37,39,44,51,46,217
"Adur 001B","E01031350","20-24 years","Female",34,27,24,29,37,151
"Adur 001B","E01031350","25-29 years","Female",35,37,32,33,33,170
"Adur 001B","E01031350","30-34 years","Female",38,44,42,44,36,204
"Adur 001B","E01031350","35-39 years","Female",39,48,51,59,64,261
"Adur 001B","E01031350","40-44 years","Female",40,41,40,41,39,201
"Adur 001B","E01031350","45-49 years","Female",46,45,47,42,42,222
"Adur 001B","E01031350","50-54 years","Female",52,54,53,54,48,261
"Adur 001B","E01031350","55-59 years","Female",38,38,42,46,47,211
"Adur 001B","E01031350","60-64 years","Female",38,30,28,26,32,154
"Adur 001B","E01031350","65-69 years","Female",52,56,55,43,40,246
"Adur 001B","E01031350","70-74 years","Female",20,26,25,37,41,149
"Adur 001B","E01031350","75-79 years","Female",15,15,18,18,18,84
"Adur 001B","E01031350","80-84 years","Female",18,16,15,16,14,79
"Adur 001B","E01031350","85+ years","Female",20,24,26,21,21,112
"Adur 001C","E01031351","0-4 years","Male",40,38,32,35,35,180
"Adur 001C","E01031351","5-9 years","Male",49,53,54,55,56,267
"Adur 001C","E01031351","10-14 years","Male",38,44,49,46,53,230
"Adur 001C","E01031351","15-19 years","Male",57,49,44,51,51,252
"Adur 001C","E01031351","20-24 years","Male",32,31,32,34,38,167
"Adur 001C","E01031351","25-29 years","Male",37,32,31,21,21,142
"Adur 001C","E01031351","30-34 years","Male",43,46,45,45,43,222
"Adur 001C","E01031351","35-39 years","Male",45,45,48,47,53,238
"Adur 001C","E01031351","40-44 years","Male",50,55,55,58,53,271
"Adur 001C","E01031351","45-49 years","Male",46,50,48,47,49,240
"Adur 001C","E01031351","50-54 years","Male",70,68,72,71,73,354
"Adur 001C","E01031351","55-59 years","Male",56,65,57,57,58,293
"Adur 001C","E01031351","60-64 years","Male",45,45,47,47,56,240
"Adur 001C","E01031351","65-69 years","Male",43,36,40,40,41,200
"Adur 001C","E01031351","70-74 years","Male",32,34,33,31,27,157
"Adur 001C","E01031351","75-79 years","Male",30,30,32,39,40,171
"Adur 001C","E01031351","80-84 years","Male",28,22,22,21,23,116
"Adur 001C","E01031351","85+ years","Male",29,29,27,22,21,128
"Adur 001C","E01031351","0-4 years","Female",36,33,30,34,32,165
"Adur 001C","E01031351","5-9 years","Female",50,53,45,53,51,252
"Adur 001C","E01031351","10-14 years","Female",41,37,42,46,46,212
"Adur 001C","E01031351","15-19 years","Female",34,35,34,29,37,169
"Adur 001C","E01031351","20-24 years","Female",29,26,32,32,32,151
"Adur 001C","E01031351","25-29 years","Female",31,32,26,28,25,142
"Adur 001C","E01031351","30-34 years","Female",31,31,30,29,30,151
"Adur 001C","E01031351","35-39 years","Female",60,57,47,50,47,261
"Adur 001C","E01031351","40-44 years","Female",45,45,53,58,55,256
"Adur 001C","E01031351","45-49 years","Female",70,64,60,49,50,293
"Adur 001C","E01031351","50-54 years","Female",62,69,63,70,64,328
"Adur 001C","E01031351","55-59 years","Female",55,58,63,60,61,297
"Adur 001C","E01031351","60-64 years","Female",52,52,49,59,53,265
"Adur 001C","E01031351","65-69 years","Female",34,33,30,37,44,178
"Adur 001C","E01031351","70-74 years","Female",47,50,55,45,43,240
"Adur 001C","E01031351","75-79 years","Female",43,38,37,43,43,204
"Adur 001C","E01031351","80-84 years","Female",39,49,45,48,46,227
"Adur 001C","E01031351","85+ years","Female",47,39,42,39,40,207
"Adur 001D","E01031352","0-4 years","Male",43,42,34,29,31,179
"Adur 001D","E01031352","5-9 years","Male",53,64,64,59,59,299
"Adur 001D","E01031352","10-14 years","Male",44,41,51,43,37,216
"Adur 001D","E01031352","15-19 years","Male",38,47,41,42,50,218
"Adur 001D","E01031352","20-24 years","Male",40,41,50,49,40,220
"Adur 001D","E01031352","25-29 years","Male",35,33,32,31,33,164
"Adur 001D","E01031352","30-34 years","Male",31,33,38,40,38,180
"Adur 001D","E01031352","35-39 years","Male",54,50,48,51,51,254
"Adur 001D","E01031352","40-44 years","Male",35,36,44,50,47,212
"Adur 001D","E01031352","45-49 years","Male",62,62,64,56,55,299
"Adur 001D","E01031352","50-54 years","Male",62,62,56,56,53,289
"Adur 001D","E01031352","55-59 years","Male",45,46,54,54,52,251
"Adur 001D","E01031352","60-64 years","Male",43,42,35,36,42,198
"Adur 001D","E01031352","65-69 years","Male",37,35,35,32,37,176
"Adur 001D","E01031352","70-74 years","Male",52,53,43,45,42,235
"Adur 001D","E01031352","75-79 years","Male",41,43,46,42,43,215
"Adur 001D","E01031352","80-84 years","Male",16,20,25,31,30,122
"Adur 001D","E01031352","85+ years","Male",17,17,16,13,14,77
"Adur 001D","E01031352","0-4 years","Female",35,39,39,37,39,189
"Adur 001D","E01031352","5-9 years","Female",36,34,42,43,48,203
"Adur 001D","E01031352","10-14 years","Female",39,36,33,30,26,164
"Adur 001D","E01031352","15-19 years","Female",53,57,53,49,53,265
"Adur 001D","E01031352","20-24 years","Female",19,19,23,23,20,104
"Adur 001D","E01031352","25-29 years","Female",20,21,25,22,21,109
"Adur 001D","E01031352","30-34 years","Female",46,40,43,41,45,215
"Adur 001D","E01031352","35-39 years","Female",38,39,40,42,53,212
"Adur 001D","E01031352","40-44 years","Female",47,37,36,34,35,189
"Adur 001D","E01031352","45-49 years","Female",70,71,71,66,59,337
"Adur 001D","E01031352","50-54 years","Female",69,72,77,71,71,360
"Adur 001D","E01031352","55-59 years","Female",52,49,51,53,58,263
"Adur 001D","E01031352","60-64 years","Female",43,45,47,48,50,233
"Adur 001D","E01031352","65-69 years","Female",61,62,54,48,46,271
"Adur 001D","E01031352","70-74 years","Female",52,53,55,52,56,268
"Adur 001D","E01031352","75-79 years","Female",49,50,43,44,40,226
"Adur 001D","E01031352","80-84 years","Female",27,34,34,38,43,176
"Adur 001D","E01031352","85+ years","Female",40,40,39,38,34,191
"Adur 001E","E01031370","0-4 years","Male",54,47,41,42,38,222
"Adur 001E","E01031370","5-9 years","Male",53,55,62,62,66,298
"Adur 001E","E01031370","10-14 years","Male",52,59,58,64,65,298
"Adur 001E","E01031370","15-19 years","Male",52,48,46,50,51,247
"Adur 001E","E01031370","20-24 years","Male",40,45,48,47,49,229
"Adur 001E","E01031370","25-29 years","Male",50,53,50,47,47,247
"Adur 001E","E01031370","30-34 years","Male",30,27,28,34,34,153
"Adur 001E","E01031370","35-39 years","Male",63,64,58,63,57,305
"Adur 001E","E01031370","40-44 years","Male",48,51,55,50,45,249
"Adur 001E","E01031370","45-49 years","Male",58,48,48,47,53,254
"Adur 001E","E01031370","50-54 years","Male",43,46,48,38,42,217
"Adur 001E","E01031370","55-59 years","Male",39,38,38,47,46,208
"Adur 001E","E01031370","60-64 years","Male",35,40,37,35,31,178
"Adur 001E","E01031370","65-69 years","Male",41,34,38,36,42,191
"Adur 001E","E01031370","70-74 years","Male",25,35,38,36,32,166
"Adur 001E","E01031370","75-79 years","Male",24,17,17,17,26,101
"Adur 001E","E01031370","80-84 years","Male",22,26,28,29,22,127
"Adur 001E","E01031370","85+ years","Male",17,17,13,16,15,78
"Adur 001E","E01031370","0-4 years","Female",43,37,43,47,46,216
"Adur 001E","E01031370","5-9 years","Female",46,50,46,51,44,237
"Adur 001E","E01031370","10-14 years","Female",65,57,65,57,64,308
"Adur 001E","E01031370","15-19 years","Female",55,67,60,64,63,309
"Adur 001E","E01031370","20-24 years","Female",21,19,32,34,37,143
"Adur 001E","E01031370","25-29 years","Female",34,37,35,30,35,171
"Adur 001E","E01031370","30-34 years","Female",42,39,35,34,35,185
"Adur 001E","E01031370","35-39 years","Female",53,53,61,60,54,281
"Adur 001E","E01031370","40-44 years","Female",53,51,46,55,51,256
"Adur 001E","E01031370","45-49 years","Female",55,50,51,44,48,248
"Adur 001E","E01031370","50-54 years","Female",53,59,54,61,60,287
"Adur 001E","E01031370","55-59 years","Female",53,59,65,59,70,306
"Adur 001E","E01031370","60-64 years","Female",37,32,32,38,36,175
"Adur 001E","E01031370","65-69 years","Female",43,48,50,50,51,242
"Adur 001E","E01031370","70-74 years","Female",28,31,41,42,39,181
"Adur 001E","E01031370","75-79 years","Female",21,22,18,18,21,100
"Adur 001E","E01031370","80-84 years","Female",31,26,29,29,20,135
"Adur 001E","E01031370","85+ years","Female",15,15,11,12,16,69
"Adur 001F","E01031374","0-4 years","Male",73,77,68,61,66,345
"Adur 001F","E01031374","5-9 years","Male",57,63,64,73,73,330
"Adur 001F","E01031374","10-14 years","Male",52,48,49,48,54,251
"Adur 001F","E01031374","15-19 years","Male",31,36,34,32,34,167
"Adur 001F","E01031374","20-24 years","Male",34,32,34,34,30,164
"Adur 001F","E01031374","25-29 years","Male",43,36,39,39,43,200
"Adur 001F","E01031374","30-34 years","Male",46,43,42,45,41,217
"Adur 001F","E01031374","35-39 years","Male",57,61,51,45,50,264
"Adur 001F","E01031374","40-44 years","Male",76,84,80,82,72,394
"Adur 001F","E01031374","45-49 years","Male",49,44,45,46,57,241
"Adur 001F","E01031374","50-54 years","Male",59,65,60,64,56,304
"Adur 001F","E01031374","55-59 years","Male",55,52,55,51,59,272
"Adur 001F","E01031374","60-64 years","Male",47,52,52,52,45,248
"Adur 001F","E01031374","65-69 years","Male",29,31,37,37,40,174
"Adur 001F","E01031374","70-74 years","Male",38,35,33,36,31,173
"Adur 001F","E01031374","75-79 years","Male",21,17,22,19,23,102
"Adur 001F","E01031374","80-84 years","Male",23,25,23,19,16,106
"Adur 001F","E01031374","85+ years","Male",22,20,22,23,28,115
"Adur 001F","E01031374","0-4 years","Female",64,64,58,66,56,308
"Adur 001F","E01031374","5-9 years","Female",49,68,68,58,80,323
"Adur 001F","E01031374","10-14 years","Female",47,46,43,48,45,229
"Adur 001F","E01031374","15-19 years","Female",23,22,30,32,36,143
"Adur 001F","E01031374","20-24 years","Female",34,30,27,28,29,148
"Adur 001F","E01031374","25-29 years","Female",50,46,40,41,32,209
"Adur 001F","E01031374","30-34 years","Female",56,54,51,57,60,278
"Adur 001F","E01031374","35-39 years","Female",61,66,62,54,53,296
"Adur 001F","E01031374","40-44 years","Female",71,69,66,68,69,343
"Adur 001F","E01031374","45-49 years","Female",52,54,57,66,65,294
"Adur 001F","E01031374","50-54 years","Female",61,60,63,55,49,288
"Adur 001F","E01031374","55-59 years","Female",45,38,40,49,55,227
"Adur 001F","E01031374","60-64 years","Female",35,47,46,46,45,219
"Adur 001F","E01031374","65-69 years","Female",39,30,37,34,30,170
"Adur 001F","E01031374","70-74 years","Female",40,42,37,39,40,198
"Adur 001F","E01031374","75-79 years","Female",33,36,33,35,37,174
"Adur 001F","E01031374","80-84 years","Female",25,24,26,21,20,116
"Adur 001F","E01031374","85+ years","Female",39,38,42,44,39,202
"Adur 002A","E01031338","0-4 years","Male",31,43,39,36,31,180
"Adur 002A","E01031338","5-9 years","Male",40,37,37,37,46,197
"Adur 002A","E01031338","10-14 years","Male",32,34,40,51,53,210
"Adur 002A","E01031338","15-19 years","Male",26,22,26,26,29,129
"Adur 002A","E01031338","20-24 years","Male",33,31,33,27,28,152
"Adur 002A","E01031338","25-29 years","Male",19,18,16,23,21,97
"Adur 002A","E01031338","30-34 years","Male",25,25,26,23,22,121
"Adur 002A","E01031338","35-39 years","Male",44,45,45,47,52,233
"Adur 002A","E01031338","40-44 years","Male",40,47,45,47,50,229
"Adur 002A","E01031338","45-49 years","Male",61,53,54,52,47,267
"Adur 002A","E01031338","50-54 years","Male",47,62,61,62,65,297
"Adur 002A","E01031338","55-59 years","Male",32,27,35,39,46,179
"Adur 002A","E01031338","60-64 years","Male",26,24,21,22,22,115
"Adur 002A","E01031338","65-69 years","Male",47,40,35,32,31,185
"Adur 002A","E01031338","70-74 years","Male",51,53,51,48,46,249
"Adur 002A","E01031338","75-79 years","Male",19,22,22,22,24,109
"Adur 002A","E01031338","80-84 years","Male",12,11,12,17,18,70
"Adur 002A","E01031338","85+ years","Male",14,16,17,11,9,67
"Adur 002A","E01031338","0-4 years","Female",40,45,37,40,44,206
"Adur 002A","E01031338","5-9 years","Female",35,44,48,51,63,241
"Adur 002A","E01031338","10-14 years","Female",26,24,30,29,25,134
"Adur 002A","E01031338","15-19 years","Female",28,30,27,28,34,147
"Adur 002A","E01031338","20-24 years","Female",6,6,8,7,7,34
"Adur 002A","E01031338","25-29 years","Female",17,21,17,21,25,101
"Adur 002A","E01031338","30-34 years","Female",31,29,28,20,23,131
"Adur 002A","E01031338","35-39 years","Female",59,62,58,60,53,292
"Adur 002A","E01031338","40-44 years","Female",34,36,41,44,43,198
"Adur 002A","E01031338","45-49 years","Female",48,44,47,52,49,240
"Adur 002A","E01031338","50-54 years","Female",39,40,45,36,37,197
"Adur 002A","E01031338","55-59 years","Female",45,44,46,53,49,237
"Adur 002A","E01031338","60-64 years","Female",34,30,33,32,29,158
"Adur 002A","E01031338","65-69 years","Female",52,40,23,27,35,177
"Adur 002A","E01031338","70-74 years","Female",35,44,54,52,39,224
"Adur 002A","E01031338","75-79 years","Female",28,24,28,24,32,136
"Adur 002A","E01031338","80-84 years","Female",26,28,30,28,26,138
"Adur 002A","E01031338","85+ years","Female",20,28,25,22,23,118
"Adur 002B","E01031339","0-4 years","Male",54,61,55,53,39,262
"Adur 002B","E01031339","5-9 years","Male",39,39,45,44,47,214
"Adur 002B","E01031339","10-14 years","Male",30,37,42,42,42,193
"Adur 002B","E01031339","15-19 years","Male",23,22,16,16,20,97
"Adur 002B","E01031339","20-24 years","Male",24,21,21,24,20,110
"Adur 002B","E01031339","25-29 years","Male",18,24,30,28,30,130
"Adur 002B","E01031339","30-34 years","Male",30,29,31,37,29,156
"Adur 002B","E01031339","35-39 years","Male",55,53,45,40,38,231
"Adur 002B","E01031339","40-44 years","Male",44,45,50,46,47,232
"Adur 002B","E01031339","45-49 years","Male",39,33,38,45,47,202
"Adur 002B","E01031339","50-54 years","Male",34,37,40,33,37,181
"Adur 002B","E01031339","55-59 years","Male",39,36,35,42,40,192
"Adur 002B","E01031339","60-64 years","Male",32,36,37,37,38,180
"Adur 002B","E01031339","65-69 years","Male",35,36,28,30,31,160
"Adur 002B","E01031339","70-74 years","Male",33,34,37,37,39,180
"Adur 002B","E01031339","75-79 years","Male",18,20,22,23,24,107
"Adur 002B","E01031339","80-84 years","Male",16,16,14,13,12,71
"Adur 002B","E01031339","85+ years","Male",12,14,15,22,22,85
"Adur 002B","E01031339","0-4 years","Female",35,35,38,35,29,172
"Adur 002B","E01031339","5-9 years","Female",30,33,35,49,48,195
"Adur 002B","E01031339","10-14 years","Female",30,32,24,21,37,144
"Adur 002B","E01031339","15-19 years","Female",28,27,31,26,23,135
"Adur 002B","E01031339","20-24 years","Female",15,13,14,16,12,70
"Adur 002B","E01031339","25-29 years","Female",27,24,26,23,33,133
"Adur 002B","E01031339","30-34 years","Female",51,47,44,45,46,233
"Adur 002B","E01031339","35-39 years","Female",56,53,56,57,49,271
"Adur 002B","E01031339","40-44 years","Female",42,51,53,54,47,247
"Adur 002B","E01031339","45-49 years","Female",39,35,33,39,49,195
"Adur 002B","E01031339","50-54 years","Female",40,39,43,40,41,203
"Adur 002B","E01031339","55-59 years","Female",53,49,45,42,40,229
"Adur 002B","E01031339","60-64 years","Female",37,42,51,52,53,235
"Adur 002B","E01031339","65-69 years","Female",50,44,34,30,31,189
"Adur 002B","E01031339","70-74 years","Female",31,42,42,43,44,202
"Adur 002B","E01031339","75-79 years","Female",22,23,25,25,28,123
"Adur 002B","E01031339","80-84 years","Female",18,21,24,23,22,108
"Adur 002B","E01031339","85+ years","Female",10,12,10,15,10,57
"Adur 002C","E01031340","0-4 years","Male",35,38,44,42,42,201
"Adur 002C","E01031340","5-9 years","Male",43,44,43,53,52,235
"Adur 002C","E01031340","10-14 years","Male",36,38,36,35,36,181
"Adur 002C","E01031340","15-19 years","Male",54,51,43,43,37,228
"Adur 002C","E01031340","20-24 years","Male",27,30,39,35,38,169
"Adur 002C","E01031340","25-29 years","Male",18,17,16,25,20,96
"Adur 002C","E01031340","30-34 years","Male",19,17,22,16,21,95
"Adur 002C","E01031340","35-39 years","Male",27,23,23,20,23,116
"Adur 002C","E01031340","40-44 years","Male",44,45,40,37,38,204
"Adur 002C","E01031340","45-49 years","Male",52,52,55,55,56,270
"Adur 002C","E01031340","50-54 years","Male",63,60,53,57,47,280
"Adur 002C","E01031340","55-59 years","Male",58,53,61,53,64,289
"Adur 002C","E01031340","60-64 years","Male",54,58,51,53,51,267
"Adur 002C","E01031340","65-69 years","Male",58,54,51,53,47,263
"Adur 002C","E01031340","70-74 years","Male",53,58,64,69,67,311
"Adur 002C","E01031340","75-79 years","Male",47,45,47,43,45,227
"Adur 002C","E01031340","80-84 years","Male",15,21,19,30,35,120
"Adur 002C","E01031340","85+ years","Male",26,29,31,30,26,142
"Adur 002C","E01031340","0-4 years","Female",38,34,33,30,25,160
"Adur 002C","E01031340","5-9 years","Female",38,43,40,37,40,198
"Adur 002C","E01031340","10-14 years","Female",48,46,41,49,53,237
"Adur 002C","E01031340","15-19 years","Female",20,22,24,28,30,124
"Adur 002C","E01031340","20-24 years","Female",19,19,19,18,13,88
"Adur 002C","E01031340","25-29 years","Female",14,13,12,11,15,65
"Adur 002C","E01031340","30-34 years","Female",25,26,27,21,18,117
"Adur 002C","E01031340","35-39 years","Female",33,31,29,31,35,159
"Adur 002C","E01031340","40-44 years","Female",47,42,40,38,41,208
"Adur 002C","E01031340","45-49 years","Female",58,55,57,64,58,292
"Adur 002C","E01031340","50-54 years","Female",67,68,60,57,61,313
"Adur 002C","E01031340","55-59 years","Female",51,53,51,50,47,252
"Adur 002C","E01031340","60-64 years","Female",60,55,57,57,52,281
"Adur 002C","E01031340","65-69 years","Female",72,79,72,65,71,359
"Adur 002C","E01031340","70-74 years","Female",58,62,67,69,67,323
"Adur 002C","E01031340","75-79 years","Female",40,47,45,47,48,227
"Adur 002C","E01031340","80-84 years","Female",23,23,19,28,31,124
"Adur 002C","E01031340","85+ years","Female",32,31,33,28,33,157
"Adur 002D","E01031365","0-4 years","Male",76,73,52,54,54,309
"Adur 002D","E01031365","5-9 years","Male",69,68,71,68,64,340
"Adur 002D","E01031365","10-14 years","Male",69,70,78,82,82,381
"Adur 002D","E01031365","15-19 years","Male",49,54,57,58,67,285
"Adur 002D","E01031365","20-24 years","Male",29,27,28,29,33,146
"Adur 002D","E01031365","25-29 years","Male",63,52,52,48,43,258
"Adur 002D","E01031365","30-34 years","Male",49,54,47,45,41,236
"Adur 002D","E01031365","35-39 years","Male",39,47,43,44,45,218
"Adur 002D","E01031365","40-44 years","Male",87,76,71,66,67,367
"Adur 002D","E01031365","45-49 years","Male",75,76,75,77,77,380
"Adur 002D","E01031365","50-54 years","Male",64,73,72,76,76,361
"Adur 002D","E01031365","55-59 years","Male",56,58,64,73,73,324
"Adur 002D","E01031365","60-64 years","Male",36,39,45,43,40,203
"Adur 002D","E01031365","65-69 years","Male",53,51,51,41,43,239
"Adur 002D","E01031365","70-74 years","Male",43,46,48,60,59,256
"Adur 002D","E01031365","75-79 years","Male",25,32,31,30,28,146
"Adur 002D","E01031365","80-84 years","Male",40,37,38,32,27,174
"Adur 002D","E01031365","85+ years","Male",23,28,26,28,22,127
"Adur 002D","E01031365","0-4 years","Female",84,89,83,73,60,389
"Adur 002D","E01031365","5-9 years","Female",78,81,82,79,74,394
"Adur 002D","E01031365","10-14 years","Female",42,38,44,52,64,240
"Adur 002D","E01031365","15-19 years","Female",43,49,38,36,38,204
"Adur 002D","E01031365","20-24 years","Female",49,44,43,41,34,211
"Adur 002D","E01031365","25-29 years","Female",59,50,42,44,45,240
"Adur 002D","E01031365","30-34 years","Female",56,57,60,57,45,275
"Adur 002D","E01031365","35-39 years","Female",61,61,57,54,60,293
"Adur 002D","E01031365","40-44 years","Female",84,86,78,74,68,390
"Adur 002D","E01031365","45-49 years","Female",92,100,108,112,122,534
"Adur 002D","E01031365","50-54 years","Female",49,55,57,68,70,299
"Adur 002D","E01031365","55-59 years","Female",41,45,45,39,42,212
"Adur 002D","E01031365","60-64 years","Female",52,45,50,57,54,258
"Adur 002D","E01031365","65-69 years","Female",57,55,64,56,51,283
"Adur 002D","E01031365","70-74 years","Female",48,57,55,58,76,294
"Adur 002D","E01031365","75-79 years","Female",47,48,41,46,45,227
"Adur 002D","E01031365","80-84 years","Female",41,39,38,38,43,199
"Adur 002D","E01031365","85+ years","Female",58,50,47,54,51,260
"Adur 002E","E01031367","0-4 years","Male",43,36,35,30,33,177
"Adur 002E","E01031367","5-9 years","Male",40,63,62,64,63,292
"Adur 002E","E01031367","10-14 years","Male",37,41,40,37,38,193
"Adur 002E","E01031367","15-19 years","Male",28,27,28,30,35,148
"Adur 002E","E01031367","20-24 years","Male",18,18,24,25,24,109
"Adur 002E","E01031367","25-29 years","Male",16,12,11,16,16,71
"Adur 002E","E01031367","30-34 years","Male",17,17,21,19,20,94
"Adur 002E","E01031367","35-39 years","Male",42,45,39,43,37,206
"Adur 002E","E01031367","40-44 years","Male",45,46,50,43,42,226
"Adur 002E","E01031367","45-49 years","Male",52,55,61,63,61,292
"Adur 002E","E01031367","50-54 years","Male",40,41,39,37,33,190
"Adur 002E","E01031367","55-59 years","Male",61,55,55,55,52,278
"Adur 002E","E01031367","60-64 years","Male",36,36,38,43,51,204
"Adur 002E","E01031367","65-69 years","Male",64,58,54,49,39,264
"Adur 002E","E01031367","70-74 years","Male",42,46,53,53,60,254
"Adur 002E","E01031367","75-79 years","Male",32,29,30,36,38,165
"Adur 002E","E01031367","80-84 years","Male",23,27,28,28,30,136
"Adur 002E","E01031367","85+ years","Male",22,20,20,18,23,103
"Adur 002E","E01031367","0-4 years","Female",33,34,28,29,23,147
"Adur 002E","E01031367","5-9 years","Female",34,39,41,39,46,199
"Adur 002E","E01031367","10-14 years","Female",24,29,36,39,38,166
"Adur 002E","E01031367","15-19 years","Female",34,36,31,25,20,146
"Adur 002E","E01031367","20-24 years","Female",12,11,14,13,11,61
"Adur 002E","E01031367","25-29 years","Female",10,14,12,17,23,76
"Adur 002E","E01031367","30-34 years","Female",28,25,20,16,18,107
"Adur 002E","E01031367","35-39 years","Female",30,34,41,44,38,187
"Adur 002E","E01031367","40-44 years","Female",61,56,55,50,55,277
"Adur 002E","E01031367","45-49 years","Female",40,52,57,50,48,247
"Adur 002E","E01031367","50-54 years","Female",39,33,30,35,40,177
"Adur 002E","E01031367","55-59 years","Female",49,44,48,49,42,232
"Adur 002E","E01031367","60-64 years","Female",37,37,36,37,48,195
"Adur 002E","E01031367","65-69 years","Female",78,71,66,62,45,322
"Adur 002E","E01031367","70-74 years","Female",59,64,66,64,71,324
"Adur 002E","E01031367","75-79 years","Female",42,40,39,44,49,214
"Adur 002E","E01031367","80-84 years","Female",16,16,20,25,27,104
"Adur 002E","E01031367","85+ years","Female",23,21,21,18,18,101
"Adur 003A","E01031345","0-4 years","Male",41,40,51,47,43,222
"Adur 003A","E01031345","5-9 years","Male",41,37,32,32,39,181
"Adur 003A","E01031345","10-14 years","Male",34,38,38,43,46,199
"Adur 003A","E01031345","15-19 years","Male",46,46,43,45,41,221
"Adur 003A","E01031345","20-24 years","Male",32,37,41,41,40,191
"Adur 003A","E01031345","25-29 years","Male",34,32,28,31,33,158
"Adur 003A","E01031345","30-34 years","Male",56,59,56,41,41,253
"Adur 003A","E01031345","35-39 years","Male",46,57,57,65,54,279
"Adur 003A","E01031345","40-44 years","Male",49,44,43,40,51,227
"Adur 003A","E01031345","45-49 years","Male",60,56,56,51,49,272
"Adur 003A","E01031345","50-54 years","Male",60,67,58,65,61,311
"Adur 003A","E01031345","55-59 years","Male",57,53,59,61,58,288
"Adur 003A","E01031345","60-64 years","Male",59,60,51,49,52,271
"Adur 003A","E01031345","65-69 years","Male",49,43,50,55,53,250
"Adur 003A","E01031345","70-74 years","Male",50,58,53,45,37,243
"Adur 003A","E01031345","75-79 years","Male",32,33,33,36,37,171
"Adur 003A","E01031345","80-84 years","Male",11,16,20,24,31,102
"Adur 003A","E01031345","85+ years","Male",22,20,13,14,10,79
"Adur 003A","E01031345","0-4 years","Female",30,37,30,27,28,152
"Adur 003A","E01031345","5-9 years","Female",40,46,51,44,42,223
"Adur 003A","E01031345","10-14 years","Female",34,35,41,44,43,197
"Adur 003A","E01031345","15-19 years","Female",29,30,30,36,36,161
"Adur 003A","E01031345","20-24 years","Female",43,33,30,31,35,172
"Adur 003A","E01031345","25-29 years","Female",31,32,30,37,40,170
"Adur 003A","E01031345","30-34 years","Female",35,30,33,37,39,174
"Adur 003A","E01031345","35-39 years","Female",54,65,65,61,59,304
"Adur 003A","E01031345","40-44 years","Female",57,55,50,51,50,263
"Adur 003A","E01031345","45-49 years","Female",54,53,49,49,49,254
"Adur 003A","E01031345","50-54 years","Female",58,57,59,66,72,312
"Adur 003A","E01031345","55-59 years","Female",65,66,67,57,59,314
"Adur 003A","E01031345","60-64 years","Female",63,68,72,67,65,335
"Adur 003A","E01031345","65-69 years","Female",57,46,45,51,49,248
"Adur 003A","E01031345","70-74 years","Female",53,63,69,66,60,311
"Adur 003A","E01031345","75-79 years","Female",39,41,28,39,37,184
"Adur 003A","E01031345","80-84 years","Female",28,24,29,30,40,151
"Adur 003A","E01031345","85+ years","Female",35,40,41,38,35,189
"Adur 003B","E01031353","0-4 years","Male",24,25,22,29,24,124
"Adur 003B","E01031353","5-9 years","Male",32,37,40,36,37,182
"Adur 003B","E01031353","10-14 years","Male",58,59,60,63,55,295
"Adur 003B","E01031353","15-19 years","Male",157,123,120,117,117,634
"Adur 003B","E01031353","20-24 years","Male",26,13,9,11,16,75
"Adur 003B","E01031353","25-29 years","Male",28,25,21,22,24,120
"Adur 003B","E01031353","30-34 years","Male",27,27,25,30,29,138
"Adur 003B","E01031353","35-39 years","Male",33,33,37,35,30,168
"Adur 003B","E01031353","40-44 years","Male",33,32,34,38,39,176
"Adur 003B","E01031353","45-49 years","Male",43,44,48,45,38,218
"Adur 003B","E01031353","50-54 years","Male",44,40,42,37,35,198
"Adur 003B","E01031353","55-59 years","Male",49,46,43,49,40,227
"Adur 003B","E01031353","60-64 years","Male",47,48,44,40,49,228
"Adur 003B","E01031353","65-69 years","Male",43,42,44,43,40,212
"Adur 003B","E01031353","70-74 years","Male",40,39,39,41,44,203
"Adur 003B","E01031353","75-79 years","Male",30,31,33,35,35,164
"Adur 003B","E01031353","80-84 years","Male",16,18,21,23,25,103
"Adur 003B","E01031353","85+ years","Male",14,18,22,25,23,102
"Adur 003B","E01031353","0-4 years","Female",24,22,19,26,31,122
"Adur 003B","E01031353","5-9 years","Female",28,32,32,28,26,146
"Adur 003B","E01031353","10-14 years","Female",32,36,35,33,45,181
"Adur 003B","E01031353","15-19 years","Female",117,93,98,98,79,485
"Adur 003B","E01031353","20-24 years","Female",30,13,10,13,13,79
"Adur 003B","E01031353","25-29 years","Female",17,23,21,25,24,110
"Adur 003B","E01031353","30-34 years","Female",28,21,20,22,23,114
"Adur 003B","E01031353","35-39 years","Female",27,31,27,25,25,135
"Adur 003B","E01031353","40-44 years","Female",39,36,33,32,27,167
"Adur 003B","E01031353","45-49 years","Female",40,44,44,46,45,219
"Adur 003B","E01031353","50-54 years","Female",45,42,44,46,47,224
"Adur 003B","E01031353","55-59 years","Female",56,63,55,44,43,261
"Adur 003B","E01031353","60-64 years","Female",42,42,42,50,50,226
"Adur 003B","E01031353","65-69 years","Female",48,46,47,41,42,224
"Adur 003B","E01031353","70-74 years","Female",32,31,29,34,32,158
"Adur 003B","E01031353","75-79 years","Female",16,20,17,18,17,88
"Adur 003B","E01031353","80-84 years","Female",31,33,35,34,38,171
"Adur 003B","E01031353","85+ years","Female",11,13,17,16,19,76
"Adur 003C","E01031354","0-4 years","Male",36,33,30,22,21,142
"Adur 003C","E01031354","5-9 years","Male",42,43,48,52,52,237
"Adur 003C","E01031354","10-14 years","Male",28,27,30,35,42,162
"Adur 003C","E01031354","15-19 years","Male",36,38,38,41,30,183
"Adur 003C","E01031354","20-24 years","Male",30,28,26,27,32,143
"Adur 003C","E01031354","25-29 years","Male",25,21,25,26,27,124
"Adur 003C","E01031354","30-34 years","Male",32,29,24,24,22,131
"Adur 003C","E01031354","35-39 years","Male",29,24,27,31,34,145
"Adur 003C","E01031354","40-44 years","Male",32,37,45,44,40,198
"Adur 003C","E01031354","45-49 years","Male",50,52,41,42,39,224
"Adur 003C","E01031354","50-54 years","Male",58,59,61,62,61,301
"Adur 003C","E01031354","55-59 years","Male",41,40,42,37,41,201
"Adur 003C","E01031354","60-64 years","Male",39,37,37,39,34,186
"Adur 003C","E01031354","65-69 years","Male",63,55,51,46,46,261
"Adur 003C","E01031354","70-74 years","Male",49,60,59,60,60,288
"Adur 003C","E01031354","75-79 years","Male",34,36,38,44,47,199
"Adur 003C","E01031354","80-84 years","Male",27,21,22,24,24,118
"Adur 003C","E01031354","85+ years","Male",15,20,21,23,23,102
"Adur 003C","E01031354","0-4 years","Female",29,29,31,29,30,148
"Adur 003C","E01031354","5-9 years","Female",23,21,24,25,25,118
"Adur 003C","E01031354","10-14 years","Female",31,30,33,34,40,168
"Adur 003C","E01031354","15-19 years","Female",27,32,24,26,28,137
"Adur 003C","E01031354","20-24 years","Female",21,18,20,16,18,93
"Adur 003C","E01031354","25-29 years","Female",24,24,22,21,22,113
"Adur 003C","E01031354","30-34 years","Female",25,29,33,31,25,143
"Adur 003C","E01031354","35-39 years","Female",36,28,30,29,29,152
"Adur 003C","E01031354","40-44 years","Female",43,40,39,39,49,210
"Adur 003C","E01031354","45-49 years","Female",43,40,35,37,38,193
"Adur 003C","E01031354","50-54 years","Female",58,52,56,57,54,277
"Adur 003C","E01031354","55-59 years","Female",54,57,47,51,51,260
"Adur 003C","E01031354","60-64 years","Female",43,43,51,48,50,235
"Adur 003C","E01031354","65-69 years","Female",68,58,48,41,43,258
"Adur 003C","E01031354","70-74 years","Female",42,52,54,58,62,268
"Adur 003C","E01031354","75-79 years","Female",22,26,31,39,41,159
"Adur 003C","E01031354","80-84 years","Female",29,26,27,26,18,126
"Adur 003C","E01031354","85+ years","Female",22,21,15,25,33,116
"Adur 003D","E01031355","0-4 years","Male",68,58,51,49,41,267
"Adur 003D","E01031355","5-9 years","Male",73,78,71,81,70,373
"Adur 003D","E01031355","10-14 years","Male",52,52,59,58,74,295
"Adur 003D","E01031355","15-19 years","Male",58,58,52,42,40,250
"Adur 003D","E01031355","20-24 years","Male",53,52,62,56,57,280
"Adur 003D","E01031355","25-29 years","Male",34,37,39,41,36,187
"Adur 003D","E01031355","30-34 years","Male",58,52,46,52,47,255
"Adur 003D","E01031355","35-39 years","Male",55,50,59,59,58,281
"Adur 003D","E01031355","40-44 years","Male",60,58,61,64,69,312
"Adur 003D","E01031355","45-49 years","Male",59,63,59,59,56,296
"Adur 003D","E01031355","50-54 years","Male",74,74,60,62,62,332
"Adur 003D","E01031355","55-59 years","Male",44,45,53,52,49,243
"Adur 003D","E01031355","60-64 years","Male",40,44,47,49,54,234
"Adur 003D","E01031355","65-69 years","Male",47,47,46,43,43,226
"Adur 003D","E01031355","70-74 years","Male",34,40,41,46,41,202
"Adur 003D","E01031355","75-79 years","Male",27,21,20,21,28,117
"Adur 003D","E01031355","80-84 years","Male",28,29,24,23,21,125
"Adur 003D","E01031355","85+ years","Male",14,15,13,13,13,68
"Adur 003D","E01031355","0-4 years","Female",60,60,58,57,47,282
"Adur 003D","E01031355","5-9 years","Female",74,71,73,86,83,387
"Adur 003D","E01031355","10-14 years","Female",52,50,54,59,68,283
"Adur 003D","E01031355","15-19 years","Female",58,52,44,39,36,229
"Adur 003D","E01031355","20-24 years","Female",43,43,39,36,34,195
"Adur 003D","E01031355","25-29 years","Female",33,34,31,31,31,160
"Adur 003D","E01031355","30-34 years","Female",71,59,61,62,65,318
"Adur 003D","E01031355","35-39 years","Female",66,70,68,62,65,331
"Adur 003D","E01031355","40-44 years","Female",75,74,66,77,71,363
"Adur 003D","E01031355","45-49 years","Female",76,77,72,72,75,372
"Adur 003D","E01031355","50-54 years","Female",63,73,75,78,72,361
"Adur 003D","E01031355","55-59 years","Female",44,51,57,65,69,286
"Adur 003D","E01031355","60-64 years","Female",51,38,43,41,41,214
"Adur 003D","E01031355","65-69 years","Female",49,46,43,41,47,226
"Adur 003D","E01031355","70-74 years","Female",31,40,39,44,44,198
"Adur 003D","E01031355","75-79 years","Female",41,35,36,34,33,179
"Adur 003D","E01031355","80-84 years","Female",33,38,36,37,41,185
"Adur 003D","E01031355","85+ years","Female",32,29,28,28,21,138
"Adur 003E","E01031359","0-4 years","Male",31,37,43,34,30,175
"Adur 003E","E01031359","5-9 years","Male",55,52,46,47,47,247
"Adur 003E","E01031359","10-14 years","Male",55,56,60,60,64,295
"Adur 003E","E01031359","15-19 years","Male",54,51,53,51,44,253
"Adur 003E","E01031359","20-24 years","Male",32,34,25,18,21,130
"Adur 003E","E01031359","25-29 years","Male",31,32,28,25,29,145
"Adur 003E","E01031359","30-34 years","Male",42,40,38,39,39,198
"Adur 003E","E01031359","35-39 years","Male",37,39,43,42,39,200
"Adur 003E","E01031359","40-44 years","Male",68,64,57,46,40,275
"Adur 003E","E01031359","45-49 years","Male",41,40,44,47,47,219
"Adur 003E","E01031359","50-54 years","Male",43,41,43,41,41,209
"Adur 003E","E01031359","55-59 years","Male",35,39,45,46,49,214
"Adur 003E","E01031359","60-64 years","Male",43,38,38,40,28,187
"Adur 003E","E01031359","65-69 years","Male",32,34,30,38,46,180
"Adur 003E","E01031359","70-74 years","Male",29,28,30,32,26,145
"Adur 003E","E01031359","75-79 years","Male",20,18,18,15,16,87
"Adur 003E","E01031359","80-84 years","Male",17,18,18,18,20,91
"Adur 003E","E01031359","85+ years","Male",6,6,8,7,6,33
"Adur 003E","E01031359","0-4 years","Female",40,33,33,39,44,189
"Adur 003E","E01031359","5-9 years","Female",41,44,44,39,36,204
"Adur 003E","E01031359","10-14 years","Female",28,30,36,37,36,167
"Adur 003E","E01031359","15-19 years","Female",35,33,30,29,29,156
"Adur 003E","E01031359","20-24 years","Female",33,31,34,32,31,161
"Adur 003E","E01031359","25-29 years","Female",25,27,21,15,20,108
"Adur 003E","E01031359","30-34 years","Female",40,32,45,47,39,203
"Adur 003E","E01031359","35-39 years","Female",59,57,57,51,51,275
"Adur 003E","E01031359","40-44 years","Female",42,46,39,37,37,201
"Adur 003E","E01031359","45-49 years","Female",67,63,65,64,65,324
"Adur 003E","E01031359","50-54 years","Female",41,46,57,54,49,247
"Adur 003E","E01031359","55-59 years","Female",49,52,49,49,45,244
"Adur 003E","E01031359","60-64 years","Female",50,49,48,48,47,242
"Adur 003E","E01031359","65-69 years","Female",38,40,39,36,39,192
"Adur 003E","E01031359","70-74 years","Female",20,17,21,20,22,100
"Adur 003E","E01031359","75-79 years","Female",22,25,26,22,19,114
"Adur 003E","E01031359","80-84 years","Female",22,25,23,24,25,119
"Adur 003E","E01031359","85+ years","Female",14,14,19,23,20,90
"Adur 004A","E01031347","0-4 years","Male",65,56,56,54,48,279
"Adur 004A","E01031347","5-9 years","Male",55,52,63,65,71,306
"Adur 004A","E01031347","10-14 years","Male",59,62,53,56,55,285
"Adur 004A","E01031347","15-19 years","Male",33,42,49,56,53,233
"Adur 004A","E01031347","20-24 years","Male",66,58,57,46,43,270
"Adur 004A","E01031347","25-29 years","Male",54,59,53,58,54,278
"Adur 004A","E01031347","30-34 years","Male",61,49,48,56,52,266
"Adur 004A","E01031347","35-39 years","Male",29,28,31,36,42,166
"Adur 004A","E01031347","40-44 years","Male",56,55,51,50,52,264
"Adur 004A","E01031347","45-49 years","Male",60,64,68,55,52,299
"Adur 004A","E01031347","50-54 years","Male",64,59,59,61,54,297
"Adur 004A","E01031347","55-59 years","Male",44,45,48,55,52,244
"Adur 004A","E01031347","60-64 years","Male",42,42,45,43,51,223
"Adur 004A","E01031347","65-69 years","Male",46,46,46,47,45,230
"Adur 004A","E01031347","70-74 years","Male",22,22,21,21,26,112
"Adur 004A","E01031347","75-79 years","Male",22,19,23,23,15,102
"Adur 004A","E01031347","80-84 years","Male",12,15,14,14,16,71
"Adur 004A","E01031347","85+ years","Male",17,20,19,15,16,87
"Adur 004A","E01031347","0-4 years","Female",64,68,70,78,65,345
"Adur 004A","E01031347","5-9 years","Female",68,75,72,71,83,369
"Adur 004A","E01031347","10-14 years","Female",42,56,55,63,65,281
"Adur 004A","E01031347","15-19 years","Female",42,48,48,56,64,258
"Adur 004A","E01031347","20-24 years","Female",58,49,43,40,34,224
"Adur 004A","E01031347","25-29 years","Female",61,58,62,69,66,316
"Adur 004A","E01031347","30-34 years","Female",75,77,64,79,74,369
"Adur 004A","E01031347","35-39 years","Female",52,55,59,59,61,286
"Adur 004A","E01031347","40-44 years","Female",67,67,70,74,71,349
"Adur 004A","E01031347","45-49 years","Female",48,57,61,70,68,304
"Adur 004A","E01031347","50-54 years","Female",65,56,53,50,50,274
"Adur 004A","E01031347","55-59 years","Female",47,53,60,64,55,279
"Adur 004A","E01031347","60-64 years","Female",35,42,41,36,41,195
"Adur 004A","E01031347","65-69 years","Female",38,32,37,33,31,171
"Adur 004A","E01031347","70-74 years","Female",29,26,22,28,29,134
"Adur 004A","E01031347","75-79 years","Female",29,33,32,27,30,151
"Adur 004A","E01031347","80-84 years","Female",30,27,22,23,28,130
"Adur 004A","E01031347","85+ years","Female",21,20,22,24,24,111
"Adur 004B","E01031348","0-4 years","Male",71,61,64,56,51,303
"Adur 004B","E01031348","5-9 years","Male",79,79,76,80,84,398
"Adur 004B","E01031348","10-14 years","Male",63,73,63,67,63,329
"Adur 004B","E01031348","15-19 years","Male",63,60,64,60,66,313
"Adur 004B","E01031348","20-24 years","Male",40,37,40,40,40,197
"Adur 004B","E01031348","25-29 years","Male",55,62,65,64,57,303
"Adur 004B","E01031348","30-34 years","Male",63,53,52,64,61,293
"Adur 004B","E01031348","35-39 years","Male",52,53,57,56,52,270
"Adur 004B","E01031348","40-44 years","Male",67,61,56,53,65,302
"Adur 004B","E01031348","45-49 years","Male",80,82,88,83,84,417
"Adur 004B","E01031348","50-54 years","Male",51,55,57,62,71,296
"Adur 004B","E01031348","55-59 years","Male",39,39,48,47,47,220
"Adur 004B","E01031348","60-64 years","Male",32,34,30,30,37,163
"Adur 004B","E01031348","65-69 years","Male",25,28,31,35,32,151
"Adur 004B","E01031348","70-74 years","Male",14,15,15,12,14,70
"Adur 004B","E01031348","75-79 years","Male",25,26,27,28,21,127
"Adur 004B","E01031348","80-84 years","Male",16,14,16,18,20,84
"Adur 004B","E01031348","85+ years","Male",8,10,16,15,18,67
"Adur 004B","E01031348","0-4 years","Female",75,61,68,63,57,324
"Adur 004B","E01031348","5-9 years","Female",87,86,73,58,58,362
"Adur 004B","E01031348","10-14 years","Female",55,60,73,73,64,325
"Adur 004B","E01031348","15-19 years","Female",50,45,45,42,45,227
"Adur 004B","E01031348","20-24 years","Female",38,46,42,32,30,188
"Adur 004B","E01031348","25-29 years","Female",46,36,35,40,33,190
"Adur 004B","E01031348","30-34 years","Female",66,67,61,59,54,307
"Adur 004B","E01031348","35-39 years","Female",72,65,79,75,80,371
"Adur 004B","E01031348","40-44 years","Female",76,70,66,76,67,355
"Adur 004B","E01031348","45-49 years","Female",86,87,79,72,79,403
"Adur 004B","E01031348","50-54 years","Female",56,69,79,81,86,371
"Adur 004B","E01031348","55-59 years","Female",37,36,39,37,38,187
"Adur 004B","E01031348","60-64 years","Female",28,25,32,36,37,158
"Adur 004B","E01031348","65-69 years","Female",49,40,34,29,23,175
"Adur 004B","E01031348","70-74 years","Female",24,34,38,41,45,182
"Adur 004B","E01031348","75-79 years","Female",11,12,14,16,13,66
"Adur 004B","E01031348","80-84 years","Female",9,7,10,12,16,54
"Adur 004B","E01031348","85+ years","Female",15,12,13,11,11,62
"Adur 004C","E01031366","0-4 years","Male",55,63,70,64,51,303
"Adur 004C","E01031366","5-9 years","Male",48,50,44,47,44,233
"Adur 004C","E01031366","10-14 years","Male",41,37,45,47,43,213
"Adur 004C","E01031366","15-19 years","Male",50,49,43,37,48,227
"Adur 004C","E01031366","20-24 years","Male",48,46,55,41,37,227
"Adur 004C","E01031366","25-29 years","Male",37,39,37,49,44,206
"Adur 004C","E01031366","30-34 years","Male",39,38,36,34,40,187
"Adur 004C","E01031366","35-39 years","Male",40,38,39,41,32,190
"Adur 004C","E01031366","40-44 years","Male",43,43,43,43,46,218
"Adur 004C","E01031366","45-49 years","Male",44,52,51,46,48,241
"Adur 004C","E01031366","50-54 years","Male",46,46,50,54,48,244
"Adur 004C","E01031366","55-59 years","Male",42,41,45,47,57,232
"Adur 004C","E01031366","60-64 years","Male",39,45,44,39,40,207
"Adur 004C","E01031366","65-69 years","Male",27,24,28,29,30,138
"Adur 004C","E01031366","70-74 years","Male",19,21,23,24,20,107
"Adur 004C","E01031366","75-79 years","Male",19,21,23,26,29,118
"Adur 004C","E01031366","80-84 years","Male",13,13,12,10,8,56
"Adur 004C","E01031366","85+ years","Male",34,42,37,39,43,195
"Adur 004C","E01031366","0-4 years","Female",43,41,37,38,37,196
"Adur 004C","E01031366","5-9 years","Female",40,44,41,48,48,221
"Adur 004C","E01031366","10-14 years","Female",40,49,52,52,48,241
"Adur 004C","E01031366","15-19 years","Female",48,48,54,45,47,242
"Adur 004C","E01031366","20-24 years","Female",38,36,39,39,37,189
"Adur 004C","E01031366","25-29 years","Female",25,26,25,27,31,134
"Adur 004C","E01031366","30-34 years","Female",42,47,32,31,25,177
"Adur 004C","E01031366","35-39 years","Female",46,48,45,46,45,230
"Adur 004C","E01031366","40-44 years","Female",52,51,57,54,54,268
"Adur 004C","E01031366","45-49 years","Female",71,65,62,63,56,317
"Adur 004C","E01031366","50-54 years","Female",53,61,68,63,70,315
"Adur 004C","E01031366","55-59 years","Female",61,60,55,59,60,295
"Adur 004C","E01031366","60-64 years","Female",32,33,37,44,45,191
"Adur 004C","E01031366","65-69 years","Female",32,37,41,33,42,185
"Adur 004C","E01031366","70-74 years","Female",24,26,25,27,23,125
"Adur 004C","E01031366","75-79 years","Female",23,30,27,26,22,128
"Adur 004C","E01031366","80-84 years","Female",25,27,25,24,30,131
"Adur 004C","E01031366","85+ years","Female",54,63,62,70,61,310
"Adur 004D","E01031371","0-4 years","Male",49,55,55,62,58,279
"Adur 004D","E01031371","5-9 years","Male",47,41,47,52,58,245
"Adur 004D","E01031371","10-14 years","Male",43,38,36,37,35,189
"Adur 004D","E01031371","15-19 years","Male",46,45,47,40,41,219
"Adur 004D","E01031371","20-24 years","Male",42,39,37,40,41,199
"Adur 004D","E01031371","25-29 years","Male",40,35,38,37,39,189
"Adur 004D","E01031371","30-34 years","Male",40,37,32,32,27,168
"Adur 004D","E01031371","35-39 years","Male",48,46,46,42,32,214
"Adur 004D","E01031371","40-44 years","Male",35,35,41,44,54,209
"Adur 004D","E01031371","45-49 years","Male",48,51,41,39,35,214
"Adur 004D","E01031371","50-54 years","Male",71,73,68,67,62,341
"Adur 004D","E01031371","55-59 years","Male",23,22,26,26,34,131
"Adur 004D","E01031371","60-64 years","Male",32,24,25,29,27,137
"Adur 004D","E01031371","65-69 years","Male",50,48,42,42,39,221
"Adur 004D","E01031371","70-74 years","Male",39,36,38,32,41,186
"Adur 004D","E01031371","75-79 years","Male",22,31,30,33,29,145
"Adur 004D","E01031371","80-84 years","Male",19,17,22,23,27,108
"Adur 004D","E01031371","85+ years","Male",11,9,6,8,7,41
"Adur 004D","E01031371","0-4 years","Female",43,35,28,30,31,167
"Adur 004D","E01031371","5-9 years","Female",34,36,41,39,35,185
"Adur 004D","E01031371","10-14 years","Female",33,38,36,43,45,195
"Adur 004D","E01031371","15-19 years","Female",33,36,28,29,25,151
"Adur 004D","E01031371","20-24 years","Female",30,25,28,24,26,133
"Adur 004D","E01031371","25-29 years","Female",53,52,57,41,39,242
"Adur 004D","E01031371","30-34 years","Female",45,38,39,53,46,221
"Adur 004D","E01031371","35-39 years","Female",36,43,41,45,49,214
"Adur 004D","E01031371","40-44 years","Female",46,38,40,34,31,189
"Adur 004D","E01031371","45-49 years","Female",57,57,51,43,45,253
"Adur 004D","E01031371","50-54 years","Female",56,52,60,57,55,280
"Adur 004D","E01031371","55-59 years","Female",39,38,40,44,45,206
"Adur 004D","E01031371","60-64 years","Female",38,33,31,32,37,171
"Adur 004D","E01031371","65-69 years","Female",38,37,36,34,34,179
"Adur 004D","E01031371","70-74 years","Female",42,43,46,53,50,234
"Adur 004D","E01031371","75-79 years","Female",24,32,32,30,30,148
"Adur 004D","E01031371","80-84 years","Female",23,11,12,14,23,83
"Adur 004D","E01031371","85+ years","Female",33,34,34,28,23,152
"Adur 004E","E01031372","0-4 years","Male",23,27,45,46,38,179
"Adur 004E","E01031372","5-9 years","Male",36,36,39,41,46,198
"Adur 004E","E01031372","10-14 years","Male",20,21,29,31,31,132
"Adur 004E","E01031372","15-19 years","Male",36,41,34,30,31,172
"Adur 004E","E01031372","20-24 years","Male",53,49,57,57,42,258
"Adur 004E","E01031372","25-29 years","Male",28,30,33,37,43,171
"Adur 004E","E01031372","30-34 years","Male",24,28,38,38,35,163
"Adur 004E","E01031372","35-39 years","Male",34,36,38,32,36,176
"Adur 004E","E01031372","40-44 years","Male",36,33,37,46,49,201
"Adur 004E","E01031372","45-49 years","Male",43,45,43,44,41,216
"Adur 004E","E01031372","50-54 years","Male",46,50,46,45,38,225
"Adur 004E","E01031372","55-59 years","Male",39,45,53,53,61,251
"Adur 004E","E01031372","60-64 years","Male",34,35,43,47,37,196
"Adur 004E","E01031372","65-69 years","Male",21,17,16,19,28,101
"Adur 004E","E01031372","70-74 years","Male",20,28,25,20,24,117
"Adur 004E","E01031372","75-79 years","Male",33,24,30,26,19,132
"Adur 004E","E01031372","80-84 years","Male",21,26,21,27,28,123
"Adur 004E","E01031372","85+ years","Male",24,17,21,17,16,95
"Adur 004E","E01031372","0-4 years","Female",39,46,74,67,61,287
"Adur 004E","E01031372","5-9 years","Female",27,39,35,45,50,196
"Adur 004E","E01031372","10-14 years","Female",29,30,37,38,41,175
"Adur 004E","E01031372","15-19 years","Female",33,28,26,27,23,137
"Adur 004E","E01031372","20-24 years","Female",47,55,49,42,44,237
"Adur 004E","E01031372","25-29 years","Female",25,37,51,47,41,201
"Adur 004E","E01031372","30-34 years","Female",31,35,44,56,58,224
"Adur 004E","E01031372","35-39 years","Female",27,34,48,51,53,213
"Adur 004E","E01031372","40-44 years","Female",61,55,59,62,64,301
"Adur 004E","E01031372","45-49 years","Female",51,59,64,63,57,294
"Adur 004E","E01031372","50-54 years","Female",48,51,50,52,59,260
"Adur 004E","E01031372","55-59 years","Female",42,37,40,45,39,203
"Adur 004E","E01031372","60-64 years","Female",26,36,33,38,42,175
"Adur 004E","E01031372","65-69 years","Female",44,40,38,33,36,191
"Adur 004E","E01031372","70-74 years","Female",24,25,31,29,30,139
"Adur 004E","E01031372","75-79 years","Female",31,33,28,34,36,162
"Adur 004E","E01031372","80-84 years","Female",36,28,30,29,27,150
"Adur 004E","E01031372","85+ years","Female",29,34,38,36,39,176
"Adur 004F","E01031373","0-4 years","Male",61,60,53,49,44,267
"Adur 004F","E01031373","5-9 years","Male",64,70,63,73,69,339
"Adur 004F","E01031373","10-14 years","Male",31,32,41,36,39,179
"Adur 004F","E01031373","15-19 years","Male",37,30,35,37,36,175
"Adur 004F","E01031373","20-24 years","Male",47,54,46,42,35,224
"Adur 004F","E01031373","25-29 years","Male",26,26,26,27,32,137
"Adur 004F","E01031373","30-34 years","Male",40,34,37,39,39,189
"Adur 004F","E01031373","35-39 years","Male",40,37,38,41,37,193
"Adur 004F","E01031373","40-44 years","Male",57,56,45,42,44,244
"Adur 004F","E01031373","45-49 years","Male",35,39,40,44,45,203
"Adur 004F","E01031373","50-54 years","Male",54,48,44,51,44,241
"Adur 004F","E01031373","55-59 years","Male",49,50,57,51,54,261
"Adur 004F","E01031373","60-64 years","Male",40,43,44,42,44,213
"Adur 004F","E01031373","65-69 years","Male",33,29,26,28,27,143
"Adur 004F","E01031373","70-74 years","Male",35,33,32,32,29,161
"Adur 004F","E01031373","75-79 years","Male",19,26,26,28,28,127
"Adur 004F","E01031373","80-84 years","Male",19,15,18,17,17,86
"Adur 004F","E01031373","85+ years","Male",12,10,7,12,12,53
"Adur 004F","E01031373","0-4 years","Female",45,51,48,47,42,233
"Adur 004F","E01031373","5-9 years","Female",45,40,46,43,41,215
"Adur 004F","E01031373","10-14 years","Female",30,37,35,35,36,173
"Adur 004F","E01031373","15-19 years","Female",27,31,28,34,34,154
"Adur 004F","E01031373","20-24 years","Female",27,32,37,29,28,153
"Adur 004F","E01031373","25-29 years","Female",42,36,29,34,39,180
"Adur 004F","E01031373","30-34 years","Female",44,41,44,49,44,222
"Adur 004F","E01031373","35-39 years","Female",53,55,45,35,40,228
"Adur 004F","E01031373","40-44 years","Female",46,41,49,45,43,224
"Adur 004F","E01031373","45-49 years","Female",50,55,55,57,50,267
"Adur 004F","E01031373","50-54 years","Female",63,69,54,54,55,295
"Adur 004F","E01031373","55-59 years","Female",35,36,45,50,57,223
"Adur 004F","E01031373","60-64 years","Female",36,31,35,27,27,156
"Adur 004F","E01031373","65-69 years","Female",51,43,39,42,37,212
"Adur 004F","E01031373","70-74 years","Female",42,46,47,43,37,215
"Adur 004F","E01031373","75-79 years","Female",31,32,30,31,34,158
"Adur 004F","E01031373","80-84 years","Female",24,21,24,28,27,124
"Adur 004F","E01031373","85+ years","Female",29,29,26,30,31,145
"Adur 004G","E01031375","0-4 years","Male",30,28,42,39,47,186
"Adur 004G","E01031375","5-9 years","Male",31,32,33,40,36,172
"Adur 004G","E01031375","10-14 years","Male",33,29,27,28,31,148
"Adur 004G","E01031375","15-19 years","Male",24,29,32,27,30,142
"Adur 004G","E01031375","20-24 years","Male",29,27,21,23,22,122
"Adur 004G","E01031375","25-29 years","Male",49,46,53,56,46,250
"Adur 004G","E01031375","30-34 years","Male",35,43,43,45,40,206
"Adur 004G","E01031375","35-39 years","Male",28,30,29,32,39,158
"Adur 004G","E01031375","40-44 years","Male",42,43,45,40,39,209
"Adur 004G","E01031375","45-49 years","Male",66,67,63,63,52,311
"Adur 004G","E01031375","50-54 years","Male",49,49,44,49,52,243
"Adur 004G","E01031375","55-59 years","Male",60,59,67,65,63,314
"Adur 004G","E01031375","60-64 years","Male",31,36,36,39,45,187
"Adur 004G","E01031375","65-69 years","Male",45,35,42,42,41,205
"Adur 004G","E01031375","70-74 years","Male",44,51,44,48,43,230
"Adur 004G","E01031375","75-79 years","Male",29,33,34,41,40,177
"Adur 004G","E01031375","80-84 years","Male",25,26,21,21,23,116
"Adur 004G","E01031375","85+ years","Male",10,9,12,9,8,48
"Adur 004G","E01031375","0-4 years","Female",28,20,23,25,24,120
"Adur 004G","E01031375","5-9 years","Female",31,36,30,35,40,172
"Adur 004G","E01031375","10-14 years","Female",33,33,39,48,49,202
"Adur 004G","E01031375","15-19 years","Female",34,38,35,25,27,159
"Adur 004G","E01031375","20-24 years","Female",25,31,27,35,32,150
"Adur 004G","E01031375","25-29 years","Female",43,40,39,33,35,190
"Adur 004G","E01031375","30-34 years","Female",39,45,51,56,53,244
"Adur 004G","E01031375","35-39 years","Female",36,34,37,38,41,186
"Adur 004G","E01031375","40-44 years","Female",50,58,54,48,60,270
"Adur 004G","E01031375","45-49 years","Female",56,45,56,57,52,266
"Adur 004G","E01031375","50-54 years","Female",48,53,54,49,49,253
"Adur 004G","E01031375","55-59 years","Female",58,55,58,63,59,293
"Adur 004G","E01031375","60-64 years","Female",48,50,46,47,51,242
"Adur 004G","E01031375","65-69 years","Female",56,49,51,48,48,252
"Adur 004G","E01031375","70-74 years","Female",36,46,45,50,54,231
"Adur 004G","E01031375","75-79 years","Female",55,55,56,51,44,261
"Adur 004G","E01031375","80-84 years","Female",38,46,49,44,48,225
"Adur 004G","E01031375","85+ years","Female",29,22,19,26,31,127
"Adur 005A","E01031356","0-4 years","Male",81,69,70,62,58,340
"Adur 005A","E01031356","5-9 years","Male",96,103,96,94,80,469
"Adur 005A","E01031356","10-14 years","Male",69,77,77,95,99,417
"Adur 005A","E01031356","15-19 years","Male",55,50,64,54,65,288
"Adur 005A","E01031356","20-24 years","Male",47,40,43,49,45,224
"Adur 005A","E01031356","25-29 years","Male",64,56,54,64,65,303
"Adur 005A","E01031356","30-34 years","Male",87,87,85,74,81,414
"Adur 005A","E01031356","35-39 years","Male",86,96,77,68,56,383
"Adur 005A","E01031356","40-44 years","Male",101,94,95,85,86,461
"Adur 005A","E01031356","45-49 years","Male",90,85,93,96,103,467
"Adur 005A","E01031356","50-54 years","Male",92,107,104,112,102,517
"Adur 005A","E01031356","55-59 years","Male",81,76,79,88,97,421
"Adur 005A","E01031356","60-64 years","Male",72,74,75,72,73,366
"Adur 005A","E01031356","65-69 years","Male",72,72,74,73,70,361
"Adur 005A","E01031356","70-74 years","Male",55,53,46,54,62,270
"Adur 005A","E01031356","75-79 years","Male",40,42,52,53,54,241
"Adur 005A","E01031356","80-84 years","Male",29,24,34,33,30,150
"Adur 005A","E01031356","85+ years","Male",35,31,29,25,25,145
"Adur 005A","E01031356","0-4 years","Female",89,85,86,85,84,429
"Adur 005A","E01031356","5-9 years","Female",65,79,87,77,86,394
"Adur 005A","E01031356","10-14 years","Female",49,47,46,60,59,261
"Adur 005A","E01031356","15-19 years","Female",47,47,51,53,44,242
"Adur 005A","E01031356","20-24 years","Female",41,38,42,34,37,192
"Adur 005A","E01031356","25-29 years","Female",71,68,63,59,58,319
"Adur 005A","E01031356","30-34 years","Female",74,73,63,54,51,315
"Adur 005A","E01031356","35-39 years","Female",110,114,94,81,77,476
"Adur 005A","E01031356","40-44 years","Female",97,93,103,106,96,495
"Adur 005A","E01031356","45-49 years","Female",93,93,103,109,105,503
"Adur 005A","E01031356","50-54 years","Female",81,89,79,85,86,420
"Adur 005A","E01031356","55-59 years","Female",88,85,90,92,91,446
"Adur 005A","E01031356","60-64 years","Female",74,72,74,74,81,375
"Adur 005A","E01031356","65-69 years","Female",105,106,92,92,93,488
"Adur 005A","E01031356","70-74 years","Female",40,51,66,80,81,318
"Adur 005A","E01031356","75-79 years","Female",36,35,37,39,40,187
"Adur 005A","E01031356","80-84 years","Female",43,38,33,29,27,170
"Adur 005A","E01031356","85+ years","Female",25,27,24,28,28,132
"Adur 005B","E01031357","0-4 years","Male",70,56,57,65,62,310
"Adur 005B","E01031357","5-9 years","Male",81,67,56,55,55,314
"Adur 005B","E01031357","10-14 years","Male",75,65,69,70,67,346
"Adur 005B","E01031357","15-19 years","Male",39,41,45,41,44,210
"Adur 005B","E01031357","20-24 years","Male",60,70,53,69,73,325
"Adur 005B","E01031357","25-29 years","Male",68,60,55,51,55,289
"Adur 005B","E01031357","30-34 years","Male",71,64,68,54,47,304
"Adur 005B","E01031357","35-39 years","Male",82,69,74,79,62,366
"Adur 005B","E01031357","40-44 years","Male",90,89,79,78,81,417
"Adur 005B","E01031357","45-49 years","Male",128,123,128,122,129,630
"Adur 005B","E01031357","50-54 years","Male",93,107,103,97,98,498
"Adur 005B","E01031357","55-59 years","Male",47,44,50,55,61,257
"Adur 005B","E01031357","60-64 years","Male",60,68,59,62,59,308
"Adur 005B","E01031357","65-69 years","Male",69,65,69,63,59,325
"Adur 005B","E01031357","70-74 years","Male",65,66,63,66,70,330
"Adur 005B","E01031357","75-79 years","Male",28,35,49,55,51,218
"Adur 005B","E01031357","80-84 years","Male",24,30,28,28,30,140
"Adur 005B","E01031357","85+ years","Male",15,19,19,22,24,99
"Adur 005B","E01031357","0-4 years","Female",88,85,65,65,44,347
"Adur 005B","E01031357","5-9 years","Female",81,60,61,65,72,339
"Adur 005B","E01031357","10-14 years","Female",66,67,69,64,58,324
"Adur 005B","E01031357","15-19 years","Female",49,54,49,43,43,238
"Adur 005B","E01031357","20-24 years","Female",40,41,37,45,45,208
"Adur 005B","E01031357","25-29 years","Female",59,53,48,47,43,250
"Adur 005B","E01031357","30-34 years","Female",60,58,50,56,56,280
"Adur 005B","E01031357","35-39 years","Female",98,78,79,86,75,416
"Adur 005B","E01031357","40-44 years","Female",82,73,67,72,66,360
"Adur 005B","E01031357","45-49 years","Female",99,96,96,90,82,463
"Adur 005B","E01031357","50-54 years","Female",95,100,98,106,114,513
"Adur 005B","E01031357","55-59 years","Female",68,67,78,86,95,394
"Adur 005B","E01031357","60-64 years","Female",66,73,66,71,75,351
"Adur 005B","E01031357","65-69 years","Female",69,71,74,68,60,342
"Adur 005B","E01031357","70-74 years","Female",64,70,68,73,79,354
"Adur 005B","E01031357","75-79 years","Female",31,30,43,47,49,200
"Adur 005B","E01031357","80-84 years","Female",27,34,27,26,26,140
"Adur 005B","E01031357","85+ years","Female",39,41,40,43,46,209
"Adur 005C","E01031364","0-4 years","Male",73,77,77,75,72,374
"Adur 005C","E01031364","5-9 years","Male",67,68,46,53,57,291
"Adur 005C","E01031364","10-14 years","Male",31,28,38,44,46,187
"Adur 005C","E01031364","15-19 years","Male",23,24,22,25,26,120
"Adur 005C","E01031364","20-24 years","Male",31,34,33,36,35,169
"Adur 005C","E01031364","25-29 years","Male",70,66,65,74,79,354
"Adur 005C","E01031364","30-34 years","Male",77,60,61,53,58,309
"Adur 005C","E01031364","35-39 years","Male",58,58,58,57,55,286
"Adur 005C","E01031364","40-44 years","Male",62,59,50,52,47,270
"Adur 005C","E01031364","45-49 years","Male",37,43,51,50,53,234
"Adur 005C","E01031364","50-54 years","Male",51,52,60,52,47,262
"Adur 005C","E01031364","55-59 years","Male",50,49,51,61,74,285
"Adur 005C","E01031364","60-64 years","Male",46,47,47,51,50,241
"Adur 005C","E01031364","65-69 years","Male",39,34,39,39,37,188
"Adur 005C","E01031364","70-74 years","Male",37,36,31,31,32,167
"Adur 005C","E01031364","75-79 years","Male",19,16,23,23,22,103
"Adur 005C","E01031364","80-84 years","Male",18,21,24,23,21,107
"Adur 005C","E01031364","85+ years","Male",12,11,12,14,16,65
"Adur 005C","E01031364","0-4 years","Female",54,55,57,58,62,286
"Adur 005C","E01031364","5-9 years","Female",50,48,52,48,48,246
"Adur 005C","E01031364","10-14 years","Female",12,16,15,22,25,90
"Adur 005C","E01031364","15-19 years","Female",21,24,16,17,12,90
"Adur 005C","E01031364","20-24 years","Female",51,54,51,45,48,249
"Adur 005C","E01031364","25-29 years","Female",74,60,61,74,82,351
"Adur 005C","E01031364","30-34 years","Female",67,74,73,70,64,348
"Adur 005C","E01031364","35-39 years","Female",75,74,64,70,71,354
"Adur 005C","E01031364","40-44 years","Female",69,69,67,67,75,347
"Adur 005C","E01031364","45-49 years","Female",56,58,59,63,55,291
"Adur 005C","E01031364","50-54 years","Female",54,55,58,57,68,292
"Adur 005C","E01031364","55-59 years","Female",48,48,50,54,49,249
"Adur 005C","E01031364","60-64 years","Female",51,56,61,53,49,270
"Adur 005C","E01031364","65-69 years","Female",60,51,50,57,67,285
"Adur 005C","E01031364","70-74 years","Female",40,51,59,63,61,274
"Adur 005C","E01031364","75-79 years","Female",30,34,39,32,43,178
"Adur 005C","E01031364","80-84 years","Female",28,29,25,35,33,150
"Adur 005C","E01031364","85+ years","Female",29,29,30,28,25,141
"Adur 005D","E01031368","0-4 years","Male",46,38,31,25,23,163
"Adur 005D","E01031368","5-9 years","Male",44,51,59,62,64,280
"Adur 005D","E01031368","10-14 years","Male",43,38,42,41,39,203
"Adur 005D","E01031368","15-19 years","Male",17,19,21,19,25,101
"Adur 005D","E01031368","20-24 years","Male",22,27,26,19,19,113
"Adur 005D","E01031368","25-29 years","Male",24,25,30,29,24,132
"Adur 005D","E01031368","30-34 years","Male",21,16,17,16,20,90
"Adur 005D","E01031368","35-39 years","Male",31,28,22,19,22,122
"Adur 005D","E01031368","40-44 years","Male",34,37,42,47,41,201
"Adur 005D","E01031368","45-49 years","Male",53,47,49,45,42,236
"Adur 005D","E01031368","50-54 years","Male",48,53,54,52,56,263
"Adur 005D","E01031368","55-59 years","Male",44,44,41,39,48,216
"Adur 005D","E01031368","60-64 years","Male",41,38,34,38,33,184
"Adur 005D","E01031368","65-69 years","Male",61,57,59,54,49,280
"Adur 005D","E01031368","70-74 years","Male",35,38,44,47,48,212
"Adur 005D","E01031368","75-79 years","Male",22,22,26,25,19,114
"Adur 005D","E01031368","80-84 years","Male",13,15,12,15,20,75
"Adur 005D","E01031368","85+ years","Male",17,16,17,16,20,86
"Adur 005D","E01031368","0-4 years","Female",39,34,39,27,29,168
"Adur 005D","E01031368","5-9 years","Female",35,35,41,50,49,210
"Adur 005D","E01031368","10-14 years","Female",22,20,21,27,34,124
"Adur 005D","E01031368","15-19 years","Female",20,18,21,15,16,90
"Adur 005D","E01031368","20-24 years","Female",33,28,29,17,16,123
"Adur 005D","E01031368","25-29 years","Female",23,22,28,30,28,131
"Adur 005D","E01031368","30-34 years","Female",22,19,22,26,26,115
"Adur 005D","E01031368","35-39 years","Female",42,35,34,36,36,183
"Adur 005D","E01031368","40-44 years","Female",53,67,57,55,43,275
"Adur 005D","E01031368","45-49 years","Female",46,38,46,48,59,237
"Adur 005D","E01031368","50-54 years","Female",34,42,40,40,36,192
"Adur 005D","E01031368","55-59 years","Female",50,49,43,50,51,243
"Adur 005D","E01031368","60-64 years","Female",52,58,60,54,57,281
"Adur 005D","E01031368","65-69 years","Female",52,50,47,43,44,236
"Adur 005D","E01031368","70-74 years","Female",50,53,57,68,67,295
"Adur 005D","E01031368","75-79 years","Female",28,28,28,31,30,145
"Adur 005D","E01031368","80-84 years","Female",24,23,29,26,20,122
"Adur 005D","E01031368","85+ years","Female",36,29,25,28,35,153
"Adur 005E","E01031369","0-4 years","Male",39,37,27,34,26,163
"Adur 005E","E01031369","5-9 years","Male",34,32,29,24,24,143
"Adur 005E","E01031369","10-14 years","Male",38,46,45,40,43,212
"Adur 005E","E01031369","15-19 years","Male",32,39,38,34,30,173
"Adur 005E","E01031369","20-24 years","Male",34,30,33,39,38,174
"Adur 005E","E01031369","25-29 years","Male",15,15,18,21,22,91
"Adur 005E","E01031369","30-34 years","Male",31,35,29,35,30,160
"Adur 005E","E01031369","35-39 years","Male",25,23,22,19,18,107
"Adur 005E","E01031369","40-44 years","Male",50,44,37,33,23,187
"Adur 005E","E01031369","45-49 years","Male",47,54,49,57,59,266
"Adur 005E","E01031369","50-54 years","Male",34,40,46,41,32,193
"Adur 005E","E01031369","55-59 years","Male",58,53,54,55,63,283
"Adur 005E","E01031369","60-64 years","Male",34,31,41,43,45,194
"Adur 005E","E01031369","65-69 years","Male",33,36,28,29,27,153
"Adur 005E","E01031369","70-74 years","Male",40,38,43,37,35,193
"Adur 005E","E01031369","75-79 years","Male",24,26,26,34,39,149
"Adur 005E","E01031369","80-84 years","Male",25,28,28,28,27,136
"Adur 005E","E01031369","85+ years","Male",28,30,26,28,28,140
"Adur 005E","E01031369","0-4 years","Female",28,24,27,26,21,126
"Adur 005E","E01031369","5-9 years","Female",30,35,35,32,29,161
"Adur 005E","E01031369","10-14 years","Female",33,33,32,32,24,154
"Adur 005E","E01031369","15-19 years","Female",36,34,30,31,30,161
"Adur 005E","E01031369","20-24 years","Female",22,20,26,27,22,117
"Adur 005E","E01031369","25-29 years","Female",21,18,18,14,16,87
"Adur 005E","E01031369","30-34 years","Female",33,29,32,32,26,152
"Adur 005E","E01031369","35-39 years","Female",56,49,45,38,39,227
"Adur 005E","E01031369","40-44 years","Female",56,50,50,53,50,259
"Adur 005E","E01031369","45-49 years","Female",59,68,65,59,52,303
"Adur 005E","E01031369","50-54 years","Female",54,51,42,46,56,249
"Adur 005E","E01031369","55-59 years","Female",36,38,42,48,48,212
"Adur 005E","E01031369","60-64 years","Female",43,44,39,40,40,206
"Adur 005E","E01031369","65-69 years","Female",56,46,44,39,39,224
"Adur 005E","E01031369","70-74 years","Female",43,55,61,68,76,303
"Adur 005E","E01031369","75-79 years","Female",40,40,42,46,41,209
"Adur 005E","E01031369","80-84 years","Female",50,50,52,56,52,260
"Adur 005E","E01031369","85+ years","Female",77,74,71,77,71,370
"Adur 006A","E01031344","0-4 years","Male",40,41,38,31,29,179
"Adur 006A","E01031344","5-9 years","Male",39,35,34,45,44,197
"Adur 006A","E01031344","10-14 years","Male",48,44,40,41,44,217
"Adur 006A","E01031344","15-19 years","Male",41,39,43,43,39,205
"Adur 006A","E01031344","20-24 years","Male",32,32,34,37,39,174
"Adur 006A","E01031344","25-29 years","Male",38,40,31,33,34,176
"Adur 006A","E01031344","30-34 years","Male",41,42,43,43,41,210
"Adur 006A","E01031344","35-39 years","Male",34,38,31,35,38,176
"Adur 006A","E01031344","40-44 years","Male",45,34,30,36,31,176
"Adur 006A","E01031344","45-49 years","Male",78,77,76,68,56,355
"Adur 006A","E01031344","50-54 years","Male",53,59,60,62,66,300
"Adur 006A","E01031344","55-59 years","Male",43,45,47,56,55,246
"Adur 006A","E01031344","60-64 years","Male",53,45,50,45,45,238
"Adur 006A","E01031344","65-69 years","Male",43,40,37,35,37,192
"Adur 006A","E01031344","70-74 years","Male",43,42,41,42,42,210
"Adur 006A","E01031344","75-79 years","Male",27,24,24,25,29,129
"Adur 006A","E01031344","80-84 years","Male",9,10,9,12,12,52
"Adur 006A","E01031344","85+ years","Male",10,6,7,7,10,40
"Adur 006A","E01031344","0-4 years","Female",32,27,33,35,34,161
"Adur 006A","E01031344","5-9 years","Female",34,35,31,31,32,163
"Adur 006A","E01031344","10-14 years","Female",33,26,36,33,29,157
"Adur 006A","E01031344","15-19 years","Female",38,48,54,53,59,252
"Adur 006A","E01031344","20-24 years","Female",26,20,21,21,22,110
"Adur 006A","E01031344","25-29 years","Female",37,40,35,36,39,187
"Adur 006A","E01031344","30-34 years","Female",38,40,38,39,36,191
"Adur 006A","E01031344","35-39 years","Female",53,42,48,47,47,237
"Adur 006A","E01031344","40-44 years","Female",46,46,41,45,42,220
"Adur 006A","E01031344","45-49 years","Female",50,46,50,51,54,251
"Adur 006A","E01031344","50-54 years","Female",61,65,65,61,51,303
"Adur 006A","E01031344","55-59 years","Female",47,45,48,51,59,250
"Adur 006A","E01031344","60-64 years","Female",44,44,49,45,41,223
"Adur 006A","E01031344","65-69 years","Female",44,43,45,41,45,218
"Adur 006A","E01031344","70-74 years","Female",41,46,46,44,37,214
"Adur 006A","E01031344","75-79 years","Female",32,32,28,34,38,164
"Adur 006A","E01031344","80-84 years","Female",24,23,25,25,25,122
"Adur 006A","E01031344","85+ years","Female",18,17,16,14,16,81
"Adur 006B","E01031346","0-4 years","Male",51,58,53,46,40,248
"Adur 006B","E01031346","5-9 years","Male",53,44,64,58,57,276
"Adur 006B","E01031346","10-14 years","Male",34,44,37,44,49,208
"Adur 006B","E01031346","15-19 years","Male",28,26,23,26,23,126
"Adur 006B","E01031346","20-24 years","Male",24,26,24,18,20,112
"Adur 006B","E01031346","25-29 years","Male",49,46,52,47,49,243
"Adur 006B","E01031346","30-34 years","Male",36,37,40,44,42,199
"Adur 006B","E01031346","35-39 years","Male",49,44,52,50,48,243
"Adur 006B","E01031346","40-44 years","Male",47,44,39,37,35,202
"Adur 006B","E01031346","45-49 years","Male",41,42,43,40,48,214
"Adur 006B","E01031346","50-54 years","Male",57,58,53,54,48,270
"Adur 006B","E01031346","55-59 years","Male",58,71,75,68,65,337
"Adur 006B","E01031346","60-64 years","Male",45,41,39,43,46,214
"Adur 006B","E01031346","65-69 years","Male",57,54,51,49,48,259
"Adur 006B","E01031346","70-74 years","Male",47,54,55,49,44,249
"Adur 006B","E01031346","75-79 years","Male",40,41,42,48,48,219
"Adur 006B","E01031346","80-84 years","Male",25,26,23,21,28,123
"Adur 006B","E01031346","85+ years","Male",19,17,18,21,16,91
"Adur 006B","E01031346","0-4 years","Female",43,46,43,52,50,234
"Adur 006B","E01031346","5-9 years","Female",36,33,34,36,29,168
"Adur 006B","E01031346","10-14 years","Female",47,38,47,45,49,226
"Adur 006B","E01031346","15-19 years","Female",22,29,33,37,30,151
"Adur 006B","E01031346","20-24 years","Female",28,28,25,29,28,138
"Adur 006B","E01031346","25-29 years","Female",44,46,46,48,53,237
"Adur 006B","E01031346","30-34 years","Female",48,44,40,43,40,215
"Adur 006B","E01031346","35-39 years","Female",54,56,57,50,51,268
"Adur 006B","E01031346","40-44 years","Female",36,36,39,46,42,199
"Adur 006B","E01031346","45-49 years","Female",48,43,35,36,31,193
"Adur 006B","E01031346","50-54 years","Female",40,43,47,47,47,224
"Adur 006B","E01031346","55-59 years","Female",42,44,44,54,61,245
"Adur 006B","E01031346","60-64 years","Female",61,55,58,56,43,273
"Adur 006B","E01031346","65-69 years","Female",65,57,49,48,60,279
"Adur 006B","E01031346","70-74 years","Female",57,69,71,59,55,311
"Adur 006B","E01031346","75-79 years","Female",38,38,43,52,51,222
"Adur 006B","E01031346","80-84 years","Female",35,36,34,36,36,177
"Adur 006B","E01031346","85+ years","Female",24,26,22,22,21,115
"Adur 006C","E01031361","0-4 years","Male",47,50,52,47,40,236
"Adur 006C","E01031361","5-9 years","Male",41,40,37,36,38,192
"Adur 006C","E01031361","10-14 years","Male",57,65,64,59,55,300
"Adur 006C","E01031361","15-19 years","Male",51,40,45,42,50,228
"Adur 006C","E01031361","20-24 years","Male",51,52,46,44,41,234
"Adur 006C","E01031361","25-29 years","Male",33,31,28,28,30,150
"Adur 006C","E01031361","30-34 years","Male",36,38,42,39,40,195
"Adur 006C","E01031361","35-39 years","Male",52,45,36,40,35,208
"Adur 006C","E01031361","40-44 years","Male",53,46,51,48,56,254
"Adur 006C","E01031361","45-49 years","Male",45,53,50,47,43,238
"Adur 006C","E01031361","50-54 years","Male",50,49,49,51,47,246
"Adur 006C","E01031361","55-59 years","Male",46,56,48,43,45,238
"Adur 006C","E01031361","60-64 years","Male",29,28,35,34,35,161
"Adur 006C","E01031361","65-69 years","Male",42,39,28,31,31,171
"Adur 006C","E01031361","70-74 years","Male",40,44,49,46,47,226
"Adur 006C","E01031361","75-79 years","Male",24,21,29,39,35,148
"Adur 006C","E01031361","80-84 years","Male",18,22,18,13,15,86
"Adur 006C","E01031361","85+ years","Male",7,6,4,9,9,35
"Adur 006C","E01031361","0-4 years","Female",49,47,39,41,43,219
"Adur 006C","E01031361","5-9 years","Female",42,42,44,45,40,213
"Adur 006C","E01031361","10-14 years","Female",43,34,33,38,40,188
"Adur 006C","E01031361","15-19 years","Female",40,46,42,36,38,202
"Adur 006C","E01031361","20-24 years","Female",36,33,36,37,38,180
"Adur 006C","E01031361","25-29 years","Female",36,38,36,31,36,177
"Adur 006C","E01031361","30-34 years","Female",47,47,49,39,36,218
"Adur 006C","E01031361","35-39 years","Female",51,54,52,58,63,278
"Adur 006C","E01031361","40-44 years","Female",56,50,42,44,41,233
"Adur 006C","E01031361","45-49 years","Female",50,55,56,49,44,254
"Adur 006C","E01031361","50-54 years","Female",53,55,60,63,69,300
"Adur 006C","E01031361","55-59 years","Female",49,49,40,44,39,221
"Adur 006C","E01031361","60-64 years","Female",43,43,47,47,49,229
"Adur 006C","E01031361","65-69 years","Female",56,53,48,49,52,258
"Adur 006C","E01031361","70-74 years","Female",38,44,46,42,40,210
"Adur 006C","E01031361","75-79 years","Female",34,35,38,46,42,195
"Adur 006C","E01031361","80-84 years","Female",22,24,22,23,24,115
"Adur 006C","E01031361","85+ years","Female",16,16,15,13,18,78
"Adur 006D","E01031362","0-4 years","Male",25,23,28,27,24,127
"Adur 006D","E01031362","5-9 years","Male",43,49,47,43,36,218
"Adur 006D","E01031362","10-14 years","Male",37,33,40,45,55,210
"Adur 006D","E01031362","15-19 years","Male",54,48,38,40,36,216
"Adur 006D","E01031362","20-24 years","Male",30,30,31,27,29,147
"Adur 006D","E01031362","25-29 years","Male",22,21,21,28,25,117
"Adur 006D","E01031362","30-34 years","Male",31,30,32,33,27,153
"Adur 006D","E01031362","35-39 years","Male",38,48,44,37,33,200
"Adur 006D","E01031362","40-44 years","Male",42,34,35,40,40,191
"Adur 006D","E01031362","45-49 years","Male",36,40,39,41,38,194
"Adur 006D","E01031362","50-54 years","Male",75,73,68,60,53,329
"Adur 006D","E01031362","55-59 years","Male",33,31,36,42,58,200
"Adur 006D","E01031362","60-64 years","Male",39,42,40,45,34,200
"Adur 006D","E01031362","65-69 years","Male",38,31,24,23,20,136
"Adur 006D","E01031362","70-74 years","Male",32,39,38,38,38,185
"Adur 006D","E01031362","75-79 years","Male",20,16,19,18,22,95
"Adur 006D","E01031362","80-84 years","Male",19,18,18,15,12,82
"Adur 006D","E01031362","85+ years","Male",17,19,13,17,17,83
"Adur 006D","E01031362","0-4 years","Female",42,36,36,39,30,183
"Adur 006D","E01031362","5-9 years","Female",36,34,29,39,37,175
"Adur 006D","E01031362","10-14 years","Female",42,46,53,58,43,242
"Adur 006D","E01031362","15-19 years","Female",37,27,25,26,33,148
"Adur 006D","E01031362","20-24 years","Female",33,38,34,32,28,165
"Adur 006D","E01031362","25-29 years","Female",31,34,32,29,26,152
"Adur 006D","E01031362","30-34 years","Female",44,42,44,47,41,218
"Adur 006D","E01031362","35-39 years","Female",53,59,55,54,56,277
"Adur 006D","E01031362","40-44 years","Female",45,38,49,56,55,243
"Adur 006D","E01031362","45-49 years","Female",36,39,33,35,39,182
"Adur 006D","E01031362","50-54 years","Female",53,58,54,47,47,259
"Adur 006D","E01031362","55-59 years","Female",38,37,36,43,43,197
"Adur 006D","E01031362","60-64 years","Female",44,38,38,36,32,188
"Adur 006D","E01031362","65-69 years","Female",44,45,51,38,46,224
"Adur 006D","E01031362","70-74 years","Female",34,37,30,42,44,187
"Adur 006D","E01031362","75-79 years","Female",27,25,29,25,21,127
"Adur 006D","E01031362","80-84 years","Female",10,9,10,11,16,56
"Adur 006D","E01031362","85+ years","Female",27,29,27,28,23,134
"Adur 006E","E01031363","0-4 years","Male",29,31,32,30,34,156
"Adur 006E","E01031363","5-9 years","Male",28,26,33,31,27,145
"Adur 006E","E01031363","10-14 years","Male",21,24,22,19,23,109
"Adur 006E","E01031363","15-19 years","Male",36,29,24,24,20,133
"Adur 006E","E01031363","20-24 years","Male",30,34,35,39,36,174
"Adur 006E","E01031363","25-29 years","Male",25,26,22,31,37,141
"Adur 006E","E01031363","30-34 years","Male",29,28,23,22,23,125
"Adur 006E","E01031363","35-39 years","Male",39,31,32,34,36,172
"Adur 006E","E01031363","40-44 years","Male",48,59,60,53,47,267
"Adur 006E","E01031363","45-49 years","Male",54,49,46,59,59,267
"Adur 006E","E01031363","50-54 years","Male",48,47,51,43,45,234
"Adur 006E","E01031363","55-59 years","Male",41,42,45,50,52,230
"Adur 006E","E01031363","60-64 years","Male",46,49,46,48,45,234
"Adur 006E","E01031363","65-69 years","Male",58,54,50,42,51,255
"Adur 006E","E01031363","70-74 years","Male",71,73,77,74,62,357
"Adur 006E","E01031363","75-79 years","Male",49,49,51,54,58,261
"Adur 006E","E01031363","80-84 years","Male",34,33,37,39,36,179
"Adur 006E","E01031363","85+ years","Male",30,30,34,31,34,159
"Adur 006E","E01031363","0-4 years","Female",41,44,41,39,36,201
"Adur 006E","E01031363","5-9 years","Female",45,47,49,48,53,242
"Adur 006E","E01031363","10-14 years","Female",18,20,23,24,23,108
"Adur 006E","E01031363","15-19 years","Female",27,24,23,18,18,110
"Adur 006E","E01031363","20-24 years","Female",30,29,30,30,28,147
"Adur 006E","E01031363","25-29 years","Female",25,22,15,19,20,101
"Adur 006E","E01031363","30-34 years","Female",34,29,33,33,34,163
"Adur 006E","E01031363","35-39 years","Female",45,48,52,43,37,225
"Adur 006E","E01031363","40-44 years","Female",45,48,45,40,42,220
"Adur 006E","E01031363","45-49 years","Female",54,42,51,54,56,257
"Adur 006E","E01031363","50-54 years","Female",44,48,44,53,50,239
"Adur 006E","E01031363","55-59 years","Female",57,54,56,44,46,257
"Adur 006E","E01031363","60-64 years","Female",52,54,59,62,63,290
"Adur 006E","E01031363","65-69 years","Female",77,77,68,65,60,347
"Adur 006E","E01031363","70-74 years","Female",74,73,76,67,73,363
"Adur 006E","E01031363","75-79 years","Female",73,75,76,74,70,368
"Adur 006E","E01031363","80-84 years","Female",42,39,46,56,56,239
"Adur 006E","E01031363","85+ years","Female",47,49,56,50,54,256
"Adur 007A","E01031358","0-4 years","Male",44,51,46,38,39,218
"Adur 007A","E01031358","5-9 years","Male",48,40,33,40,41,202
"Adur 007A","E01031358","10-14 years","Male",47,45,46,43,41,222
"Adur 007A","E01031358","15-19 years","Male",46,46,44,47,47,230
"Adur 007A","E01031358","20-24 years","Male",53,50,49,41,48,241
"Adur 007A","E01031358","25-29 years","Male",35,44,39,37,36,191
"Adur 007A","E01031358","30-34 years","Male",31,30,35,34,35,165
"Adur 007A","E01031358","35-39 years","Male",42,43,44,46,50,225
"Adur 007A","E01031358","40-44 years","Male",40,35,37,38,40,190
"Adur 007A","E01031358","45-49 years","Male",49,52,47,38,32,218
"Adur 007A","E01031358","50-54 years","Male",49,49,53,55,64,270
"Adur 007A","E01031358","55-59 years","Male",44,43,48,55,56,246
"Adur 007A","E01031358","60-64 years","Male",51,51,41,43,40,226
"Adur 007A","E01031358","65-69 years","Male",29,35,40,38,46,188
"Adur 007A","E01031358","70-74 years","Male",41,37,35,34,28,175
"Adur 007A","E01031358","75-79 years","Male",32,42,38,43,46,201
"Adur 007A","E01031358","80-84 years","Male",17,11,16,16,11,71
"Adur 007A","E01031358","85+ years","Male",19,28,23,24,24,118
"Adur 007A","E01031358","0-4 years","Female",41,44,47,48,49,229
"Adur 007A","E01031358","5-9 years","Female",44,42,50,46,45,227
"Adur 007A","E01031358","10-14 years","Female",38,44,45,41,51,219
"Adur 007A","E01031358","15-19 years","Female",43,39,38,35,33,188
"Adur 007A","E01031358","20-24 years","Female",31,38,38,35,33,175
"Adur 007A","E01031358","25-29 years","Female",49,48,44,39,37,217
"Adur 007A","E01031358","30-34 years","Female",35,29,29,35,41,169
"Adur 007A","E01031358","35-39 years","Female",46,44,49,49,49,237
"Adur 007A","E01031358","40-44 years","Female",64,58,57,52,52,283
"Adur 007A","E01031358","45-49 years","Female",45,47,48,53,52,245
"Adur 007A","E01031358","50-54 years","Female",57,58,52,58,56,281
"Adur 007A","E01031358","55-59 years","Female",57,57,66,67,67,314
"Adur 007A","E01031358","60-64 years","Female",54,60,55,48,51,268
"Adur 007A","E01031358","65-69 years","Female",51,43,45,49,45,233
"Adur 007A","E01031358","70-74 years","Female",52,60,52,52,50,266
"Adur 007A","E01031358","75-79 years","Female",55,45,49,44,47,240
"Adur 007A","E01031358","80-84 years","Female",23,24,26,30,37,140
"Adur 007A","E01031358","85+ years","Female",24,27,29,33,27,140
"Adur 007B","E01031360","0-4 years","Male",54,50,53,52,49,258
"Adur 007B","E01031360","5-9 years","Male",51,49,60,58,47,265
"Adur 007B","E01031360","10-14 years","Male",56,55,59,59,59,288
"Adur 007B","E01031360","15-19 years","Male",42,42,42,37,45,208
"Adur 007B","E01031360","20-24 years","Male",41,41,40,46,46,214
"Adur 007B","E01031360","25-29 years","Male",43,45,43,38,40,209
"Adur 007B","E01031360","30-34 years","Male",39,41,40,52,51,223
"Adur 007B","E01031360","35-39 years","Male",32,38,42,37,38,187
"Adur 007B","E01031360","40-44 years","Male",39,42,46,46,42,215
"Adur 007B","E01031360","45-49 years","Male",44,39,34,35,42,194
"Adur 007B","E01031360","50-54 years","Male",53,54,56,61,52,276
"Adur 007B","E01031360","55-59 years","Male",54,54,41,41,45,235
"Adur 007B","E01031360","60-64 years","Male",47,45,54,52,60,258
"Adur 007B","E01031360","65-69 years","Male",48,49,47,45,42,231
"Adur 007B","E01031360","70-74 years","Male",46,48,51,48,45,238
"Adur 007B","E01031360","75-79 years","Male",29,25,28,29,37,148
"Adur 007B","E01031360","80-84 years","Male",21,18,16,18,18,91
"Adur 007B","E01031360","85+ years","Male",19,21,23,20,17,100
"Adur 007B","E01031360","0-4 years","Female",58,64,53,43,38,256
"Adur 007B","E01031360","5-9 years","Female",36,37,42,44,47,206
"Adur 007B","E01031360","10-14 years","Female",30,30,34,40,39,173
"Adur 007B","E01031360","15-19 years","Female",41,37,36,28,28,170
"Adur 007B","E01031360","20-24 years","Female",43,35,35,29,27,169
"Adur 007B","E01031360","25-29 years","Female",63,73,68,61,56,321
"Adur 007B","E01031360","30-34 years","Female",44,47,50,53,60,254
"Adur 007B","E01031360","35-39 years","Female",37,41,52,52,52,234
"Adur 007B","E01031360","40-44 years","Female",59,48,46,43,39,235
"Adur 007B","E01031360","45-49 years","Female",59,63,59,62,69,312
"Adur 007B","E01031360","50-54 years","Female",60,55,62,53,49,279
"Adur 007B","E01031360","55-59 years","Female",64,66,63,61,65,319
"Adur 007B","E01031360","60-64 years","Female",34,33,40,43,43,193
"Adur 007B","E01031360","65-69 years","Female",54,46,41,35,38,214
"Adur 007B","E01031360","70-74 years","Female",46,52,60,58,53,269
"Adur 007B","E01031360","75-79 years","Female",28,26,27,33,37,151
"Adur 007B","E01031360","80-84 years","Female",23,28,24,22,23,120
"Adur 007B","E01031360","85+ years","Female",23,26,25,27,25,126
"Adur 007C","E01031376","0-4 years","Male",38,36,37,29,30,170
"Adur 007C","E01031376","5-9 years","Male",38,38,35,42,46,199
"Adur 007C","E01031376","10-14 years","Male",9,12,15,17,19,72
"Adur 007C","E01031376","15-19 years","Male",19,16,10,11,16,72
"Adur 007C","E01031376","20-24 years","Male",22,24,22,12,12,92
"Adur 007C","E01031376","25-29 years","Male",24,27,19,27,27,124
"Adur 007C","E01031376","30-34 years","Male",41,37,42,40,34,194
"Adur 007C","E01031376","35-39 years","Male",26,29,24,24,31,134
"Adur 007C","E01031376","40-44 years","Male",31,27,34,31,29,152
"Adur 007C","E01031376","45-49 years","Male",42,32,27,26,25,152
"Adur 007C","E01031376","50-54 years","Male",49,51,46,48,45,239
"Adur 007C","E01031376","55-59 years","Male",38,35,45,43,39,200
"Adur 007C","E01031376","60-64 years","Male",38,36,37,39,45,195
"Adur 007C","E01031376","65-69 years","Male",58,53,45,47,49,252
"Adur 007C","E01031376","70-74 years","Male",66,62,74,77,63,342
"Adur 007C","E01031376","75-79 years","Male",39,40,36,37,42,194
"Adur 007C","E01031376","80-84 years","Male",37,36,38,31,27,169
"Adur 007C","E01031376","85+ years","Male",28,29,31,31,40,159
"Adur 007C","E01031376","0-4 years","Female",34,33,25,26,25,143
"Adur 007C","E01031376","5-9 years","Female",35,25,26,31,32,149
"Adur 007C","E01031376","10-14 years","Female",14,12,14,15,22,77
"Adur 007C","E01031376","15-19 years","Female",18,15,14,12,11,70
"Adur 007C","E01031376","20-24 years","Female",24,31,20,18,17,110
"Adur 007C","E01031376","25-29 years","Female",22,19,20,17,16,94
"Adur 007C","E01031376","30-34 years","Female",31,29,26,34,39,159
"Adur 007C","E01031376","35-39 years","Female",35,32,31,29,37,164
"Adur 007C","E01031376","40-44 years","Female",40,37,33,31,33,174
"Adur 007C","E01031376","45-49 years","Female",35,44,42,45,47,213
"Adur 007C","E01031376","50-54 years","Female",41,34,43,41,38,197
"Adur 007C","E01031376","55-59 years","Female",34,41,36,36,36,183
"Adur 007C","E01031376","60-64 years","Female",52,60,59,60,63,294
"Adur 007C","E01031376","65-69 years","Female",59,54,56,56,54,279
"Adur 007C","E01031376","70-74 years","Female",58,63,66,67,78,332
"Adur 007C","E01031376","75-79 years","Female",61,51,55,51,45,263
"Adur 007C","E01031376","80-84 years","Female",37,44,43,39,38,201
"Adur 007C","E01031376","85+ years","Female",39,41,35,37,42,194
"Adur 007D","E01031378","0-4 years","Male",64,51,48,50,46,259
"Adur 007D","E01031378","5-9 years","Male",14,18,26,31,34,123
"Adur 007D","E01031378","10-14 years","Male",47,38,36,37,31,189
"Adur 007D","E01031378","15-19 years","Male",25,26,27,27,28,133
"Adur 007D","E01031378","20-24 years","Male",26,20,24,28,31,129
"Adur 007D","E01031378","25-29 years","Male",38,37,34,31,20,160
"Adur 007D","E01031378","30-34 years","Male",27,22,26,25,23,123
"Adur 007D","E01031378","35-39 years","Male",51,51,44,43,34,223
"Adur 007D","E01031378","40-44 years","Male",35,37,39,37,35,183
"Adur 007D","E01031378","45-49 years","Male",67,67,64,61,58,317
"Adur 007D","E01031378","50-54 years","Male",52,59,56,62,68,297
"Adur 007D","E01031378","55-59 years","Male",36,25,25,26,28,140
"Adur 007D","E01031378","60-64 years","Male",50,54,53,49,45,251
"Adur 007D","E01031378","65-69 years","Male",65,60,55,56,54,290
"Adur 007D","E01031378","70-74 years","Male",35,45,56,57,53,246
"Adur 007D","E01031378","75-79 years","Male",32,31,34,32,35,164
"Adur 007D","E01031378","80-84 years","Male",17,19,26,25,35,122
"Adur 007D","E01031378","85+ years","Male",11,13,10,15,14,63
"Adur 007D","E01031378","0-4 years","Female",25,24,31,29,28,137
"Adur 007D","E01031378","5-9 years","Female",37,45,41,35,30,188
"Adur 007D","E01031378","10-14 years","Female",33,31,34,40,45,183
"Adur 007D","E01031378","15-19 years","Female",20,14,23,22,26,105
"Adur 007D","E01031378","20-24 years","Female",27,23,21,23,23,117
"Adur 007D","E01031378","25-29 years","Female",29,25,37,31,27,149
"Adur 007D","E01031378","30-34 years","Female",55,53,48,46,51,253
"Adur 007D","E01031378","35-39 years","Female",42,49,45,48,38,222
"Adur 007D","E01031378","40-44 years","Female",48,38,34,31,43,194
"Adur 007D","E01031378","45-49 years","Female",55,58,56,67,64,300
"Adur 007D","E01031378","50-54 years","Female",41,39,39,35,35,189
"Adur 007D","E01031378","55-59 years","Female",54,66,58,57,58,293
"Adur 007D","E01031378","60-64 years","Female",39,40,47,46,56,228
"Adur 007D","E01031378","65-69 years","Female",61,58,62,50,44,275
"Adur 007D","E01031378","70-74 years","Female",56,51,56,65,63,291
"Adur 007D","E01031378","75-79 years","Female",32,40,43,40,43,198
"Adur 007D","E01031378","80-84 years","Female",35,36,31,31,30,163
"Adur 007D","E01031378","85+ years","Female",23,24,28,26,28,129
"Adur 008A","E01031341","0-4 years","Male",25,19,17,20,20,101
"Adur 008A","E01031341","5-9 years","Male",36,34,33,41,42,186
"Adur 008A","E01031341","10-14 years","Male",46,49,58,52,52,257
"Adur 008A","E01031341","15-19 years","Male",39,37,37,42,40,195
"Adur 008A","E01031341","20-24 years","Male",39,38,38,33,30,178
"Adur 008A","E01031341","25-29 years","Male",50,45,40,41,41,217
"Adur 008A","E01031341","30-34 years","Male",37,49,57,62,59,264
"Adur 008A","E01031341","35-39 years","Male",46,39,35,40,42,202
"Adur 008A","E01031341","40-44 years","Male",34,33,33,32,32,164
"Adur 008A","E01031341","45-49 years","Male",57,60,63,60,57,297
"Adur 008A","E01031341","50-54 years","Male",67,69,74,67,66,343
"Adur 008A","E01031341","55-59 years","Male",35,33,35,41,42,186
"Adur 008A","E01031341","60-64 years","Male",39,46,40,50,48,223
"Adur 008A","E01031341","65-69 years","Male",27,29,29,30,31,146
"Adur 008A","E01031341","70-74 years","Male",24,22,24,27,25,122
"Adur 008A","E01031341","75-79 years","Male",32,29,30,30,35,156
"Adur 008A","E01031341","80-84 years","Male",15,16,20,17,13,81
"Adur 008A","E01031341","85+ years","Male",13,16,11,7,10,57
"Adur 008A","E01031341","0-4 years","Female",27,29,25,22,23,126
"Adur 008A","E01031341","5-9 years","Female",64,59,57,49,43,272
"Adur 008A","E01031341","10-14 years","Female",37,44,44,47,50,222
"Adur 008A","E01031341","15-19 years","Female",34,30,26,29,31,150
"Adur 008A","E01031341","20-24 years","Female",26,34,35,36,32,163
"Adur 008A","E01031341","25-29 years","Female",65,54,49,46,48,262
"Adur 008A","E01031341","30-34 years","Female",35,45,52,52,49,233
"Adur 008A","E01031341","35-39 years","Female",36,40,41,45,42,204
"Adur 008A","E01031341","40-44 years","Female",32,30,35,32,35,164
"Adur 008A","E01031341","45-49 years","Female",57,57,55,53,48,270
"Adur 008A","E01031341","50-54 years","Female",71,70,62,69,69,341
"Adur 008A","E01031341","55-59 years","Female",43,43,48,53,56,243
"Adur 008A","E01031341","60-64 years","Female",38,37,36,39,43,193
"Adur 008A","E01031341","65-69 years","Female",42,42,37,35,28,184
"Adur 008A","E01031341","70-74 years","Female",34,40,47,52,52,225
"Adur 008A","E01031341","75-79 years","Female",33,34,29,23,25,144
"Adur 008A","E01031341","80-84 years","Female",29,26,28,25,23,131
"Adur 008A","E01031341","85+ years","Female",30,25,25,24,19,123
"Adur 008B","E01031342","0-4 years","Male",42,42,41,43,42,210
"Adur 008B","E01031342","5-9 years","Male",30,31,35,34,34,164
"Adur 008B","E01031342","10-14 years","Male",30,28,26,23,22,129
"Adur 008B","E01031342","15-19 years","Male",24,25,24,24,24,121
"Adur 008B","E01031342","20-24 years","Male",39,35,36,32,32,174
"Adur 008B","E01031342","25-29 years","Male",56,60,42,45,38,241
"Adur 008B","E01031342","30-34 years","Male",47,50,54,55,62,268
"Adur 008B","E01031342","35-39 years","Male",31,32,34,35,39,171
"Adur 008B","E01031342","40-44 years","Male",36,36,37,34,34,177
"Adur 008B","E01031342","45-49 years","Male",58,60,51,50,42,261
"Adur 008B","E01031342","50-54 years","Male",33,35,38,46,39,191
"Adur 008B","E01031342","55-59 years","Male",50,47,46,44,43,230
"Adur 008B","E01031342","60-64 years","Male",42,39,39,40,44,204
"Adur 008B","E01031342","65-69 years","Male",69,62,54,53,48,286
"Adur 008B","E01031342","70-74 years","Male",68,73,62,63,61,327
"Adur 008B","E01031342","75-79 years","Male",52,53,52,52,59,268
"Adur 008B","E01031342","80-84 years","Male",51,47,52,50,50,250
"Adur 008B","E01031342","85+ years","Male",48,54,51,48,43,244
"Adur 008B","E01031342","0-4 years","Female",48,39,47,50,58,242
"Adur 008B","E01031342","5-9 years","Female",29,36,32,32,33,162
"Adur 008B","E01031342","10-14 years","Female",36,35,33,35,41,180
"Adur 008B","E01031342","15-19 years","Female",25,25,29,26,42,147
"Adur 008B","E01031342","20-24 years","Female",32,33,44,41,30,180
"Adur 008B","E01031342","25-29 years","Female",49,44,41,44,54,232
"Adur 008B","E01031342","30-34 years","Female",52,51,49,39,42,233
"Adur 008B","E01031342","35-39 years","Female",37,46,40,39,29,191
"Adur 008B","E01031342","40-44 years","Female",37,29,34,35,41,176
"Adur 008B","E01031342","45-49 years","Female",55,52,51,54,51,263
"Adur 008B","E01031342","50-54 years","Female",44,46,41,38,48,217
"Adur 008B","E01031342","55-59 years","Female",37,38,41,44,52,212
"Adur 008B","E01031342","60-64 years","Female",54,46,44,44,39,227
"Adur 008B","E01031342","65-69 years","Female",87,79,80,77,66,389
"Adur 008B","E01031342","70-74 years","Female",70,86,82,90,103,431
"Adur 008B","E01031342","75-79 years","Female",81,74,85,78,80,398
"Adur 008B","E01031342","80-84 years","Female",59,61,68,68,63,319
"Adur 008B","E01031342","85+ years","Female",64,60,51,59,67,301
"Adur 008C","E01031343","0-4 years","Male",27,23,22,26,25,123
"Adur 008C","E01031343","5-9 years","Male",39,38,40,37,31,185
"Adur 008C","E01031343","10-14 years","Male",28,33,32,36,44,173
"Adur 008C","E01031343","15-19 years","Male",28,32,29,23,26,138
"Adur 008C","E01031343","20-24 years","Male",29,30,29,36,29,153
"Adur 008C","E01031343","25-29 years","Male",39,40,41,41,34,195
"Adur 008C","E01031343","30-34 years","Male",33,40,43,45,42,203
"Adur 008C","E01031343","35-39 years","Male",45,37,43,41,42,208
"Adur 008C","E01031343","40-44 years","Male",30,31,30,33,32,156
"Adur 008C","E01031343","45-49 years","Male",73,71,64,58,54,320
"Adur 008C","E01031343","50-54 years","Male",46,44,49,46,46,231
"Adur 008C","E01031343","55-59 years","Male",40,43,40,52,56,231
"Adur 008C","E01031343","60-64 years","Male",44,45,46,45,48,228
"Adur 008C","E01031343","65-69 years","Male",46,44,40,42,41,213
"Adur 008C","E01031343","70-74 years","Male",34,30,31,35,38,168
"Adur 008C","E01031343","75-79 years","Male",24,28,27,32,27,138
"Adur 008C","E01031343","80-84 years","Male",17,20,25,21,19,102
"Adur 008C","E01031343","85+ years","Male",23,25,24,21,26,119
"Adur 008C","E01031343","0-4 years","Female",33,29,22,32,39,155
"Adur 008C","E01031343","5-9 years","Female",32,34,32,29,29,156
"Adur 008C","E01031343","10-14 years","Female",30,31,39,44,37,181
"Adur 008C","E01031343","15-19 years","Female",41,41,40,43,42,207
"Adur 008C","E01031343","20-24 years","Female",20,22,24,21,21,108
"Adur 008C","E01031343","25-29 years","Female",38,41,35,30,32,176
"Adur 008C","E01031343","30-34 years","Female",43,38,41,49,42,213
"Adur 008C","E01031343","35-39 years","Female",36,41,41,37,43,198
"Adur 008C","E01031343","40-44 years","Female",52,47,49,55,54,257
"Adur 008C","E01031343","45-49 years","Female",42,45,40,38,41,206
"Adur 008C","E01031343","50-54 years","Female",58,48,48,39,35,228
"Adur 008C","E01031343","55-59 years","Female",44,45,43,47,41,220
"Adur 008C","E01031343","60-64 years","Female",51,52,46,48,52,249
"Adur 008C","E01031343","65-69 years","Female",41,41,43,47,46,218
"Adur 008C","E01031343","70-74 years","Female",53,47,43,45,49,237
"Adur 008C","E01031343","75-79 years","Female",50,51,54,51,49,255
"Adur 008C","E01031343","80-84 years","Female",31,35,40,48,52,206
"Adur 008C","E01031343","85+ years","Female",26,27,33,27,26,139
"Adur 008D","E01031377","0-4 years","Male",64,64,60,61,61,310
"Adur 008D","E01031377","5-9 years","Male",45,54,47,56,46,248
"Adur 008D","E01031377","10-14 years","Male",20,21,27,28,34,130
"Adur 008D","E01031377","15-19 years","Male",25,20,22,23,25,115
"Adur 008D","E01031377","20-24 years","Male",51,45,46,46,53,241
"Adur 008D","E01031377","25-29 years","Male",58,68,62,67,58,313
"Adur 008D","E01031377","30-34 years","Male",92,76,71,70,74,383
"Adur 008D","E01031377","35-39 years","Male",49,60,65,61,66,301
"Adur 008D","E01031377","40-44 years","Male",50,57,61,64,66,298
"Adur 008D","E01031377","45-49 years","Male",50,50,51,44,47,242
"Adur 008D","E01031377","50-54 years","Male",59,64,80,73,68,344
"Adur 008D","E01031377","55-59 years","Male",53,46,48,45,49,241
"Adur 008D","E01031377","60-64 years","Male",41,47,47,54,52,241
"Adur 008D","E01031377","65-69 years","Male",45,43,34,32,36,190
"Adur 008D","E01031377","70-74 years","Male",31,35,42,45,43,196
"Adur 008D","E01031377","75-79 years","Male",20,24,20,27,27,118
"Adur 008D","E01031377","80-84 years","Male",25,19,20,15,23,102
"Adur 008D","E01031377","85+ years","Male",20,19,20,24,24,107
"Adur 008D","E01031377","0-4 years","Female",55,53,35,35,50,228
"Adur 008D","E01031377","5-9 years","Female",53,60,67,67,61,308
"Adur 008D","E01031377","10-14 years","Female",21,27,28,33,30,139
"Adur 008D","E01031377","15-19 years","Female",16,21,20,21,19,97
"Adur 008D","E01031377","20-24 years","Female",54,48,47,47,51,247
"Adur 008D","E01031377","25-29 years","Female",76,81,76,71,76,380
"Adur 008D","E01031377","30-34 years","Female",56,54,60,63,64,297
"Adur 008D","E01031377","35-39 years","Female",55,60,72,74,70,331
"Adur 008D","E01031377","40-44 years","Female",50,52,56,61,61,280
"Adur 008D","E01031377","45-49 years","Female",53,56,48,54,51,262
"Adur 008D","E01031377","50-54 years","Female",39,40,41,47,57,224
"Adur 008D","E01031377","55-59 years","Female",59,61,60,54,51,285
"Adur 008D","E01031377","60-64 years","Female",50,49,56,59,60,274
"Adur 008D","E01031377","65-69 years","Female",51,56,54,55,49,265
"Adur 008D","E01031377","70-74 years","Female",46,50,49,56,65,266
"Adur 008D","E01031377","75-79 years","Female",40,41,33,35,37,186
"Adur 008D","E01031377","80-84 years","Female",22,23,31,26,26,128
"Adur 008D","E01031377","85+ years","Female",33,26,28,29,26,142
"Adur 008E","E01031379","0-4 years","Male",35,32,29,30,34,160
"Adur 008E","E01031379","5-9 years","Male",28,33,35,43,43,182
"Adur 008E","E01031379","10-14 years","Male",28,20,24,25,24,121
"Adur 008E","E01031379","15-19 years","Male",48,47,44,32,33,204
"Adur 008E","E01031379","20-24 years","Male",24,26,30,26,26,132
"Adur 008E","E01031379","25-29 years","Male",39,32,30,29,24,154
"Adur 008E","E01031379","30-34 years","Male",38,31,34,35,35,173
"Adur 008E","E01031379","35-39 years","Male",50,54,59,58,55,276
"Adur 008E","E01031379","40-44 years","Male",36,35,31,27,30,159
"Adur 008E","E01031379","45-49 years","Male",58,49,49,43,46,245
"Adur 008E","E01031379","50-54 years","Male",51,56,54,59,55,275
"Adur 008E","E01031379","55-59 years","Male",44,53,60,69,72,298
"Adur 008E","E01031379","60-64 years","Male",47,45,55,41,45,233
"Adur 008E","E01031379","65-69 years","Male",63,60,54,53,53,283
"Adur 008E","E01031379","70-74 years","Male",68,79,80,76,74,377
"Adur 008E","E01031379","75-79 years","Male",38,33,40,54,53,218
"Adur 008E","E01031379","80-84 years","Male",34,28,27,29,35,153
"Adur 008E","E01031379","85+ years","Male",43,47,42,44,38,214
"Adur 008E","E01031379","0-4 years","Female",33,28,23,30,28,142
"Adur 008E","E01031379","5-9 years","Female",38,36,37,35,41,187
"Adur 008E","E01031379","10-14 years","Female",39,35,39,31,31,175
"Adur 008E","E01031379","15-19 years","Female",25,31,31,29,30,146
"Adur 008E","E01031379","20-24 years","Female",29,33,23,21,29,135
"Adur 008E","E01031379","25-29 years","Female",32,25,25,28,24,134
"Adur 008E","E01031379","30-34 years","Female",44,41,49,52,49,235
"Adur 008E","E01031379","35-39 years","Female",32,39,43,51,56,221
"Adur 008E","E01031379","40-44 years","Female",41,34,35,32,30,172
"Adur 008E","E01031379","45-49 years","Female",51,55,54,49,56,265
"Adur 008E","E01031379","50-54 years","Female",60,64,69,69,63,325
"Adur 008E","E01031379","55-59 years","Female",68,71,63,70,65,337
"Adur 008E","E01031379","60-64 years","Female",57,62,56,55,57,287
"Adur 008E","E01031379","65-69 years","Female",75,64,61,59,54,313
"Adur 008E","E01031379","70-74 years","Female",63,78,86,92,93,412
"Adur 008E","E01031379","75-79 years","Female",57,54,50,43,44,248
"Adur 008E","E01031379","80-84 years","Female",45,43,48,61,58,255
"Adur 008E","E01031379","85+ years","Female",75,74,72,64,58,343
"Arun 001A","E01031390","0-4 years","Male",29,29,32,35,43,168
"Arun 001A","E01031390","5-9 years","Male",33,38,29,32,29,161
"Arun 001A","E01031390","10-14 years","Male",46,42,38,34,39,199
"Arun 001A","E01031390","15-19 years","Male",30,35,38,41,42,186
"Arun 001A","E01031390","20-24 years","Male",33,33,29,27,21,143
"Arun 001A","E01031390","25-29 years","Male",21,28,27,30,34,140
"Arun 001A","E01031390","30-34 years","Male",22,21,23,21,17,104
"Arun 001A","E01031390","35-39 years","Male",23,32,28,24,20,127
"Arun 001A","E01031390","40-44 years","Male",29,30,29,28,33,149
"Arun 001A","E01031390","45-49 years","Male",44,43,44,42,34,207
"Arun 001A","E01031390","50-54 years","Male",50,56,54,56,55,271
"Arun 001A","E01031390","55-59 years","Male",49,49,50,49,58,255
"Arun 001A","E01031390","60-64 years","Male",46,46,50,55,53,250
"Arun 001A","E01031390","65-69 years","Male",52,59,53,45,44,253
"Arun 001A","E01031390","70-74 years","Male",49,50,45,45,43,232
"Arun 001A","E01031390","75-79 years","Male",33,28,36,44,43,184
"Arun 001A","E01031390","80-84 years","Male",25,25,24,19,19,112
"Arun 001A","E01031390","85+ years","Male",27,28,31,32,25,143
"Arun 001A","E01031390","0-4 years","Female",26,24,24,21,23,118
"Arun 001A","E01031390","5-9 years","Female",28,31,37,37,38,171
"Arun 001A","E01031390","10-14 years","Female",41,45,40,37,39,202
"Arun 001A","E01031390","15-19 years","Female",45,44,42,48,44,223
"Arun 001A","E01031390","20-24 years","Female",15,17,16,14,15,77
"Arun 001A","E01031390","25-29 years","Female",23,20,23,27,27,120
"Arun 001A","E01031390","30-34 years","Female",21,23,20,17,21,102
"Arun 001A","E01031390","35-39 years","Female",39,49,49,48,35,220
"Arun 001A","E01031390","40-44 years","Female",42,35,36,35,39,187
"Arun 001A","E01031390","45-49 years","Female",56,56,52,47,53,264
"Arun 001A","E01031390","50-54 years","Female",60,58,55,59,54,286
"Arun 001A","E01031390","55-59 years","Female",48,58,51,56,63,276
"Arun 001A","E01031390","60-64 years","Female",48,48,57,54,55,262
"Arun 001A","E01031390","65-69 years","Female",49,45,39,37,37,207
"Arun 001A","E01031390","70-74 years","Female",53,57,58,52,47,267
"Arun 001A","E01031390","75-79 years","Female",33,39,38,36,42,188
"Arun 001A","E01031390","80-84 years","Female",34,25,33,31,26,149
"Arun 001A","E01031390","85+ years","Female",31,30,29,30,33,153
"Arun 001B","E01031391","0-4 years","Male",24,25,25,29,23,126
"Arun 001B","E01031391","5-9 years","Male",39,39,32,32,41,183
"Arun 001B","E01031391","10-14 years","Male",51,44,37,46,47,225
"Arun 001B","E01031391","15-19 years","Male",25,31,36,38,37,167
"Arun 001B","E01031391","20-24 years","Male",27,26,32,28,30,143
"Arun 001B","E01031391","25-29 years","Male",17,17,18,19,22,93
"Arun 001B","E01031391","30-34 years","Male",22,27,26,25,22,122
"Arun 001B","E01031391","35-39 years","Male",25,18,22,22,23,110
"Arun 001B","E01031391","40-44 years","Male",55,60,53,47,50,265
"Arun 001B","E01031391","45-49 years","Male",46,41,43,37,33,200
"Arun 001B","E01031391","50-54 years","Male",57,56,60,55,54,282
"Arun 001B","E01031391","55-59 years","Male",47,51,51,55,54,258
"Arun 001B","E01031391","60-64 years","Male",56,55,60,62,60,293
"Arun 001B","E01031391","65-69 years","Male",61,56,47,49,52,265
"Arun 001B","E01031391","70-74 years","Male",55,64,66,67,67,319
"Arun 001B","E01031391","75-79 years","Male",33,35,39,36,36,179
"Arun 001B","E01031391","80-84 years","Male",26,24,20,22,21,113
"Arun 001B","E01031391","85+ years","Male",20,19,18,20,20,97
"Arun 001B","E01031391","0-4 years","Female",27,32,27,24,33,143
"Arun 001B","E01031391","5-9 years","Female",29,27,35,26,22,139
"Arun 001B","E01031391","10-14 years","Female",30,28,24,32,28,142
"Arun 001B","E01031391","15-19 years","Female",16,16,16,18,26,92
"Arun 001B","E01031391","20-24 years","Female",25,25,24,17,22,113
"Arun 001B","E01031391","25-29 years","Female",21,16,15,21,18,91
"Arun 001B","E01031391","30-34 years","Female",32,34,32,34,30,162
"Arun 001B","E01031391","35-39 years","Female",47,46,46,48,44,231
"Arun 001B","E01031391","40-44 years","Female",53,43,39,39,40,214
"Arun 001B","E01031391","45-49 years","Female",67,62,56,47,45,277
"Arun 001B","E01031391","50-54 years","Female",56,58,56,54,55,279
"Arun 001B","E01031391","55-59 years","Female",55,51,54,69,65,294
"Arun 001B","E01031391","60-64 years","Female",61,66,61,51,64,303
"Arun 001B","E01031391","65-69 years","Female",92,88,78,85,73,416
"Arun 001B","E01031391","70-74 years","Female",57,76,86,88,90,397
"Arun 001B","E01031391","75-79 years","Female",49,46,53,50,48,246
"Arun 001B","E01031391","80-84 years","Female",17,19,20,26,34,116
"Arun 001B","E01031391","85+ years","Female",30,28,29,28,27,142
"Arun 001C","E01031392","0-4 years","Male",15,24,19,19,19,96
"Arun 001C","E01031392","5-9 years","Male",51,42,45,35,34,207
"Arun 001C","E01031392","10-14 years","Male",28,33,30,30,32,153
"Arun 001C","E01031392","15-19 years","Male",22,26,25,19,14,106
"Arun 001C","E01031392","20-24 years","Male",21,18,17,16,14,86
"Arun 001C","E01031392","25-29 years","Male",30,31,25,21,26,133
"Arun 001C","E01031392","30-34 years","Male",38,35,34,29,23,159
"Arun 001C","E01031392","35-39 years","Male",29,30,33,32,30,154
"Arun 001C","E01031392","40-44 years","Male",41,39,36,31,29,176
"Arun 001C","E01031392","45-49 years","Male",49,47,47,46,43,232
"Arun 001C","E01031392","50-54 years","Male",52,53,48,45,38,236
"Arun 001C","E01031392","55-59 years","Male",62,60,56,51,58,287
"Arun 001C","E01031392","60-64 years","Male",54,57,68,72,63,314
"Arun 001C","E01031392","65-69 years","Male",63,58,53,52,52,278
"Arun 001C","E01031392","70-74 years","Male",68,70,76,70,76,360
"Arun 001C","E01031392","75-79 years","Male",44,46,55,66,60,271
"Arun 001C","E01031392","80-84 years","Male",29,32,32,31,47,171
"Arun 001C","E01031392","85+ years","Male",32,26,27,32,34,151
"Arun 001C","E01031392","0-4 years","Female",30,25,22,22,20,119
"Arun 001C","E01031392","5-9 years","Female",28,30,33,25,21,137
"Arun 001C","E01031392","10-14 years","Female",20,21,24,21,18,104
"Arun 001C","E01031392","15-19 years","Female",25,21,22,24,30,122
"Arun 001C","E01031392","20-24 years","Female",36,27,22,33,24,142
"Arun 001C","E01031392","25-29 years","Female",14,18,17,18,20,87
"Arun 001C","E01031392","30-34 years","Female",30,32,26,28,24,140
"Arun 001C","E01031392","35-39 years","Female",25,29,32,31,28,145
"Arun 001C","E01031392","40-44 years","Female",44,37,33,33,35,182
"Arun 001C","E01031392","45-49 years","Female",57,62,56,53,49,277
"Arun 001C","E01031392","50-54 years","Female",54,56,64,58,44,276
"Arun 001C","E01031392","55-59 years","Female",63,61,61,54,56,295
"Arun 001C","E01031392","60-64 years","Female",75,75,76,80,81,387
"Arun 001C","E01031392","65-69 years","Female",74,80,84,82,92,412
"Arun 001C","E01031392","70-74 years","Female",63,60,56,72,67,318
"Arun 001C","E01031392","75-79 years","Female",38,41,47,51,58,235
"Arun 001C","E01031392","80-84 years","Female",37,39,38,40,50,204
"Arun 001C","E01031392","85+ years","Female",66,61,65,64,60,316
"Arun 001D","E01031465","0-4 years","Male",24,20,19,27,27,117
"Arun 001D","E01031465","5-9 years","Male",35,35,30,28,25,153
"Arun 001D","E01031465","10-14 years","Male",57,59,57,51,43,267
"Arun 001D","E01031465","15-19 years","Male",49,41,41,41,55,227
"Arun 001D","E01031465","20-24 years","Male",24,24,28,27,22,125
"Arun 001D","E01031465","25-29 years","Male",23,20,18,18,22,101
"Arun 001D","E01031465","30-34 years","Male",34,28,34,36,30,162
"Arun 001D","E01031465","35-39 years","Male",22,26,31,33,33,145
"Arun 001D","E01031465","40-44 years","Male",32,25,18,18,18,111
"Arun 001D","E01031465","45-49 years","Male",70,62,60,52,40,284
"Arun 001D","E01031465","50-54 years","Male",54,59,64,61,59,297
"Arun 001D","E01031465","55-59 years","Male",53,54,56,57,52,272
"Arun 001D","E01031465","60-64 years","Male",57,58,64,62,62,303
"Arun 001D","E01031465","65-69 years","Male",54,51,50,53,62,270
"Arun 001D","E01031465","70-74 years","Male",56,58,57,52,51,274
"Arun 001D","E01031465","75-79 years","Male",38,35,39,46,52,210
"Arun 001D","E01031465","80-84 years","Male",18,21,21,27,24,111
"Arun 001D","E01031465","85+ years","Male",20,18,15,17,17,87
"Arun 001D","E01031465","0-4 years","Female",29,25,17,20,15,106
"Arun 001D","E01031465","5-9 years","Female",34,32,36,28,30,160
"Arun 001D","E01031465","10-14 years","Female",42,41,37,30,34,184
"Arun 001D","E01031465","15-19 years","Female",41,41,39,40,30,191
"Arun 001D","E01031465","20-24 years","Female",18,14,15,17,18,82
"Arun 001D","E01031465","25-29 years","Female",29,29,25,24,22,129
"Arun 001D","E01031465","30-34 years","Female",18,15,17,18,20,88
"Arun 001D","E01031465","35-39 years","Female",31,33,27,25,24,140
"Arun 001D","E01031465","40-44 years","Female",37,40,32,28,27,164
"Arun 001D","E01031465","45-49 years","Female",75,60,59,52,43,289
"Arun 001D","E01031465","50-54 years","Female",71,82,79,75,73,380
"Arun 001D","E01031465","55-59 years","Female",58,61,60,60,63,302
"Arun 001D","E01031465","60-64 years","Female",45,48,48,51,56,248
"Arun 001D","E01031465","65-69 years","Female",60,51,56,49,48,264
"Arun 001D","E01031465","70-74 years","Female",52,53,52,60,65,282
"Arun 001D","E01031465","75-79 years","Female",27,32,36,36,43,174
"Arun 001D","E01031465","80-84 years","Female",22,24,24,27,22,119
"Arun 001D","E01031465","85+ years","Female",31,31,21,26,34,143
"Arun 002A","E01031386","0-4 years","Male",31,31,34,28,25,149
"Arun 002A","E01031386","5-9 years","Male",53,50,55,53,52,263
"Arun 002A","E01031386","10-14 years","Male",40,37,34,41,39,191
"Arun 002A","E01031386","15-19 years","Male",60,51,42,34,39,226
"Arun 002A","E01031386","20-24 years","Male",28,34,31,36,30,159
"Arun 002A","E01031386","25-29 years","Male",21,24,26,27,27,125
"Arun 002A","E01031386","30-34 years","Male",27,31,26,25,29,138
"Arun 002A","E01031386","35-39 years","Male",45,35,39,44,42,205
"Arun 002A","E01031386","40-44 years","Male",48,47,38,40,37,210
"Arun 002A","E01031386","45-49 years","Male",53,52,54,46,45,250
"Arun 002A","E01031386","50-54 years","Male",55,61,61,68,57,302
"Arun 002A","E01031386","55-59 years","Male",52,53,53,56,51,265
"Arun 002A","E01031386","60-64 years","Male",41,40,32,35,46,194
"Arun 002A","E01031386","65-69 years","Male",42,41,44,38,32,197
"Arun 002A","E01031386","70-74 years","Male",55,49,52,54,54,264
"Arun 002A","E01031386","75-79 years","Male",24,30,32,25,25,136
"Arun 002A","E01031386","80-84 years","Male",19,19,19,21,19,97
"Arun 002A","E01031386","85+ years","Male",21,20,23,24,27,115
"Arun 002A","E01031386","0-4 years","Female",32,28,29,33,31,153
"Arun 002A","E01031386","5-9 years","Female",53,51,46,48,48,246
"Arun 002A","E01031386","10-14 years","Female",41,42,45,43,40,211
"Arun 002A","E01031386","15-19 years","Female",19,18,23,21,17,98
"Arun 002A","E01031386","20-24 years","Female",37,28,30,39,41,175
"Arun 002A","E01031386","25-29 years","Female",23,28,28,28,26,133
"Arun 002A","E01031386","30-34 years","Female",34,30,33,38,40,175
"Arun 002A","E01031386","35-39 years","Female",45,40,35,24,28,172
"Arun 002A","E01031386","40-44 years","Female",48,41,38,47,47,221
"Arun 002A","E01031386","45-49 years","Female",57,58,60,60,54,289
"Arun 002A","E01031386","50-54 years","Female",65,59,66,64,60,314
"Arun 002A","E01031386","55-59 years","Female",46,48,47,47,57,245
"Arun 002A","E01031386","60-64 years","Female",46,43,41,43,41,214
"Arun 002A","E01031386","65-69 years","Female",59,60,58,62,61,300
"Arun 002A","E01031386","70-74 years","Female",38,41,45,36,39,199
"Arun 002A","E01031386","75-79 years","Female",50,43,43,48,42,226
"Arun 002A","E01031386","80-84 years","Female",14,12,22,22,27,97
"Arun 002A","E01031386","85+ years","Female",15,14,14,12,12,67
"Arun 002B","E01031387","0-4 years","Male",38,37,39,43,35,192
"Arun 002B","E01031387","5-9 years","Male",46,51,53,45,42,237
"Arun 002B","E01031387","10-14 years","Male",38,34,36,47,50,205
"Arun 002B","E01031387","15-19 years","Male",45,43,44,36,35,203
"Arun 002B","E01031387","20-24 years","Male",33,35,30,37,35,170
"Arun 002B","E01031387","25-29 years","Male",46,44,45,41,39,215
"Arun 002B","E01031387","30-34 years","Male",27,26,27,28,25,133
"Arun 002B","E01031387","35-39 years","Male",32,29,31,34,31,157
"Arun 002B","E01031387","40-44 years","Male",43,39,38,35,40,195
"Arun 002B","E01031387","45-49 years","Male",53,56,54,49,37,249
"Arun 002B","E01031387","50-54 years","Male",55,56,60,61,61,293
"Arun 002B","E01031387","55-59 years","Male",62,61,62,58,50,293
"Arun 002B","E01031387","60-64 years","Male",54,54,56,57,57,278
"Arun 002B","E01031387","65-69 years","Male",45,46,44,47,49,231
"Arun 002B","E01031387","70-74 years","Male",48,54,53,51,45,251
"Arun 002B","E01031387","75-79 years","Male",33,30,29,34,41,167
"Arun 002B","E01031387","80-84 years","Male",22,22,19,18,23,104
"Arun 002B","E01031387","85+ years","Male",24,28,20,24,21,117
"Arun 002B","E01031387","0-4 years","Female",34,33,31,30,27,155
"Arun 002B","E01031387","5-9 years","Female",48,40,41,47,38,214
"Arun 002B","E01031387","10-14 years","Female",34,42,43,37,35,191
"Arun 002B","E01031387","15-19 years","Female",43,40,36,32,36,187
"Arun 002B","E01031387","20-24 years","Female",21,22,21,20,21,105
"Arun 002B","E01031387","25-29 years","Female",43,48,42,39,22,194
"Arun 002B","E01031387","30-34 years","Female",40,38,47,48,46,219
"Arun 002B","E01031387","35-39 years","Female",52,50,49,56,48,255
"Arun 002B","E01031387","40-44 years","Female",44,39,38,40,44,205
"Arun 002B","E01031387","45-49 years","Female",51,55,49,47,40,242
"Arun 002B","E01031387","50-54 years","Female",68,64,68,67,61,328
"Arun 002B","E01031387","55-59 years","Female",56,60,64,62,73,315
"Arun 002B","E01031387","60-64 years","Female",45,45,45,54,59,248
"Arun 002B","E01031387","65-69 years","Female",67,55,53,41,50,266
"Arun 002B","E01031387","70-74 years","Female",64,70,73,72,69,348
"Arun 002B","E01031387","75-79 years","Female",38,39,43,53,53,226
"Arun 002B","E01031387","80-84 years","Female",36,39,32,38,44,189
"Arun 002B","E01031387","85+ years","Female",31,32,30,28,30,151
"Arun 002C","E01031425","0-4 years","Male",23,18,24,26,21,112
"Arun 002C","E01031425","5-9 years","Male",27,27,29,23,16,122
"Arun 002C","E01031425","10-14 years","Male",24,25,27,30,33,139
"Arun 002C","E01031425","15-19 years","Male",34,33,28,31,27,153
"Arun 002C","E01031425","20-24 years","Male",25,30,29,27,20,131
"Arun 002C","E01031425","25-29 years","Male",22,23,32,28,32,137
"Arun 002C","E01031425","30-34 years","Male",11,13,14,18,21,77
"Arun 002C","E01031425","35-39 years","Male",19,26,23,26,17,111
"Arun 002C","E01031425","40-44 years","Male",20,13,11,13,19,76
"Arun 002C","E01031425","45-49 years","Male",39,39,36,31,26,171
"Arun 002C","E01031425","50-54 years","Male",43,43,51,52,46,235
"Arun 002C","E01031425","55-59 years","Male",51,58,52,51,53,265
"Arun 002C","E01031425","60-64 years","Male",61,56,54,61,67,299
"Arun 002C","E01031425","65-69 years","Male",73,66,68,71,63,341
"Arun 002C","E01031425","70-74 years","Male",52,62,63,62,70,309
"Arun 002C","E01031425","75-79 years","Male",37,38,36,39,44,194
"Arun 002C","E01031425","80-84 years","Male",24,23,32,37,41,157
"Arun 002C","E01031425","85+ years","Male",22,18,22,18,16,96
"Arun 002C","E01031425","0-4 years","Female",15,13,18,17,16,79
"Arun 002C","E01031425","5-9 years","Female",23,26,17,14,13,93
"Arun 002C","E01031425","10-14 years","Female",32,32,35,32,33,164
"Arun 002C","E01031425","15-19 years","Female",41,44,46,43,38,212
"Arun 002C","E01031425","20-24 years","Female",25,31,31,30,28,145
"Arun 002C","E01031425","25-29 years","Female",11,10,12,9,10,52
"Arun 002C","E01031425","30-34 years","Female",23,21,22,23,24,113
"Arun 002C","E01031425","35-39 years","Female",16,22,17,17,16,88
"Arun 002C","E01031425","40-44 years","Female",38,32,40,36,37,183
"Arun 002C","E01031425","45-49 years","Female",51,48,44,38,35,216
"Arun 002C","E01031425","50-54 years","Female",70,66,72,66,62,336
"Arun 002C","E01031425","55-59 years","Female",70,68,63,67,76,344
"Arun 002C","E01031425","60-64 years","Female",58,64,65,69,67,323
"Arun 002C","E01031425","65-69 years","Female",61,64,60,55,56,296
"Arun 002C","E01031425","70-74 years","Female",71,76,87,91,90,415
"Arun 002C","E01031425","75-79 years","Female",33,28,27,38,50,176
"Arun 002C","E01031425","80-84 years","Female",34,34,36,29,26,159
"Arun 002C","E01031425","85+ years","Female",36,37,31,31,35,170
"Arun 002D","E01031426","0-4 years","Male",24,26,22,20,21,113
"Arun 002D","E01031426","5-9 years","Male",37,36,33,33,29,168
"Arun 002D","E01031426","10-14 years","Male",26,27,28,34,35,150
"Arun 002D","E01031426","15-19 years","Male",17,18,19,20,19,93
"Arun 002D","E01031426","20-24 years","Male",33,30,28,25,21,137
"Arun 002D","E01031426","25-29 years","Male",16,18,22,16,14,86
"Arun 002D","E01031426","30-34 years","Male",18,23,21,20,25,107
"Arun 002D","E01031426","35-39 years","Male",29,27,30,35,30,151
"Arun 002D","E01031426","40-44 years","Male",27,31,27,31,30,146
"Arun 002D","E01031426","45-49 years","Male",30,29,22,17,19,117
"Arun 002D","E01031426","50-54 years","Male",48,45,45,45,51,234
"Arun 002D","E01031426","55-59 years","Male",68,74,79,73,67,361
"Arun 002D","E01031426","60-64 years","Male",43,39,45,42,43,212
"Arun 002D","E01031426","65-69 years","Male",54,49,42,47,44,236
"Arun 002D","E01031426","70-74 years","Male",48,49,54,47,44,242
"Arun 002D","E01031426","75-79 years","Male",33,34,37,36,39,179
"Arun 002D","E01031426","80-84 years","Male",23,25,27,32,32,139
"Arun 002D","E01031426","85+ years","Male",33,36,31,34,28,162
"Arun 002D","E01031426","0-4 years","Female",32,32,20,23,19,126
"Arun 002D","E01031426","5-9 years","Female",19,18,21,18,15,91
"Arun 002D","E01031426","10-14 years","Female",33,27,28,29,25,142
"Arun 002D","E01031426","15-19 years","Female",23,25,26,28,25,127
"Arun 002D","E01031426","20-24 years","Female",17,20,18,14,15,84
"Arun 002D","E01031426","25-29 years","Female",28,23,22,16,21,110
"Arun 002D","E01031426","30-34 years","Female",27,34,33,37,38,169
"Arun 002D","E01031426","35-39 years","Female",34,31,29,34,27,155
"Arun 002D","E01031426","40-44 years","Female",26,22,22,21,31,122
"Arun 002D","E01031426","45-49 years","Female",56,59,57,53,45,270
"Arun 002D","E01031426","50-54 years","Female",60,58,53,38,33,242
"Arun 002D","E01031426","55-59 years","Female",49,54,61,68,68,300
"Arun 002D","E01031426","60-64 years","Female",48,48,50,46,53,245
"Arun 002D","E01031426","65-69 years","Female",48,48,39,42,44,221
"Arun 002D","E01031426","70-74 years","Female",42,46,45,47,40,220
"Arun 002D","E01031426","75-79 years","Female",37,33,39,38,39,186
"Arun 002D","E01031426","80-84 years","Female",23,27,32,29,29,140
"Arun 002D","E01031426","85+ years","Female",29,27,27,34,26,143
"Arun 003A","E01031393","0-4 years","Male",50,44,43,49,46,232
"Arun 003A","E01031393","5-9 years","Male",55,73,78,84,86,376
"Arun 003A","E01031393","10-14 years","Male",52,57,66,71,68,314
"Arun 003A","E01031393","15-19 years","Male",34,35,39,38,48,194
"Arun 003A","E01031393","20-24 years","Male",39,36,35,28,31,169
"Arun 003A","E01031393","25-29 years","Male",36,41,44,36,27,184
"Arun 003A","E01031393","30-34 years","Male",42,47,41,49,56,235
"Arun 003A","E01031393","35-39 years","Male",39,48,54,49,56,246
"Arun 003A","E01031393","40-44 years","Male",34,26,30,35,37,162
"Arun 003A","E01031393","45-49 years","Male",53,58,61,61,66,299
"Arun 003A","E01031393","50-54 years","Male",67,68,68,74,70,347
"Arun 003A","E01031393","55-59 years","Male",72,73,78,70,83,376
"Arun 003A","E01031393","60-64 years","Male",68,79,78,92,86,403
"Arun 003A","E01031393","65-69 years","Male",88,74,72,70,70,374
"Arun 003A","E01031393","70-74 years","Male",64,75,80,72,84,375
"Arun 003A","E01031393","75-79 years","Male",47,48,49,57,61,262
"Arun 003A","E01031393","80-84 years","Male",42,49,48,49,50,238
"Arun 003A","E01031393","85+ years","Male",22,20,19,18,23,102
"Arun 003A","E01031393","0-4 years","Female",39,45,53,58,53,248
"Arun 003A","E01031393","5-9 years","Female",36,36,42,47,55,216
"Arun 003A","E01031393","10-14 years","Female",54,62,55,71,68,310
"Arun 003A","E01031393","15-19 years","Female",52,50,66,57,74,299
"Arun 003A","E01031393","20-24 years","Female",35,27,34,33,36,165
"Arun 003A","E01031393","25-29 years","Female",38,44,40,39,43,204
"Arun 003A","E01031393","30-34 years","Female",40,47,49,59,61,256
"Arun 003A","E01031393","35-39 years","Female",48,48,50,67,62,275
"Arun 003A","E01031393","40-44 years","Female",65,73,70,61,78,347
"Arun 003A","E01031393","45-49 years","Female",58,60,58,64,70,310
"Arun 003A","E01031393","50-54 years","Female",72,67,77,79,71,366
"Arun 003A","E01031393","55-59 years","Female",81,77,74,74,87,393
"Arun 003A","E01031393","60-64 years","Female",80,81,89,101,100,451
"Arun 003A","E01031393","65-69 years","Female",70,73,74,74,81,372
"Arun 003A","E01031393","70-74 years","Female",69,73,80,83,93,398
"Arun 003A","E01031393","75-79 years","Female",59,66,62,65,57,309
"Arun 003A","E01031393","80-84 years","Female",46,39,39,44,53,221
"Arun 003A","E01031393","85+ years","Female",70,71,68,66,67,342
"Arun 003B","E01031394","0-4 years","Male",56,62,66,68,64,316
"Arun 003B","E01031394","5-9 years","Male",71,70,64,59,69,333
"Arun 003B","E01031394","10-14 years","Male",55,58,72,61,71,317
"Arun 003B","E01031394","15-19 years","Male",61,59,47,47,41,255
"Arun 003B","E01031394","20-24 years","Male",37,37,49,53,49,225
"Arun 003B","E01031394","25-29 years","Male",46,48,46,37,44,221
"Arun 003B","E01031394","30-34 years","Male",68,63,58,64,58,311
"Arun 003B","E01031394","35-39 years","Male",32,35,36,34,39,176
"Arun 003B","E01031394","40-44 years","Male",61,50,42,44,38,235
"Arun 003B","E01031394","45-49 years","Male",64,60,69,66,65,324
"Arun 003B","E01031394","50-54 years","Male",54,54,59,56,66,289
"Arun 003B","E01031394","55-59 years","Male",52,55,51,56,62,276
"Arun 003B","E01031394","60-64 years","Male",37,47,55,61,57,257
"Arun 003B","E01031394","65-69 years","Male",59,56,47,44,38,244
"Arun 003B","E01031394","70-74 years","Male",46,51,59,62,71,289
"Arun 003B","E01031394","75-79 years","Male",13,16,23,29,28,109
"Arun 003B","E01031394","80-84 years","Male",21,24,22,17,22,106
"Arun 003B","E01031394","85+ years","Male",14,12,14,19,17,76
"Arun 003B","E01031394","0-4 years","Female",39,41,32,33,33,178
"Arun 003B","E01031394","5-9 years","Female",55,55,64,52,57,283
"Arun 003B","E01031394","10-14 years","Female",54,50,50,45,46,245
"Arun 003B","E01031394","15-19 years","Female",51,50,44,50,47,242
"Arun 003B","E01031394","20-24 years","Female",33,28,33,32,33,159
"Arun 003B","E01031394","25-29 years","Female",58,60,58,56,50,282
"Arun 003B","E01031394","30-34 years","Female",59,60,66,64,70,319
"Arun 003B","E01031394","35-39 years","Female",56,54,55,53,57,275
"Arun 003B","E01031394","40-44 years","Female",63,58,52,51,47,271
"Arun 003B","E01031394","45-49 years","Female",66,70,72,68,72,348
"Arun 003B","E01031394","50-54 years","Female",63,62,62,65,59,311
"Arun 003B","E01031394","55-59 years","Female",63,63,61,66,65,318
"Arun 003B","E01031394","60-64 years","Female",53,49,46,43,47,238
"Arun 003B","E01031394","65-69 years","Female",54,46,60,50,55,265
"Arun 003B","E01031394","70-74 years","Female",31,43,47,59,58,238
"Arun 003B","E01031394","75-79 years","Female",33,31,31,35,36,166
"Arun 003B","E01031394","80-84 years","Female",12,21,27,25,26,111
"Arun 003B","E01031394","85+ years","Female",32,27,16,20,23,118
"Arun 003C","E01031395","0-4 years","Male",40,33,39,48,50,210
"Arun 003C","E01031395","5-9 years","Male",42,51,48,46,52,239
"Arun 003C","E01031395","10-14 years","Male",51,44,47,44,50,236
"Arun 003C","E01031395","15-19 years","Male",39,42,45,43,40,209
"Arun 003C","E01031395","20-24 years","Male",48,44,42,46,50,230
"Arun 003C","E01031395","25-29 years","Male",17,14,18,17,17,83
"Arun 003C","E01031395","30-34 years","Male",19,22,21,21,21,104
"Arun 003C","E01031395","35-39 years","Male",30,23,29,26,30,138
"Arun 003C","E01031395","40-44 years","Male",46,38,38,40,42,204
"Arun 003C","E01031395","45-49 years","Male",58,54,42,38,38,230
"Arun 003C","E01031395","50-54 years","Male",52,48,54,62,53,269
"Arun 003C","E01031395","55-59 years","Male",74,88,94,88,88,432
"Arun 003C","E01031395","60-64 years","Male",39,41,44,45,56,225
"Arun 003C","E01031395","65-69 years","Male",67,63,47,49,46,272
"Arun 003C","E01031395","70-74 years","Male",57,58,62,60,60,297
"Arun 003C","E01031395","75-79 years","Male",39,46,52,52,54,243
"Arun 003C","E01031395","80-84 years","Male",19,24,25,28,26,122
"Arun 003C","E01031395","85+ years","Male",21,22,19,15,12,89
"Arun 003C","E01031395","0-4 years","Female",39,37,40,52,48,216
"Arun 003C","E01031395","5-9 years","Female",30,31,34,33,45,173
"Arun 003C","E01031395","10-14 years","Female",39,34,26,28,29,156
"Arun 003C","E01031395","15-19 years","Female",33,32,39,35,30,169
"Arun 003C","E01031395","20-24 years","Female",24,20,25,36,32,137
"Arun 003C","E01031395","25-29 years","Female",19,20,23,22,21,105
"Arun 003C","E01031395","30-34 years","Female",40,45,42,42,43,212
"Arun 003C","E01031395","35-39 years","Female",37,34,37,36,37,181
"Arun 003C","E01031395","40-44 years","Female",66,61,55,45,42,269
"Arun 003C","E01031395","45-49 years","Female",59,56,54,58,60,287
"Arun 003C","E01031395","50-54 years","Female",70,71,73,74,67,355
"Arun 003C","E01031395","55-59 years","Female",67,74,76,76,86,379
"Arun 003C","E01031395","60-64 years","Female",61,50,62,61,57,291
"Arun 003C","E01031395","65-69 years","Female",63,63,52,56,63,297
"Arun 003C","E01031395","70-74 years","Female",50,62,63,57,54,286
"Arun 003C","E01031395","75-79 years","Female",32,28,34,39,40,173
"Arun 003C","E01031395","80-84 years","Female",20,22,15,17,19,93
"Arun 003C","E01031395","85+ years","Female",17,21,25,22,24,109
"Arun 003D","E01031396","0-4 years","Male",67,70,63,64,72,336
"Arun 003D","E01031396","5-9 years","Male",58,57,60,60,64,299
"Arun 003D","E01031396","10-14 years","Male",65,65,62,72,74,338
"Arun 003D","E01031396","15-19 years","Male",40,45,45,40,49,219
"Arun 003D","E01031396","20-24 years","Male",40,39,41,45,39,204
"Arun 003D","E01031396","25-29 years","Male",43,46,51,61,62,263
"Arun 003D","E01031396","30-34 years","Male",37,41,35,42,50,205
"Arun 003D","E01031396","35-39 years","Male",61,54,54,51,50,270
"Arun 003D","E01031396","40-44 years","Male",61,58,48,51,57,275
"Arun 003D","E01031396","45-49 years","Male",74,74,65,65,66,344
"Arun 003D","E01031396","50-54 years","Male",62,60,65,61,65,313
"Arun 003D","E01031396","55-59 years","Male",54,55,68,76,75,328
"Arun 003D","E01031396","60-64 years","Male",54,58,53,51,53,269
"Arun 003D","E01031396","65-69 years","Male",81,71,70,61,59,342
"Arun 003D","E01031396","70-74 years","Male",41,44,50,63,57,255
"Arun 003D","E01031396","75-79 years","Male",29,27,28,30,35,149
"Arun 003D","E01031396","80-84 years","Male",25,26,30,28,28,137
"Arun 003D","E01031396","85+ years","Male",18,14,12,16,22,82
"Arun 003D","E01031396","0-4 years","Female",40,38,35,44,44,201
"Arun 003D","E01031396","5-9 years","Female",59,60,65,66,63,313
"Arun 003D","E01031396","10-14 years","Female",57,52,50,66,79,304
"Arun 003D","E01031396","15-19 years","Female",62,62,64,60,56,304
"Arun 003D","E01031396","20-24 years","Female",29,33,32,39,39,172
"Arun 003D","E01031396","25-29 years","Female",46,41,52,54,69,262
"Arun 003D","E01031396","30-34 years","Female",49,46,41,53,56,245
"Arun 003D","E01031396","35-39 years","Female",61,63,53,51,57,285
"Arun 003D","E01031396","40-44 years","Female",63,57,53,55,50,278
"Arun 003D","E01031396","45-49 years","Female",71,69,81,76,83,380
"Arun 003D","E01031396","50-54 years","Female",87,91,88,89,85,440
"Arun 003D","E01031396","55-59 years","Female",72,73,80,80,83,388
"Arun 003D","E01031396","60-64 years","Female",69,70,65,67,74,345
"Arun 003D","E01031396","65-69 years","Female",69,72,75,73,73,362
"Arun 003D","E01031396","70-74 years","Female",41,51,56,63,69,280
"Arun 003D","E01031396","75-79 years","Female",43,43,37,39,38,200
"Arun 003D","E01031396","80-84 years","Female",33,32,33,36,38,172
"Arun 003D","E01031396","85+ years","Female",39,41,38,45,39,202
"Arun 003E","E01031397","0-4 years","Male",43,41,38,36,27,185
"Arun 003E","E01031397","5-9 years","Male",42,42,39,33,32,188
"Arun 003E","E01031397","10-14 years","Male",63,61,59,48,49,280
"Arun 003E","E01031397","15-19 years","Male",50,49,47,55,52,253
"Arun 003E","E01031397","20-24 years","Male",46,50,54,49,44,243
"Arun 003E","E01031397","25-29 years","Male",39,41,37,32,33,182
"Arun 003E","E01031397","30-34 years","Male",33,33,35,38,44,183
"Arun 003E","E01031397","35-39 years","Male",43,53,45,43,40,224
"Arun 003E","E01031397","40-44 years","Male",45,51,56,59,60,271
"Arun 003E","E01031397","45-49 years","Male",76,61,57,54,48,296
"Arun 003E","E01031397","50-54 years","Male",80,82,77,74,70,383
"Arun 003E","E01031397","55-59 years","Male",63,62,71,76,89,361
"Arun 003E","E01031397","60-64 years","Male",58,62,52,50,53,275
"Arun 003E","E01031397","65-69 years","Male",70,67,73,74,66,350
"Arun 003E","E01031397","70-74 years","Male",64,76,78,76,77,371
"Arun 003E","E01031397","75-79 years","Male",33,32,36,47,49,197
"Arun 003E","E01031397","80-84 years","Male",41,41,37,34,32,185
"Arun 003E","E01031397","85+ years","Male",28,28,31,33,37,157
"Arun 003E","E01031397","0-4 years","Female",37,32,28,24,23,144
"Arun 003E","E01031397","5-9 years","Female",34,40,46,43,39,202
"Arun 003E","E01031397","10-14 years","Female",58,61,50,47,48,264
"Arun 003E","E01031397","15-19 years","Female",58,57,60,63,64,302
"Arun 003E","E01031397","20-24 years","Female",35,34,31,24,21,145
"Arun 003E","E01031397","25-29 years","Female",38,27,33,35,29,162
"Arun 003E","E01031397","30-34 years","Female",34,28,36,32,40,170
"Arun 003E","E01031397","35-39 years","Female",28,39,31,29,27,154
"Arun 003E","E01031397","40-44 years","Female",65,52,38,43,48,246
"Arun 003E","E01031397","45-49 years","Female",69,66,74,60,60,329
"Arun 003E","E01031397","50-54 years","Female",72,81,79,83,75,390
"Arun 003E","E01031397","55-59 years","Female",60,62,60,60,68,310
"Arun 003E","E01031397","60-64 years","Female",55,61,62,58,58,294
"Arun 003E","E01031397","65-69 years","Female",83,75,76,70,71,375
"Arun 003E","E01031397","70-74 years","Female",70,79,89,99,93,430
"Arun 003E","E01031397","75-79 years","Female",46,53,55,63,71,288
"Arun 003E","E01031397","80-84 years","Female",34,29,28,34,45,170
"Arun 003E","E01031397","85+ years","Female",73,79,87,77,77,393
"Arun 003F","E01031466","0-4 years","Male",25,28,24,27,24,128
"Arun 003F","E01031466","5-9 years","Male",40,41,48,50,52,231
"Arun 003F","E01031466","10-14 years","Male",54,53,56,54,58,275
"Arun 003F","E01031466","15-19 years","Male",46,47,45,49,46,233
"Arun 003F","E01031466","20-24 years","Male",30,29,30,23,26,138
"Arun 003F","E01031466","25-29 years","Male",19,22,23,26,25,115
"Arun 003F","E01031466","30-34 years","Male",18,16,22,24,22,102
"Arun 003F","E01031466","35-39 years","Male",31,26,26,28,26,137
"Arun 003F","E01031466","40-44 years","Male",39,40,29,30,34,172
"Arun 003F","E01031466","45-49 years","Male",50,53,58,57,46,264
"Arun 003F","E01031466","50-54 years","Male",51,49,47,43,50,240
"Arun 003F","E01031466","55-59 years","Male",70,68,63,68,62,331
"Arun 003F","E01031466","60-64 years","Male",63,62,70,65,66,326
"Arun 003F","E01031466","65-69 years","Male",52,56,60,64,78,310
"Arun 003F","E01031466","70-74 years","Male",43,53,50,52,43,241
"Arun 003F","E01031466","75-79 years","Male",48,47,47,44,46,232
"Arun 003F","E01031466","80-84 years","Male",25,20,24,31,36,136
"Arun 003F","E01031466","85+ years","Male",23,19,21,18,28,109
"Arun 003F","E01031466","0-4 years","Female",25,30,27,20,28,130
"Arun 003F","E01031466","5-9 years","Female",39,36,25,29,22,151
"Arun 003F","E01031466","10-14 years","Female",42,42,42,42,46,214
"Arun 003F","E01031466","15-19 years","Female",34,31,32,33,30,160
"Arun 003F","E01031466","20-24 years","Female",16,17,16,16,20,85
"Arun 003F","E01031466","25-29 years","Female",9,6,10,13,15,53
"Arun 003F","E01031466","30-34 years","Female",36,41,29,28,22,156
"Arun 003F","E01031466","35-39 years","Female",36,35,36,30,35,172
"Arun 003F","E01031466","40-44 years","Female",44,40,35,39,40,198
"Arun 003F","E01031466","45-49 years","Female",54,56,53,52,51,266
"Arun 003F","E01031466","50-54 years","Female",57,51,50,52,50,260
"Arun 003F","E01031466","55-59 years","Female",58,59,68,68,60,313
"Arun 003F","E01031466","60-64 years","Female",45,50,57,52,61,265
"Arun 003F","E01031466","65-69 years","Female",70,70,60,59,65,324
"Arun 003F","E01031466","70-74 years","Female",61,61,67,64,68,321
"Arun 003F","E01031466","75-79 years","Female",35,32,37,45,44,193
"Arun 003F","E01031466","80-84 years","Female",30,34,32,32,34,162
"Arun 003F","E01031466","85+ years","Female",32,29,28,36,50,175
"Arun 004A","E01031427","0-4 years","Male",53,60,65,64,65,307
"Arun 004A","E01031427","5-9 years","Male",67,71,68,64,57,327
"Arun 004A","E01031427","10-14 years","Male",54,56,57,60,71,298
"Arun 004A","E01031427","15-19 years","Male",53,48,47,48,52,248
"Arun 004A","E01031427","20-24 years","Male",63,57,79,69,72,340
"Arun 004A","E01031427","25-29 years","Male",38,40,34,43,46,201
"Arun 004A","E01031427","30-34 years","Male",48,51,53,55,54,261
"Arun 004A","E01031427","35-39 years","Male",33,44,47,46,49,219
"Arun 004A","E01031427","40-44 years","Male",33,38,39,39,36,185
"Arun 004A","E01031427","45-49 years","Male",52,52,46,45,48,243
"Arun 004A","E01031427","50-54 years","Male",44,45,62,59,60,270
"Arun 004A","E01031427","55-59 years","Male",37,37,25,31,36,166
"Arun 004A","E01031427","60-64 years","Male",28,32,33,31,28,152
"Arun 004A","E01031427","65-69 years","Male",29,27,21,20,28,125
"Arun 004A","E01031427","70-74 years","Male",25,21,22,24,21,113
"Arun 004A","E01031427","75-79 years","Male",18,19,24,27,30,118
"Arun 004A","E01031427","80-84 years","Male",20,22,18,11,14,85
"Arun 004A","E01031427","85+ years","Male",13,12,14,15,11,65
"Arun 004A","E01031427","0-4 years","Female",69,63,68,64,69,333
"Arun 004A","E01031427","5-9 years","Female",77,82,79,86,80,404
"Arun 004A","E01031427","10-14 years","Female",69,74,78,73,68,362
"Arun 004A","E01031427","15-19 years","Female",46,51,58,56,56,267
"Arun 004A","E01031427","20-24 years","Female",42,37,39,34,34,186
"Arun 004A","E01031427","25-29 years","Female",72,59,52,52,54,289
"Arun 004A","E01031427","30-34 years","Female",61,67,69,58,59,314
"Arun 004A","E01031427","35-39 years","Female",55,56,61,65,56,293
"Arun 004A","E01031427","40-44 years","Female",48,54,60,65,69,296
"Arun 004A","E01031427","45-49 years","Female",69,59,56,51,59,294
"Arun 004A","E01031427","50-54 years","Female",51,56,61,59,50,277
"Arun 004A","E01031427","55-59 years","Female",58,57,64,62,64,305
"Arun 004A","E01031427","60-64 years","Female",38,48,50,46,45,227
"Arun 004A","E01031427","65-69 years","Female",34,37,32,34,32,169
"Arun 004A","E01031427","70-74 years","Female",34,32,29,33,24,152
"Arun 004A","E01031427","75-79 years","Female",35,30,28,24,27,144
"Arun 004A","E01031427","80-84 years","Female",16,25,22,23,21,107
"Arun 004A","E01031427","85+ years","Female",26,23,24,25,26,124
"Arun 004B","E01031429","0-4 years","Male",83,74,72,86,89,404
"Arun 004B","E01031429","5-9 years","Male",66,81,88,84,74,393
"Arun 004B","E01031429","10-14 years","Male",52,51,47,49,57,256
"Arun 004B","E01031429","15-19 years","Male",46,44,37,35,36,198
"Arun 004B","E01031429","20-24 years","Male",19,25,28,27,23,122
"Arun 004B","E01031429","25-29 years","Male",42,36,32,37,38,185
"Arun 004B","E01031429","30-34 years","Male",42,40,43,42,40,207
"Arun 004B","E01031429","35-39 years","Male",42,50,45,39,43,219
"Arun 004B","E01031429","40-44 years","Male",36,40,43,39,35,193
"Arun 004B","E01031429","45-49 years","Male",48,47,51,48,48,242
"Arun 004B","E01031429","50-54 years","Male",38,38,34,36,32,178
"Arun 004B","E01031429","55-59 years","Male",39,35,32,32,28,166
"Arun 004B","E01031429","60-64 years","Male",34,37,40,39,42,192
"Arun 004B","E01031429","65-69 years","Male",29,25,25,26,30,135
"Arun 004B","E01031429","70-74 years","Male",22,26,28,27,21,124
"Arun 004B","E01031429","75-79 years","Male",30,23,16,21,32,122
"Arun 004B","E01031429","80-84 years","Male",5,7,7,6,5,30
"Arun 004B","E01031429","85+ years","Male",7,7,8,6,7,35
"Arun 004B","E01031429","0-4 years","Female",82,72,74,75,77,380
"Arun 004B","E01031429","5-9 years","Female",71,78,69,66,69,353
"Arun 004B","E01031429","10-14 years","Female",58,62,67,61,57,305
"Arun 004B","E01031429","15-19 years","Female",37,38,37,35,40,187
"Arun 004B","E01031429","20-24 years","Female",35,30,31,35,30,161
"Arun 004B","E01031429","25-29 years","Female",45,47,49,48,56,245
"Arun 004B","E01031429","30-34 years","Female",51,48,51,46,42,238
"Arun 004B","E01031429","35-39 years","Female",52,57,48,57,51,265
"Arun 004B","E01031429","40-44 years","Female",43,38,39,35,43,198
"Arun 004B","E01031429","45-49 years","Female",62,65,68,67,57,319
"Arun 004B","E01031429","50-54 years","Female",57,52,54,52,49,264
"Arun 004B","E01031429","55-59 years","Female",38,46,41,41,47,213
"Arun 004B","E01031429","60-64 years","Female",37,30,32,31,28,158
"Arun 004B","E01031429","65-69 years","Female",45,39,35,35,35,189
"Arun 004B","E01031429","70-74 years","Female",21,28,27,33,37,146
"Arun 004B","E01031429","75-79 years","Female",19,21,23,22,20,105
"Arun 004B","E01031429","80-84 years","Female",4,4,3,5,10,26
"Arun 004B","E01031429","85+ years","Female",4,3,3,3,3,16
"Arun 004C","E01031430","0-4 years","Male",42,37,33,39,33,184
"Arun 004C","E01031430","5-9 years","Male",43,40,39,38,34,194
"Arun 004C","E01031430","10-14 years","Male",29,29,31,33,36,158
"Arun 004C","E01031430","15-19 years","Male",48,45,40,37,35,205
"Arun 004C","E01031430","20-24 years","Male",35,39,31,36,34,175
"Arun 004C","E01031430","25-29 years","Male",40,36,41,40,43,200
"Arun 004C","E01031430","30-34 years","Male",50,50,53,51,46,250
"Arun 004C","E01031430","35-39 years","Male",36,38,46,52,51,223
"Arun 004C","E01031430","40-44 years","Male",24,27,22,21,22,116
"Arun 004C","E01031430","45-49 years","Male",43,37,42,43,40,205
"Arun 004C","E01031430","50-54 years","Male",50,55,55,46,43,249
"Arun 004C","E01031430","55-59 years","Male",45,40,41,46,46,218
"Arun 004C","E01031430","60-64 years","Male",42,45,46,48,52,233
"Arun 004C","E01031430","65-69 years","Male",39,38,39,40,41,197
"Arun 004C","E01031430","70-74 years","Male",45,41,34,37,35,192
"Arun 004C","E01031430","75-79 years","Male",21,26,28,31,36,142
"Arun 004C","E01031430","80-84 years","Male",26,27,24,26,23,126
"Arun 004C","E01031430","85+ years","Male",6,9,10,11,11,47
"Arun 004C","E01031430","0-4 years","Female",58,40,41,40,45,224
"Arun 004C","E01031430","5-9 years","Female",32,34,33,32,30,161
"Arun 004C","E01031430","10-14 years","Female",25,29,28,27,27,136
"Arun 004C","E01031430","15-19 years","Female",42,36,28,35,34,175
"Arun 004C","E01031430","20-24 years","Female",30,29,36,38,28,161
"Arun 004C","E01031430","25-29 years","Female",37,34,23,26,28,148
"Arun 004C","E01031430","30-34 years","Female",39,38,37,44,39,197
"Arun 004C","E01031430","35-39 years","Female",43,35,40,41,42,201
"Arun 004C","E01031430","40-44 years","Female",43,52,41,30,30,196
"Arun 004C","E01031430","45-49 years","Female",38,36,41,43,36,194
"Arun 004C","E01031430","50-54 years","Female",52,49,47,46,40,234
"Arun 004C","E01031430","55-59 years","Female",57,54,54,55,57,277
"Arun 004C","E01031430","60-64 years","Female",47,45,45,51,55,243
"Arun 004C","E01031430","65-69 years","Female",54,49,48,42,40,233
"Arun 004C","E01031430","70-74 years","Female",27,36,40,42,49,194
"Arun 004C","E01031430","75-79 years","Female",39,37,34,38,29,177
"Arun 004C","E01031430","80-84 years","Female",29,33,38,34,38,172
"Arun 004C","E01031430","85+ years","Female",19,19,20,19,19,96
"Arun 004D","E01031467","0-4 years","Male",97,122,132,144,133,628
"Arun 004D","E01031467","5-9 years","Male",71,107,142,144,164,628
"Arun 004D","E01031467","10-14 years","Male",47,71,82,98,115,413
"Arun 004D","E01031467","15-19 years","Male",80,86,82,86,86,420
"Arun 004D","E01031467","20-24 years","Male",47,56,70,67,56,296
"Arun 004D","E01031467","25-29 years","Male",60,73,88,98,103,422
"Arun 004D","E01031467","30-34 years","Male",76,92,95,104,110,477
"Arun 004D","E01031467","35-39 years","Male",46,60,78,74,77,335
"Arun 004D","E01031467","40-44 years","Male",61,64,67,86,104,382
"Arun 004D","E01031467","45-49 years","Male",60,71,76,83,87,377
"Arun 004D","E01031467","50-54 years","Male",81,92,97,112,110,492
"Arun 004D","E01031467","55-59 years","Male",73,91,89,95,94,442
"Arun 004D","E01031467","60-64 years","Male",54,62,72,89,94,371
"Arun 004D","E01031467","65-69 years","Male",74,76,80,74,78,382
"Arun 004D","E01031467","70-74 years","Male",63,69,70,68,68,338
"Arun 004D","E01031467","75-79 years","Male",32,35,38,42,47,194
"Arun 004D","E01031467","80-84 years","Male",16,18,22,28,21,105
"Arun 004D","E01031467","85+ years","Male",18,18,19,17,23,95
"Arun 004D","E01031467","0-4 years","Female",106,142,155,177,176,756
"Arun 004D","E01031467","5-9 years","Female",55,75,85,89,115,419
"Arun 004D","E01031467","10-14 years","Female",57,69,75,80,88,369
"Arun 004D","E01031467","15-19 years","Female",38,48,63,72,69,290
"Arun 004D","E01031467","20-24 years","Female",58,74,78,74,66,350
"Arun 004D","E01031467","25-29 years","Female",88,118,122,141,141,610
"Arun 004D","E01031467","30-34 years","Female",67,99,123,129,133,551
"Arun 004D","E01031467","35-39 years","Female",73,95,109,129,128,534
"Arun 004D","E01031467","40-44 years","Female",59,68,79,86,102,394
"Arun 004D","E01031467","45-49 years","Female",94,107,112,105,100,518
"Arun 004D","E01031467","50-54 years","Female",80,95,114,126,125,540
"Arun 004D","E01031467","55-59 years","Female",71,83,99,106,112,471
"Arun 004D","E01031467","60-64 years","Female",69,76,75,89,85,394
"Arun 004D","E01031467","65-69 years","Female",81,78,75,76,83,393
"Arun 004D","E01031467","70-74 years","Female",54,69,72,85,84,364
"Arun 004D","E01031467","75-79 years","Female",44,48,49,48,50,239
"Arun 004D","E01031467","80-84 years","Female",30,24,26,29,31,140
"Arun 004D","E01031467","85+ years","Female",35,35,31,28,27,156
"Arun 004E","E01031468","0-4 years","Male",122,134,147,124,119,646
"Arun 004E","E01031468","5-9 years","Male",98,110,126,140,156,630
"Arun 004E","E01031468","10-14 years","Male",82,98,97,106,110,493
"Arun 004E","E01031468","15-19 years","Male",67,59,70,71,78,345
"Arun 004E","E01031468","20-24 years","Male",84,97,90,88,86,445
"Arun 004E","E01031468","25-29 years","Male",108,108,106,104,115,541
"Arun 004E","E01031468","30-34 years","Male",92,90,106,115,136,539
"Arun 004E","E01031468","35-39 years","Male",81,99,101,105,100,486
"Arun 004E","E01031468","40-44 years","Male",84,77,79,78,96,414
"Arun 004E","E01031468","45-49 years","Male",83,88,96,94,94,455
"Arun 004E","E01031468","50-54 years","Male",91,90,102,123,119,525
"Arun 004E","E01031468","55-59 years","Male",66,75,78,74,85,378
"Arun 004E","E01031468","60-64 years","Male",69,67,64,60,57,317
"Arun 004E","E01031468","65-69 years","Male",88,78,66,61,68,361
"Arun 004E","E01031468","70-74 years","Male",41,49,56,65,65,276
"Arun 004E","E01031468","75-79 years","Male",21,23,26,26,32,128
"Arun 004E","E01031468","80-84 years","Male",15,14,13,15,16,73
"Arun 004E","E01031468","85+ years","Male",25,27,24,25,27,128
"Arun 004E","E01031468","0-4 years","Female",98,101,102,119,144,564
"Arun 004E","E01031468","5-9 years","Female",113,123,162,157,175,730
"Arun 004E","E01031468","10-14 years","Female",54,62,77,88,108,389
"Arun 004E","E01031468","15-19 years","Female",80,79,90,87,87,423
"Arun 004E","E01031468","20-24 years","Female",58,61,55,54,58,286
"Arun 004E","E01031468","25-29 years","Female",89,94,102,95,100,480
"Arun 004E","E01031468","30-34 years","Female",126,128,133,170,175,732
"Arun 004E","E01031468","35-39 years","Female",65,82,101,100,119,467
"Arun 004E","E01031468","40-44 years","Female",90,76,74,86,94,420
"Arun 004E","E01031468","45-49 years","Female",95,99,101,90,94,479
"Arun 004E","E01031468","50-54 years","Female",95,105,110,126,119,555
"Arun 004E","E01031468","55-59 years","Female",76,82,81,79,85,403
"Arun 004E","E01031468","60-64 years","Female",85,87,90,84,73,419
"Arun 004E","E01031468","65-69 years","Female",60,59,64,71,83,337
"Arun 004E","E01031468","70-74 years","Female",44,48,55,64,66,277
"Arun 004E","E01031468","75-79 years","Female",30,38,33,32,34,167
"Arun 004E","E01031468","80-84 years","Female",14,17,19,27,26,103
"Arun 004E","E01031468","85+ years","Female",19,16,15,18,15,83
"Arun 005A","E01031388","0-4 years","Male",91,98,120,130,122,561
"Arun 005A","E01031388","5-9 years","Male",92,105,120,136,132,585
"Arun 005A","E01031388","10-14 years","Male",111,116,111,107,110,555
"Arun 005A","E01031388","15-19 years","Male",84,87,92,98,118,479
"Arun 005A","E01031388","20-24 years","Male",65,74,73,78,76,366
"Arun 005A","E01031388","25-29 years","Male",47,49,59,68,71,294
"Arun 005A","E01031388","30-34 years","Male",63,59,63,67,75,327
"Arun 005A","E01031388","35-39 years","Male",79,74,77,88,88,406
"Arun 005A","E01031388","40-44 years","Male",110,109,107,118,118,562
"Arun 005A","E01031388","45-49 years","Male",128,129,146,141,132,676
"Arun 005A","E01031388","50-54 years","Male",80,101,125,120,137,563
"Arun 005A","E01031388","55-59 years","Male",77,82,79,91,88,417
"Arun 005A","E01031388","60-64 years","Male",69,69,80,88,92,398
"Arun 005A","E01031388","65-69 years","Male",67,71,78,69,75,360
"Arun 005A","E01031388","70-74 years","Male",64,66,69,75,67,341
"Arun 005A","E01031388","75-79 years","Male",55,65,74,72,73,339
"Arun 005A","E01031388","80-84 years","Male",33,29,37,37,39,175
"Arun 005A","E01031388","85+ years","Male",22,24,21,22,29,118
"Arun 005A","E01031388","0-4 years","Female",86,102,115,116,117,536
"Arun 005A","E01031388","5-9 years","Female",85,83,100,97,112,477
"Arun 005A","E01031388","10-14 years","Female",91,90,84,83,91,439
"Arun 005A","E01031388","15-19 years","Female",91,87,103,117,106,504
"Arun 005A","E01031388","20-24 years","Female",45,47,59,70,71,292
"Arun 005A","E01031388","25-29 years","Female",46,50,59,64,69,288
"Arun 005A","E01031388","30-34 years","Female",73,69,87,96,92,417
"Arun 005A","E01031388","35-39 years","Female",101,107,116,117,117,558
"Arun 005A","E01031388","40-44 years","Female",124,125,115,113,130,607
"Arun 005A","E01031388","45-49 years","Female",131,135,138,148,140,692
"Arun 005A","E01031388","50-54 years","Female",95,113,126,136,132,602
"Arun 005A","E01031388","55-59 years","Female",97,102,113,117,137,566
"Arun 005A","E01031388","60-64 years","Female",85,71,84,92,101,433
"Arun 005A","E01031388","65-69 years","Female",79,84,91,89,90,433
"Arun 005A","E01031388","70-74 years","Female",63,84,89,87,88,411
"Arun 005A","E01031388","75-79 years","Female",63,59,63,66,75,326
"Arun 005A","E01031388","80-84 years","Female",34,32,38,46,46,196
"Arun 005A","E01031388","85+ years","Female",36,41,50,50,48,225
"Arun 005B","E01031389","0-4 years","Male",32,27,29,30,30,148
"Arun 005B","E01031389","5-9 years","Male",58,49,47,46,43,243
"Arun 005B","E01031389","10-14 years","Male",83,71,77,76,71,378
"Arun 005B","E01031389","15-19 years","Male",54,65,65,66,86,336
"Arun 005B","E01031389","20-24 years","Male",39,39,40,36,30,184
"Arun 005B","E01031389","25-29 years","Male",31,34,33,33,29,160
"Arun 005B","E01031389","30-34 years","Male",27,28,26,34,31,146
"Arun 005B","E01031389","35-39 years","Male",33,34,34,26,33,160
"Arun 005B","E01031389","40-44 years","Male",60,48,50,43,39,240
"Arun 005B","E01031389","45-49 years","Male",105,96,90,82,76,449
"Arun 005B","E01031389","50-54 years","Male",68,80,80,97,94,419
"Arun 005B","E01031389","55-59 years","Male",53,58,62,65,65,303
"Arun 005B","E01031389","60-64 years","Male",70,63,62,59,56,310
"Arun 005B","E01031389","65-69 years","Male",104,93,89,81,78,445
"Arun 005B","E01031389","70-74 years","Male",95,105,102,109,98,509
"Arun 005B","E01031389","75-79 years","Male",67,61,75,75,83,361
"Arun 005B","E01031389","80-84 years","Male",49,53,55,52,55,264
"Arun 005B","E01031389","85+ years","Male",37,37,43,46,40,203
"Arun 005B","E01031389","0-4 years","Female",43,36,47,36,40,202
"Arun 005B","E01031389","5-9 years","Female",44,38,36,38,42,198
"Arun 005B","E01031389","10-14 years","Female",79,80,76,69,62,366
"Arun 005B","E01031389","15-19 years","Female",58,58,62,71,71,320
"Arun 005B","E01031389","20-24 years","Female",42,49,46,45,46,228
"Arun 005B","E01031389","25-29 years","Female",29,24,27,27,30,137
"Arun 005B","E01031389","30-34 years","Female",26,22,19,19,17,103
"Arun 005B","E01031389","35-39 years","Female",65,54,54,51,37,261
"Arun 005B","E01031389","40-44 years","Female",70,69,76,59,60,334
"Arun 005B","E01031389","45-49 years","Female",99,98,93,104,99,493
"Arun 005B","E01031389","50-54 years","Female",88,87,87,93,95,450
"Arun 005B","E01031389","55-59 years","Female",83,74,62,70,73,362
"Arun 005B","E01031389","60-64 years","Female",106,106,108,102,90,512
"Arun 005B","E01031389","65-69 years","Female",94,103,100,100,98,495
"Arun 005B","E01031389","70-74 years","Female",113,118,119,117,124,591
"Arun 005B","E01031389","75-79 years","Female",88,87,89,97,88,449
"Arun 005B","E01031389","80-84 years","Female",46,50,57,60,68,281
"Arun 005B","E01031389","85+ years","Female",45,45,36,39,45,210
"Arun 005C","E01031414","0-4 years","Male",40,31,35,41,36,183
"Arun 005C","E01031414","5-9 years","Male",33,37,31,29,36,166
"Arun 005C","E01031414","10-14 years","Male",34,32,35,36,36,173
"Arun 005C","E01031414","15-19 years","Male",45,37,35,33,26,176
"Arun 005C","E01031414","20-24 years","Male",28,30,30,27,32,147
"Arun 005C","E01031414","25-29 years","Male",35,35,30,32,31,163
"Arun 005C","E01031414","30-34 years","Male",26,25,25,27,24,127
"Arun 005C","E01031414","35-39 years","Male",47,50,47,40,38,222
"Arun 005C","E01031414","40-44 years","Male",44,37,41,47,38,207
"Arun 005C","E01031414","45-49 years","Male",57,56,54,44,41,252
"Arun 005C","E01031414","50-54 years","Male",47,46,46,49,46,234
"Arun 005C","E01031414","55-59 years","Male",34,43,46,49,51,223
"Arun 005C","E01031414","60-64 years","Male",47,40,45,42,37,211
"Arun 005C","E01031414","65-69 years","Male",69,52,44,47,48,260
"Arun 005C","E01031414","70-74 years","Male",54,57,59,57,61,288
"Arun 005C","E01031414","75-79 years","Male",31,41,45,46,51,214
"Arun 005C","E01031414","80-84 years","Male",24,27,24,22,19,116
"Arun 005C","E01031414","85+ years","Male",25,26,31,29,30,141
"Arun 005C","E01031414","0-4 years","Female",37,28,36,33,34,168
"Arun 005C","E01031414","5-9 years","Female",50,59,55,70,63,297
"Arun 005C","E01031414","10-14 years","Female",34,31,36,38,42,181
"Arun 005C","E01031414","15-19 years","Female",38,36,32,32,26,164
"Arun 005C","E01031414","20-24 years","Female",27,25,33,32,35,152
"Arun 005C","E01031414","25-29 years","Female",35,36,32,32,34,169
"Arun 005C","E01031414","30-34 years","Female",33,35,45,38,36,187
"Arun 005C","E01031414","35-39 years","Female",30,26,24,30,32,142
"Arun 005C","E01031414","40-44 years","Female",44,37,36,40,42,199
"Arun 005C","E01031414","45-49 years","Female",53,59,60,45,35,252
"Arun 005C","E01031414","50-54 years","Female",54,59,58,64,62,297
"Arun 005C","E01031414","55-59 years","Female",48,48,55,54,52,257
"Arun 005C","E01031414","60-64 years","Female",41,45,43,50,53,232
"Arun 005C","E01031414","65-69 years","Female",70,53,42,38,45,248
"Arun 005C","E01031414","70-74 years","Female",56,69,75,81,76,357
"Arun 005C","E01031414","75-79 years","Female",49,53,43,47,48,240
"Arun 005C","E01031414","80-84 years","Female",27,24,24,18,21,114
"Arun 005C","E01031414","85+ years","Female",34,36,36,37,39,182
"Arun 005D","E01031415","0-4 years","Male",24,26,29,27,24,130
"Arun 005D","E01031415","5-9 years","Male",37,47,49,54,47,234
"Arun 005D","E01031415","10-14 years","Male",34,35,37,32,39,177
"Arun 005D","E01031415","15-19 years","Male",44,37,29,34,36,180
"Arun 005D","E01031415","20-24 years","Male",32,36,35,36,31,170
"Arun 005D","E01031415","25-29 years","Male",32,31,33,37,29,162
"Arun 005D","E01031415","30-34 years","Male",23,24,18,19,24,108
"Arun 005D","E01031415","35-39 years","Male",26,29,29,24,27,135
"Arun 005D","E01031415","40-44 years","Male",23,19,20,20,17,99
"Arun 005D","E01031415","45-49 years","Male",47,43,45,36,38,209
"Arun 005D","E01031415","50-54 years","Male",43,46,40,41,32,202
"Arun 005D","E01031415","55-59 years","Male",33,41,51,59,55,239
"Arun 005D","E01031415","60-64 years","Male",51,46,35,35,42,209
"Arun 005D","E01031415","65-69 years","Male",75,73,76,69,68,361
"Arun 005D","E01031415","70-74 years","Male",55,63,65,68,69,320
"Arun 005D","E01031415","75-79 years","Male",53,46,42,49,47,237
"Arun 005D","E01031415","80-84 years","Male",32,35,40,33,29,169
"Arun 005D","E01031415","85+ years","Male",32,33,34,48,50,197
"Arun 005D","E01031415","0-4 years","Female",23,24,32,33,26,138
"Arun 005D","E01031415","5-9 years","Female",23,23,19,20,26,111
"Arun 005D","E01031415","10-14 years","Female",32,24,23,29,26,134
"Arun 005D","E01031415","15-19 years","Female",20,20,22,23,25,110
"Arun 005D","E01031415","20-24 years","Female",35,34,31,30,24,154
"Arun 005D","E01031415","25-29 years","Female",21,21,25,21,22,110
"Arun 005D","E01031415","30-34 years","Female",26,27,20,22,18,113
"Arun 005D","E01031415","35-39 years","Female",33,29,33,30,33,158
"Arun 005D","E01031415","40-44 years","Female",38,39,37,35,38,187
"Arun 005D","E01031415","45-49 years","Female",42,44,36,42,43,207
"Arun 005D","E01031415","50-54 years","Female",54,51,52,49,40,246
"Arun 005D","E01031415","55-59 years","Female",47,50,57,57,57,268
"Arun 005D","E01031415","60-64 years","Female",45,42,52,57,57,253
"Arun 005D","E01031415","65-69 years","Female",83,70,63,64,57,337
"Arun 005D","E01031415","70-74 years","Female",66,73,62,65,69,335
"Arun 005D","E01031415","75-79 years","Female",73,70,80,82,82,387
"Arun 005D","E01031415","80-84 years","Female",60,58,61,69,70,318
"Arun 005D","E01031415","85+ years","Female",84,86,83,79,78,410
"Arun 005E","E01031459","0-4 years","Male",47,36,41,38,43,205
"Arun 005E","E01031459","5-9 years","Male",57,67,64,53,52,293
"Arun 005E","E01031459","10-14 years","Male",50,51,59,79,78,317
"Arun 005E","E01031459","15-19 years","Male",47,45,33,30,31,186
"Arun 005E","E01031459","20-24 years","Male",46,47,48,46,42,229
"Arun 005E","E01031459","25-29 years","Male",57,54,55,56,51,273
"Arun 005E","E01031459","30-34 years","Male",57,56,61,63,69,306
"Arun 005E","E01031459","35-39 years","Male",35,38,36,36,39,184
"Arun 005E","E01031459","40-44 years","Male",56,54,49,40,38,237
"Arun 005E","E01031459","45-49 years","Male",60,63,61,59,53,296
"Arun 005E","E01031459","50-54 years","Male",62,51,61,61,69,304
"Arun 005E","E01031459","55-59 years","Male",38,44,45,49,50,226
"Arun 005E","E01031459","60-64 years","Male",38,45,41,44,51,219
"Arun 005E","E01031459","65-69 years","Male",55,45,44,33,38,215
"Arun 005E","E01031459","70-74 years","Male",52,59,63,67,65,306
"Arun 005E","E01031459","75-79 years","Male",31,31,27,31,29,149
"Arun 005E","E01031459","80-84 years","Male",36,31,23,28,30,148
"Arun 005E","E01031459","85+ years","Male",17,24,31,30,35,137
"Arun 005E","E01031459","0-4 years","Female",55,59,54,50,47,265
"Arun 005E","E01031459","5-9 years","Female",49,45,49,45,44,232
"Arun 005E","E01031459","10-14 years","Female",51,60,69,68,64,312
"Arun 005E","E01031459","15-19 years","Female",56,62,47,52,53,270
"Arun 005E","E01031459","20-24 years","Female",45,44,42,41,40,212
"Arun 005E","E01031459","25-29 years","Female",52,53,55,50,44,254
"Arun 005E","E01031459","30-34 years","Female",40,43,47,48,51,229
"Arun 005E","E01031459","35-39 years","Female",60,57,57,50,60,284
"Arun 005E","E01031459","40-44 years","Female",62,60,64,60,58,304
"Arun 005E","E01031459","45-49 years","Female",75,67,64,71,68,345
"Arun 005E","E01031459","50-54 years","Female",61,63,57,63,67,311
"Arun 005E","E01031459","55-59 years","Female",56,59,67,65,65,312
"Arun 005E","E01031459","60-64 years","Female",56,58,55,53,57,279
"Arun 005E","E01031459","65-69 years","Female",83,70,59,59,57,328
"Arun 005E","E01031459","70-74 years","Female",53,66,71,73,76,339
"Arun 005E","E01031459","75-79 years","Female",51,45,41,39,45,221
"Arun 005E","E01031459","80-84 years","Female",51,69,70,72,66,328
"Arun 005E","E01031459","85+ years","Female",61,70,64,63,60,318
"Arun 006A","E01031470","0-4 years","Male",53,46,54,53,56,262
"Arun 006A","E01031470","5-9 years","Male",55,65,59,57,53,289
"Arun 006A","E01031470","10-14 years","Male",27,25,29,35,38,154
"Arun 006A","E01031470","15-19 years","Male",31,30,26,22,20,129
"Arun 006A","E01031470","20-24 years","Male",39,44,51,39,40,213
"Arun 006A","E01031470","25-29 years","Male",99,101,135,134,96,565
"Arun 006A","E01031470","30-34 years","Male",108,115,119,120,129,591
"Arun 006A","E01031470","35-39 years","Male",80,93,97,80,95,445
"Arun 006A","E01031470","40-44 years","Male",88,86,85,80,80,419
"Arun 006A","E01031470","45-49 years","Male",85,104,72,89,79,429
"Arun 006A","E01031470","50-54 years","Male",120,109,103,96,86,514
"Arun 006A","E01031470","55-59 years","Male",74,87,67,82,87,397
"Arun 006A","E01031470","60-64 years","Male",57,54,54,71,59,295
"Arun 006A","E01031470","65-69 years","Male",70,64,70,68,73,345
"Arun 006A","E01031470","70-74 years","Male",45,57,57,61,53,273
"Arun 006A","E01031470","75-79 years","Male",30,36,35,35,40,176
"Arun 006A","E01031470","80-84 years","Male",24,23,23,25,29,124
"Arun 006A","E01031470","85+ years","Male",21,19,19,17,13,89
"Arun 006A","E01031470","0-4 years","Female",52,51,46,44,53,246
"Arun 006A","E01031470","5-9 years","Female",44,40,41,39,36,200
"Arun 006A","E01031470","10-14 years","Female",50,49,50,54,63,266
"Arun 006A","E01031470","15-19 years","Female",40,45,41,38,39,203
"Arun 006A","E01031470","20-24 years","Female",26,28,25,24,17,120
"Arun 006A","E01031470","25-29 years","Female",38,44,43,49,57,231
"Arun 006A","E01031470","30-34 years","Female",45,34,32,26,22,159
"Arun 006A","E01031470","35-39 years","Female",39,40,43,52,52,226
"Arun 006A","E01031470","40-44 years","Female",52,49,43,39,42,225
"Arun 006A","E01031470","45-49 years","Female",60,62,57,56,53,288
"Arun 006A","E01031470","50-54 years","Female",51,49,48,54,49,251
"Arun 006A","E01031470","55-59 years","Female",46,47,46,44,43,226
"Arun 006A","E01031470","60-64 years","Female",65,63,65,65,68,326
"Arun 006A","E01031470","65-69 years","Female",51,53,51,55,50,260
"Arun 006A","E01031470","70-74 years","Female",64,73,73,65,57,332
"Arun 006A","E01031470","75-79 years","Female",32,38,42,49,60,221
"Arun 006A","E01031470","80-84 years","Female",23,20,22,27,28,120
"Arun 006A","E01031470","85+ years","Female",17,16,11,12,12,68
"Arun 006B","E01031471","0-4 years","Male",49,59,66,68,60,302
"Arun 006B","E01031471","5-9 years","Male",46,52,58,67,71,294
"Arun 006B","E01031471","10-14 years","Male",60,63,64,55,62,304
"Arun 006B","E01031471","15-19 years","Male",55,62,54,50,57,278
"Arun 006B","E01031471","20-24 years","Male",30,30,30,31,28,149
"Arun 006B","E01031471","25-29 years","Male",32,33,37,35,32,169
"Arun 006B","E01031471","30-34 years","Male",35,39,43,42,49,208
"Arun 006B","E01031471","35-39 years","Male",52,58,58,60,61,289
"Arun 006B","E01031471","40-44 years","Male",36,43,40,42,46,207
"Arun 006B","E01031471","45-49 years","Male",51,59,64,48,42,264
"Arun 006B","E01031471","50-54 years","Male",75,66,65,76,75,357
"Arun 006B","E01031471","55-59 years","Male",46,43,40,44,44,217
"Arun 006B","E01031471","60-64 years","Male",59,67,64,60,65,315
"Arun 006B","E01031471","65-69 years","Male",38,45,48,53,51,235
"Arun 006B","E01031471","70-74 years","Male",33,36,40,46,49,204
"Arun 006B","E01031471","75-79 years","Male",25,22,19,25,27,118
"Arun 006B","E01031471","80-84 years","Male",16,19,19,23,21,98
"Arun 006B","E01031471","85+ years","Male",15,17,19,21,20,92
"Arun 006B","E01031471","0-4 years","Female",67,92,91,70,61,381
"Arun 006B","E01031471","5-9 years","Female",62,78,85,100,96,421
"Arun 006B","E01031471","10-14 years","Female",29,33,35,40,43,180
"Arun 006B","E01031471","15-19 years","Female",38,30,34,33,35,170
"Arun 006B","E01031471","20-24 years","Female",27,28,26,27,21,129
"Arun 006B","E01031471","25-29 years","Female",37,50,54,50,42,233
"Arun 006B","E01031471","30-34 years","Female",50,58,65,70,72,315
"Arun 006B","E01031471","35-39 years","Female",61,60,63,62,71,317
"Arun 006B","E01031471","40-44 years","Female",45,54,51,55,61,266
"Arun 006B","E01031471","45-49 years","Female",50,44,47,42,42,225
"Arun 006B","E01031471","50-54 years","Female",66,79,79,75,70,369
"Arun 006B","E01031471","55-59 years","Female",73,64,72,76,79,364
"Arun 006B","E01031471","60-64 years","Female",68,72,65,72,70,347
"Arun 006B","E01031471","65-69 years","Female",61,67,78,76,79,361
"Arun 006B","E01031471","70-74 years","Female",29,36,34,39,44,182
"Arun 006B","E01031471","75-79 years","Female",25,20,26,30,29,130
"Arun 006B","E01031471","80-84 years","Female",16,11,12,12,12,63
"Arun 006B","E01031471","85+ years","Female",13,12,15,18,21,79
"Arun 006C","E01031472","0-4 years","Male",31,29,26,31,28,145
"Arun 006C","E01031472","5-9 years","Male",33,32,29,30,28,152
"Arun 006C","E01031472","10-14 years","Male",44,47,42,41,29,203
"Arun 006C","E01031472","15-19 years","Male",51,52,49,47,46,245
"Arun 006C","E01031472","20-24 years","Male",32,28,28,33,29,150
"Arun 006C","E01031472","25-29 years","Male",20,26,27,27,32,132
"Arun 006C","E01031472","30-34 years","Male",29,25,25,22,20,121
"Arun 006C","E01031472","35-39 years","Male",30,27,30,30,28,145
"Arun 006C","E01031472","40-44 years","Male",45,34,27,34,30,170
"Arun 006C","E01031472","45-49 years","Male",61,66,68,63,58,316
"Arun 006C","E01031472","50-54 years","Male",59,54,50,49,48,260
"Arun 006C","E01031472","55-59 years","Male",65,67,72,74,80,358
"Arun 006C","E01031472","60-64 years","Male",47,42,43,38,33,203
"Arun 006C","E01031472","65-69 years","Male",59,54,51,55,55,274
"Arun 006C","E01031472","70-74 years","Male",49,56,63,67,64,299
"Arun 006C","E01031472","75-79 years","Male",40,43,48,47,55,233
"Arun 006C","E01031472","80-84 years","Male",24,29,29,26,23,131
"Arun 006C","E01031472","85+ years","Male",22,21,22,18,21,104
"Arun 006C","E01031472","0-4 years","Female",37,36,28,28,28,157
"Arun 006C","E01031472","5-9 years","Female",35,38,39,34,32,178
"Arun 006C","E01031472","10-14 years","Female",46,46,53,53,44,242
"Arun 006C","E01031472","15-19 years","Female",36,39,32,31,42,180
"Arun 006C","E01031472","20-24 years","Female",32,32,30,31,25,150
"Arun 006C","E01031472","25-29 years","Female",36,32,28,29,34,159
"Arun 006C","E01031472","30-34 years","Female",40,39,38,35,32,184
"Arun 006C","E01031472","35-39 years","Female",31,35,41,40,37,184
"Arun 006C","E01031472","40-44 years","Female",40,38,33,29,34,174
"Arun 006C","E01031472","45-49 years","Female",68,66,65,59,54,312
"Arun 006C","E01031472","50-54 years","Female",52,58,58,57,57,282
"Arun 006C","E01031472","55-59 years","Female",63,58,59,62,60,302
"Arun 006C","E01031472","60-64 years","Female",56,63,66,71,75,331
"Arun 006C","E01031472","65-69 years","Female",64,62,57,49,53,285
"Arun 006C","E01031472","70-74 years","Female",55,58,58,65,66,302
"Arun 006C","E01031472","75-79 years","Female",39,39,41,38,37,194
"Arun 006C","E01031472","80-84 years","Female",44,46,42,45,41,218
"Arun 006C","E01031472","85+ years","Female",37,41,44,47,47,216
"Arun 006D","E01031473","0-4 years","Male",35,30,27,29,30,151
"Arun 006D","E01031473","5-9 years","Male",47,48,52,41,42,230
"Arun 006D","E01031473","10-14 years","Male",26,43,44,52,52,217
"Arun 006D","E01031473","15-19 years","Male",46,46,43,39,34,208
"Arun 006D","E01031473","20-24 years","Male",24,23,20,25,27,119
"Arun 006D","E01031473","25-29 years","Male",18,14,17,18,17,84
"Arun 006D","E01031473","30-34 years","Male",23,25,19,16,25,108
"Arun 006D","E01031473","35-39 years","Male",51,48,47,47,41,234
"Arun 006D","E01031473","40-44 years","Male",28,30,33,34,30,155
"Arun 006D","E01031473","45-49 years","Male",48,49,41,31,26,195
"Arun 006D","E01031473","50-54 years","Male",40,38,46,58,55,237
"Arun 006D","E01031473","55-59 years","Male",34,34,25,24,31,148
"Arun 006D","E01031473","60-64 years","Male",43,45,45,42,40,215
"Arun 006D","E01031473","65-69 years","Male",53,52,56,55,47,263
"Arun 006D","E01031473","70-74 years","Male",32,35,38,43,44,192
"Arun 006D","E01031473","75-79 years","Male",15,21,19,20,20,95
"Arun 006D","E01031473","80-84 years","Male",8,9,11,14,18,60
"Arun 006D","E01031473","85+ years","Male",10,9,11,8,17,55
"Arun 006D","E01031473","0-4 years","Female",29,26,33,34,35,157
"Arun 006D","E01031473","5-9 years","Female",44,42,39,34,25,184
"Arun 006D","E01031473","10-14 years","Female",35,32,32,42,54,195
"Arun 006D","E01031473","15-19 years","Female",42,43,47,45,38,215
"Arun 006D","E01031473","20-24 years","Female",27,22,25,28,26,128
"Arun 006D","E01031473","25-29 years","Female",29,28,25,31,30,143
"Arun 006D","E01031473","30-34 years","Female",40,45,47,53,60,245
"Arun 006D","E01031473","35-39 years","Female",46,49,54,46,40,235
"Arun 006D","E01031473","40-44 years","Female",43,45,47,46,42,223
"Arun 006D","E01031473","45-49 years","Female",50,48,48,50,52,248
"Arun 006D","E01031473","50-54 years","Female",39,40,37,40,35,191
"Arun 006D","E01031473","55-59 years","Female",35,29,30,27,33,154
"Arun 006D","E01031473","60-64 years","Female",40,44,36,38,38,196
"Arun 006D","E01031473","65-69 years","Female",40,41,41,40,41,203
"Arun 006D","E01031473","70-74 years","Female",26,29,30,35,39,159
"Arun 006D","E01031473","75-79 years","Female",14,17,22,24,26,103
"Arun 006D","E01031473","80-84 years","Female",25,18,16,14,17,90
"Arun 006D","E01031473","85+ years","Female",35,40,38,41,34,188
"Arun 007A","E01031407","0-4 years","Male",50,45,40,40,36,211
"Arun 007A","E01031407","5-9 years","Male",49,46,46,46,46,233
"Arun 007A","E01031407","10-14 years","Male",51,52,43,44,40,230
"Arun 007A","E01031407","15-19 years","Male",58,54,58,55,59,284
"Arun 007A","E01031407","20-24 years","Male",51,52,50,47,44,244
"Arun 007A","E01031407","25-29 years","Male",27,31,34,32,32,156
"Arun 007A","E01031407","30-34 years","Male",35,29,26,24,25,139
"Arun 007A","E01031407","35-39 years","Male",42,35,43,37,40,197
"Arun 007A","E01031407","40-44 years","Male",55,45,41,38,38,217
"Arun 007A","E01031407","45-49 years","Male",53,58,64,67,60,302
"Arun 007A","E01031407","50-54 years","Male",50,54,47,48,43,242
"Arun 007A","E01031407","55-59 years","Male",49,45,39,43,48,224
"Arun 007A","E01031407","60-64 years","Male",27,37,48,47,55,214
"Arun 007A","E01031407","65-69 years","Male",52,41,38,36,32,199
"Arun 007A","E01031407","70-74 years","Male",34,39,39,41,41,194
"Arun 007A","E01031407","75-79 years","Male",18,19,20,27,29,113
"Arun 007A","E01031407","80-84 years","Male",13,12,11,10,14,60
"Arun 007A","E01031407","85+ years","Male",12,9,12,11,16,60
"Arun 007A","E01031407","0-4 years","Female",40,36,39,33,29,177
"Arun 007A","E01031407","5-9 years","Female",46,42,39,37,36,200
"Arun 007A","E01031407","10-14 years","Female",42,45,44,42,44,217
"Arun 007A","E01031407","15-19 years","Female",54,46,37,37,31,205
"Arun 007A","E01031407","20-24 years","Female",26,28,39,37,41,171
"Arun 007A","E01031407","25-29 years","Female",44,41,43,39,36,203
"Arun 007A","E01031407","30-34 years","Female",36,33,35,35,36,175
"Arun 007A","E01031407","35-39 years","Female",52,50,42,45,35,224
"Arun 007A","E01031407","40-44 years","Female",59,50,50,54,54,267
"Arun 007A","E01031407","45-49 years","Female",80,80,69,65,59,353
"Arun 007A","E01031407","50-54 years","Female",57,53,56,60,57,283
"Arun 007A","E01031407","55-59 years","Female",65,70,74,70,71,350
"Arun 007A","E01031407","60-64 years","Female",51,52,48,62,63,276
"Arun 007A","E01031407","65-69 years","Female",42,40,41,40,46,209
"Arun 007A","E01031407","70-74 years","Female",43,45,49,37,38,212
"Arun 007A","E01031407","75-79 years","Female",23,26,28,31,31,139
"Arun 007A","E01031407","80-84 years","Female",13,15,20,22,25,95
"Arun 007A","E01031407","85+ years","Female",7,4,6,3,4,24
"Arun 007B","E01031408","0-4 years","Male",81,84,76,78,66,385
"Arun 007B","E01031408","5-9 years","Male",79,85,89,80,86,419
"Arun 007B","E01031408","10-14 years","Male",66,65,64,65,76,336
"Arun 007B","E01031408","15-19 years","Male",49,47,46,42,43,227
"Arun 007B","E01031408","20-24 years","Male",41,38,37,40,39,195
"Arun 007B","E01031408","25-29 years","Male",71,68,74,73,72,358
"Arun 007B","E01031408","30-34 years","Male",77,77,83,67,71,375
"Arun 007B","E01031408","35-39 years","Male",67,73,70,70,76,356
"Arun 007B","E01031408","40-44 years","Male",60,60,52,55,57,284
"Arun 007B","E01031408","45-49 years","Male",65,78,75,75,74,367
"Arun 007B","E01031408","50-54 years","Male",65,63,64,66,68,326
"Arun 007B","E01031408","55-59 years","Male",66,62,66,62,64,320
"Arun 007B","E01031408","60-64 years","Male",36,41,44,52,51,224
"Arun 007B","E01031408","65-69 years","Male",63,53,49,41,48,254
"Arun 007B","E01031408","70-74 years","Male",41,45,45,51,52,234
"Arun 007B","E01031408","75-79 years","Male",29,27,28,28,32,144
"Arun 007B","E01031408","80-84 years","Male",10,10,14,16,14,64
"Arun 007B","E01031408","85+ years","Male",23,27,23,23,25,121
"Arun 007B","E01031408","0-4 years","Female",76,73,58,64,51,322
"Arun 007B","E01031408","5-9 years","Female",76,86,86,70,82,400
"Arun 007B","E01031408","10-14 years","Female",76,78,78,72,71,375
"Arun 007B","E01031408","15-19 years","Female",48,47,43,44,48,230
"Arun 007B","E01031408","20-24 years","Female",63,63,49,51,49,275
"Arun 007B","E01031408","25-29 years","Female",61,52,61,56,47,277
"Arun 007B","E01031408","30-34 years","Female",76,90,80,73,75,394
"Arun 007B","E01031408","35-39 years","Female",82,81,76,72,67,378
"Arun 007B","E01031408","40-44 years","Female",76,77,69,78,83,383
"Arun 007B","E01031408","45-49 years","Female",62,61,64,65,67,319
"Arun 007B","E01031408","50-54 years","Female",85,86,82,67,63,383
"Arun 007B","E01031408","55-59 years","Female",60,57,56,70,65,308
"Arun 007B","E01031408","60-64 years","Female",55,64,63,62,79,323
"Arun 007B","E01031408","65-69 years","Female",63,48,52,48,47,258
"Arun 007B","E01031408","70-74 years","Female",47,50,57,54,58,266
"Arun 007B","E01031408","75-79 years","Female",28,27,28,32,31,146
"Arun 007B","E01031408","80-84 years","Female",24,26,20,19,22,111
"Arun 007B","E01031408","85+ years","Female",12,16,24,31,32,115
"Arun 007C","E01031410","0-4 years","Male",39,36,37,35,33,180
"Arun 007C","E01031410","5-9 years","Male",31,32,31,28,31,153
"Arun 007C","E01031410","10-14 years","Male",27,27,25,29,35,143
"Arun 007C","E01031410","15-19 years","Male",34,28,28,33,27,150
"Arun 007C","E01031410","20-24 years","Male",28,26,25,29,22,130
"Arun 007C","E01031410","25-29 years","Male",43,40,45,43,38,209
"Arun 007C","E01031410","30-34 years","Male",44,43,41,40,46,214
"Arun 007C","E01031410","35-39 years","Male",37,38,44,43,40,202
"Arun 007C","E01031410","40-44 years","Male",35,38,27,32,39,171
"Arun 007C","E01031410","45-49 years","Male",52,43,47,40,37,219
"Arun 007C","E01031410","50-54 years","Male",43,45,48,51,51,238
"Arun 007C","E01031410","55-59 years","Male",44,46,39,37,38,204
"Arun 007C","E01031410","60-64 years","Male",39,35,39,38,47,198
"Arun 007C","E01031410","65-69 years","Male",49,50,53,50,44,246
"Arun 007C","E01031410","70-74 years","Male",34,38,45,43,46,206
"Arun 007C","E01031410","75-79 years","Male",13,17,15,20,29,94
"Arun 007C","E01031410","80-84 years","Male",18,16,10,12,11,67
"Arun 007C","E01031410","85+ years","Male",16,21,22,22,15,96
"Arun 007C","E01031410","0-4 years","Female",40,33,31,32,39,175
"Arun 007C","E01031410","5-9 years","Female",29,32,31,27,30,149
"Arun 007C","E01031410","10-14 years","Female",36,36,37,36,34,179
"Arun 007C","E01031410","15-19 years","Female",31,32,25,34,36,158
"Arun 007C","E01031410","20-24 years","Female",43,32,36,38,30,179
"Arun 007C","E01031410","25-29 years","Female",41,48,45,43,31,208
"Arun 007C","E01031410","30-34 years","Female",48,41,51,47,65,252
"Arun 007C","E01031410","35-39 years","Female",46,48,43,49,39,225
"Arun 007C","E01031410","40-44 years","Female",39,39,42,40,42,202
"Arun 007C","E01031410","45-49 years","Female",39,32,28,22,26,147
"Arun 007C","E01031410","50-54 years","Female",56,54,53,51,45,259
"Arun 007C","E01031410","55-59 years","Female",49,54,54,55,55,267
"Arun 007C","E01031410","60-64 years","Female",49,43,44,49,48,233
"Arun 007C","E01031410","65-69 years","Female",39,46,56,53,48,242
"Arun 007C","E01031410","70-74 years","Female",45,53,47,50,53,248
"Arun 007C","E01031410","75-79 years","Female",32,37,41,33,26,169
"Arun 007C","E01031410","80-84 years","Female",24,19,24,24,33,124
"Arun 007C","E01031410","85+ years","Female",17,20,19,23,23,102
"Arun 007D","E01031462","0-4 years","Male",53,55,56,54,52,270
"Arun 007D","E01031462","5-9 years","Male",48,47,49,50,50,244
"Arun 007D","E01031462","10-14 years","Male",40,37,41,49,56,223
"Arun 007D","E01031462","15-19 years","Male",32,30,35,36,29,162
"Arun 007D","E01031462","20-24 years","Male",43,41,34,30,29,177
"Arun 007D","E01031462","25-29 years","Male",36,41,41,42,44,204
"Arun 007D","E01031462","30-34 years","Male",38,30,40,45,42,195
"Arun 007D","E01031462","35-39 years","Male",47,51,43,40,46,227
"Arun 007D","E01031462","40-44 years","Male",33,30,34,38,39,174
"Arun 007D","E01031462","45-49 years","Male",50,44,45,44,47,230
"Arun 007D","E01031462","50-54 years","Male",47,48,53,49,50,247
"Arun 007D","E01031462","55-59 years","Male",48,60,61,57,55,281
"Arun 007D","E01031462","60-64 years","Male",43,47,43,49,49,231
"Arun 007D","E01031462","65-69 years","Male",33,28,33,38,42,174
"Arun 007D","E01031462","70-74 years","Male",32,30,30,31,39,162
"Arun 007D","E01031462","75-79 years","Male",34,32,30,24,27,147
"Arun 007D","E01031462","80-84 years","Male",15,20,30,46,43,154
"Arun 007D","E01031462","85+ years","Male",17,16,15,10,9,67
"Arun 007D","E01031462","0-4 years","Female",65,51,50,46,42,254
"Arun 007D","E01031462","5-9 years","Female",50,59,61,67,62,299
"Arun 007D","E01031462","10-14 years","Female",37,37,36,40,47,197
"Arun 007D","E01031462","15-19 years","Female",46,48,39,33,30,196
"Arun 007D","E01031462","20-24 years","Female",43,34,34,37,39,187
"Arun 007D","E01031462","25-29 years","Female",45,43,41,42,42,213
"Arun 007D","E01031462","30-34 years","Female",35,43,41,45,40,204
"Arun 007D","E01031462","35-39 years","Female",54,47,48,50,56,255
"Arun 007D","E01031462","40-44 years","Female",48,47,54,48,50,247
"Arun 007D","E01031462","45-49 years","Female",57,56,58,60,52,283
"Arun 007D","E01031462","50-54 years","Female",47,50,45,43,38,223
"Arun 007D","E01031462","55-59 years","Female",50,53,47,51,56,257
"Arun 007D","E01031462","60-64 years","Female",42,38,51,54,58,243
"Arun 007D","E01031462","65-69 years","Female",45,42,34,31,41,193
"Arun 007D","E01031462","70-74 years","Female",59,55,59,55,57,285
"Arun 007D","E01031462","75-79 years","Female",34,43,42,44,40,203
"Arun 007D","E01031462","80-84 years","Female",13,18,20,21,27,99
"Arun 007D","E01031462","85+ years","Female",39,40,30,28,28,165
"Arun 007E","E01031463","0-4 years","Male",34,37,42,47,45,205
"Arun 007E","E01031463","5-9 years","Male",40,48,41,36,39,204
"Arun 007E","E01031463","10-14 years","Male",45,40,43,45,53,226
"Arun 007E","E01031463","15-19 years","Male",35,41,51,51,45,223
"Arun 007E","E01031463","20-24 years","Male",36,36,37,36,38,183
"Arun 007E","E01031463","25-29 years","Male",27,25,28,29,30,139
"Arun 007E","E01031463","30-34 years","Male",31,32,27,25,28,143
"Arun 007E","E01031463","35-39 years","Male",30,28,31,29,25,143
"Arun 007E","E01031463","40-44 years","Male",48,40,40,39,44,211
"Arun 007E","E01031463","45-49 years","Male",49,61,55,53,47,265
"Arun 007E","E01031463","50-54 years","Male",58,57,55,54,53,277
"Arun 007E","E01031463","55-59 years","Male",58,58,80,77,77,350
"Arun 007E","E01031463","60-64 years","Male",49,46,43,39,51,228
"Arun 007E","E01031463","65-69 years","Male",47,49,48,53,51,248
"Arun 007E","E01031463","70-74 years","Male",48,53,45,43,47,236
"Arun 007E","E01031463","75-79 years","Male",40,45,42,50,49,226
"Arun 007E","E01031463","80-84 years","Male",36,41,42,37,37,193
"Arun 007E","E01031463","85+ years","Male",29,35,35,29,27,155
"Arun 007E","E01031463","0-4 years","Female",45,35,38,33,34,185
"Arun 007E","E01031463","5-9 years","Female",56,50,46,42,42,236
"Arun 007E","E01031463","10-14 years","Female",56,61,50,57,58,282
"Arun 007E","E01031463","15-19 years","Female",41,43,43,41,42,210
"Arun 007E","E01031463","20-24 years","Female",23,23,31,30,30,137
"Arun 007E","E01031463","25-29 years","Female",28,29,25,19,22,123
"Arun 007E","E01031463","30-34 years","Female",39,31,33,34,37,174
"Arun 007E","E01031463","35-39 years","Female",45,50,42,40,39,216
"Arun 007E","E01031463","40-44 years","Female",38,26,41,43,47,195
"Arun 007E","E01031463","45-49 years","Female",72,78,66,61,64,341
"Arun 007E","E01031463","50-54 years","Female",63,65,73,63,56,320
"Arun 007E","E01031463","55-59 years","Female",54,61,54,63,65,297
"Arun 007E","E01031463","60-64 years","Female",59,50,50,54,65,278
"Arun 007E","E01031463","65-69 years","Female",54,54,55,50,49,262
"Arun 007E","E01031463","70-74 years","Female",51,45,46,47,49,238
"Arun 007E","E01031463","75-79 years","Female",52,55,55,62,51,275
"Arun 007E","E01031463","80-84 years","Female",50,46,42,45,44,227
"Arun 007E","E01031463","85+ years","Female",61,62,64,66,60,313
"Arun 007F","E01031464","0-4 years","Male",38,41,52,45,46,222
"Arun 007F","E01031464","5-9 years","Male",45,51,51,44,48,239
"Arun 007F","E01031464","10-14 years","Male",32,36,35,45,41,189
"Arun 007F","E01031464","15-19 years","Male",38,38,39,34,33,182
"Arun 007F","E01031464","20-24 years","Male",22,21,23,33,34,133
"Arun 007F","E01031464","25-29 years","Male",26,31,43,29,25,154
"Arun 007F","E01031464","30-34 years","Male",40,46,49,53,51,239
"Arun 007F","E01031464","35-39 years","Male",27,28,28,26,27,136
"Arun 007F","E01031464","40-44 years","Male",28,31,29,32,32,152
"Arun 007F","E01031464","45-49 years","Male",40,40,43,40,32,195
"Arun 007F","E01031464","50-54 years","Male",50,41,41,42,45,219
"Arun 007F","E01031464","55-59 years","Male",31,31,32,33,38,165
"Arun 007F","E01031464","60-64 years","Male",35,35,38,41,36,185
"Arun 007F","E01031464","65-69 years","Male",47,44,43,38,40,212
"Arun 007F","E01031464","70-74 years","Male",58,70,68,65,66,327
"Arun 007F","E01031464","75-79 years","Male",49,42,45,44,44,224
"Arun 007F","E01031464","80-84 years","Male",31,32,35,36,36,170
"Arun 007F","E01031464","85+ years","Male",27,30,36,33,38,164
"Arun 007F","E01031464","0-4 years","Female",25,28,35,28,27,143
"Arun 007F","E01031464","5-9 years","Female",34,27,28,37,36,162
"Arun 007F","E01031464","10-14 years","Female",26,30,29,26,26,137
"Arun 007F","E01031464","15-19 years","Female",35,32,28,29,31,155
"Arun 007F","E01031464","20-24 years","Female",23,22,23,21,23,112
"Arun 007F","E01031464","25-29 years","Female",30,32,33,28,32,155
"Arun 007F","E01031464","30-34 years","Female",44,52,51,52,49,248
"Arun 007F","E01031464","35-39 years","Female",25,17,21,21,25,109
"Arun 007F","E01031464","40-44 years","Female",38,36,33,36,32,175
"Arun 007F","E01031464","45-49 years","Female",60,59,53,50,50,272
"Arun 007F","E01031464","50-54 years","Female",56,56,60,55,45,272
"Arun 007F","E01031464","55-59 years","Female",41,55,54,64,73,287
"Arun 007F","E01031464","60-64 years","Female",48,40,47,46,45,226
"Arun 007F","E01031464","65-69 years","Female",74,68,58,63,64,327
"Arun 007F","E01031464","70-74 years","Female",65,74,77,70,62,348
"Arun 007F","E01031464","75-79 years","Female",87,72,87,87,91,424
"Arun 007F","E01031464","80-84 years","Female",67,74,63,71,79,354
"Arun 007F","E01031464","85+ years","Female",85,85,83,78,73,404
"Arun 008A","E01031412","0-4 years","Male",10,12,11,9,10,52
"Arun 008A","E01031412","5-9 years","Male",27,18,23,22,17,107
"Arun 008A","E01031412","10-14 years","Male",29,33,27,30,35,154
"Arun 008A","E01031412","15-19 years","Male",34,28,28,24,24,138
"Arun 008A","E01031412","20-24 years","Male",16,18,23,21,21,99
"Arun 008A","E01031412","25-29 years","Male",5,4,3,4,5,21
"Arun 008A","E01031412","30-34 years","Male",17,11,13,11,6,58
"Arun 008A","E01031412","35-39 years","Male",19,13,13,12,16,73
"Arun 008A","E01031412","40-44 years","Male",21,23,23,19,17,103
"Arun 008A","E01031412","45-49 years","Male",53,54,48,50,48,253
"Arun 008A","E01031412","50-54 years","Male",48,41,51,45,41,226
"Arun 008A","E01031412","55-59 years","Male",40,48,50,51,57,246
"Arun 008A","E01031412","60-64 years","Male",52,50,45,44,40,231
"Arun 008A","E01031412","65-69 years","Male",88,82,61,46,51,328
"Arun 008A","E01031412","70-74 years","Male",71,81,90,94,83,419
"Arun 008A","E01031412","75-79 years","Male",50,51,57,64,66,288
"Arun 008A","E01031412","80-84 years","Male",34,33,38,41,45,191
"Arun 008A","E01031412","85+ years","Male",26,30,25,26,28,135
"Arun 008A","E01031412","0-4 years","Female",14,16,17,18,24,89
"Arun 008A","E01031412","5-9 years","Female",14,15,13,13,10,65
"Arun 008A","E01031412","10-14 years","Female",24,23,26,34,33,140
"Arun 008A","E01031412","15-19 years","Female",42,38,40,32,26,178
"Arun 008A","E01031412","20-24 years","Female",25,24,21,25,25,120
"Arun 008A","E01031412","25-29 years","Female",19,21,22,25,18,105
"Arun 008A","E01031412","30-34 years","Female",5,5,9,11,10,40
"Arun 008A","E01031412","35-39 years","Female",17,13,15,13,11,69
"Arun 008A","E01031412","40-44 years","Female",39,42,43,40,36,200
"Arun 008A","E01031412","45-49 years","Female",45,41,40,40,41,207
"Arun 008A","E01031412","50-54 years","Female",51,48,47,48,49,243
"Arun 008A","E01031412","55-59 years","Female",53,57,60,55,52,277
"Arun 008A","E01031412","60-64 years","Female",48,53,51,50,55,257
"Arun 008A","E01031412","65-69 years","Female",102,92,79,81,71,425
"Arun 008A","E01031412","70-74 years","Female",84,97,93,89,96,459
"Arun 008A","E01031412","75-79 years","Female",46,53,63,69,76,307
"Arun 008A","E01031412","80-84 years","Female",41,45,42,45,44,217
"Arun 008A","E01031412","85+ years","Female",45,37,40,44,42,208
"Arun 008B","E01031422","0-4 years","Male",9,10,8,4,5,36
"Arun 008B","E01031422","5-9 years","Male",22,18,16,15,17,88
"Arun 008B","E01031422","10-14 years","Male",20,30,29,31,33,143
"Arun 008B","E01031422","15-19 years","Male",25,23,24,22,17,111
"Arun 008B","E01031422","20-24 years","Male",15,17,13,13,14,72
"Arun 008B","E01031422","25-29 years","Male",22,17,15,20,19,93
"Arun 008B","E01031422","30-34 years","Male",11,11,11,9,8,50
"Arun 008B","E01031422","35-39 years","Male",11,14,14,10,8,57
"Arun 008B","E01031422","40-44 years","Male",21,19,19,15,17,91
"Arun 008B","E01031422","45-49 years","Male",43,40,40,35,33,191
"Arun 008B","E01031422","50-54 years","Male",35,45,46,45,45,216
"Arun 008B","E01031422","55-59 years","Male",44,36,37,40,46,203
"Arun 008B","E01031422","60-64 years","Male",56,61,64,63,60,304
"Arun 008B","E01031422","65-69 years","Male",90,81,82,76,72,401
"Arun 008B","E01031422","70-74 years","Male",94,100,102,90,91,477
"Arun 008B","E01031422","75-79 years","Male",76,77,78,81,88,400
"Arun 008B","E01031422","80-84 years","Male",35,40,46,60,60,241
"Arun 008B","E01031422","85+ years","Male",57,48,45,47,49,246
"Arun 008B","E01031422","0-4 years","Female",16,13,13,14,12,68
"Arun 008B","E01031422","5-9 years","Female",8,8,7,4,5,32
"Arun 008B","E01031422","10-14 years","Female",12,14,13,13,12,64
"Arun 008B","E01031422","15-19 years","Female",27,23,29,26,30,135
"Arun 008B","E01031422","20-24 years","Female",19,17,19,17,14,86
"Arun 008B","E01031422","25-29 years","Female",14,12,12,10,11,59
"Arun 008B","E01031422","30-34 years","Female",10,5,5,4,3,27
"Arun 008B","E01031422","35-39 years","Female",18,19,18,19,15,89
"Arun 008B","E01031422","40-44 years","Female",30,23,22,18,21,114
"Arun 008B","E01031422","45-49 years","Female",37,38,41,34,28,178
"Arun 008B","E01031422","50-54 years","Female",41,43,41,39,41,205
"Arun 008B","E01031422","55-59 years","Female",70,60,67,69,79,345
"Arun 008B","E01031422","60-64 years","Female",79,84,74,72,68,377
"Arun 008B","E01031422","65-69 years","Female",102,91,96,94,90,473
"Arun 008B","E01031422","70-74 years","Female",96,117,110,109,112,544
"Arun 008B","E01031422","75-79 years","Female",81,74,90,95,100,440
"Arun 008B","E01031422","80-84 years","Female",59,59,63,60,67,308
"Arun 008B","E01031422","85+ years","Female",95,94,87,94,94,464
"Arun 008C","E01031423","0-4 years","Male",33,31,30,25,37,156
"Arun 008C","E01031423","5-9 years","Male",28,30,26,24,25,133
"Arun 008C","E01031423","10-14 years","Male",40,38,45,38,37,198
"Arun 008C","E01031423","15-19 years","Male",37,38,40,47,45,207
"Arun 008C","E01031423","20-24 years","Male",34,30,31,42,33,170
"Arun 008C","E01031423","25-29 years","Male",27,28,27,28,35,145
"Arun 008C","E01031423","30-34 years","Male",21,22,29,29,33,134
"Arun 008C","E01031423","35-39 years","Male",29,30,31,29,36,155
"Arun 008C","E01031423","40-44 years","Male",35,38,40,40,33,186
"Arun 008C","E01031423","45-49 years","Male",52,54,49,39,47,241
"Arun 008C","E01031423","50-54 years","Male",43,41,45,50,41,220
"Arun 008C","E01031423","55-59 years","Male",76,69,81,82,92,400
"Arun 008C","E01031423","60-64 years","Male",41,62,58,69,65,295
"Arun 008C","E01031423","65-69 years","Male",75,69,58,58,50,310
"Arun 008C","E01031423","70-74 years","Male",72,71,86,82,85,396
"Arun 008C","E01031423","75-79 years","Male",60,57,54,60,62,293
"Arun 008C","E01031423","80-84 years","Male",58,56,58,56,58,286
"Arun 008C","E01031423","85+ years","Male",34,37,44,46,44,205
"Arun 008C","E01031423","0-4 years","Female",18,17,14,20,19,88
"Arun 008C","E01031423","5-9 years","Female",23,24,26,28,26,127
"Arun 008C","E01031423","10-14 years","Female",36,33,37,33,39,178
"Arun 008C","E01031423","15-19 years","Female",43,42,37,40,36,198
"Arun 008C","E01031423","20-24 years","Female",15,13,16,24,21,89
"Arun 008C","E01031423","25-29 years","Female",14,14,18,17,12,75
"Arun 008C","E01031423","30-34 years","Female",16,10,11,13,17,67
"Arun 008C","E01031423","35-39 years","Female",36,36,38,39,35,184
"Arun 008C","E01031423","40-44 years","Female",36,37,42,39,37,191
"Arun 008C","E01031423","45-49 years","Female",46,50,49,52,53,250
"Arun 008C","E01031423","50-54 years","Female",65,64,62,53,48,292
"Arun 008C","E01031423","55-59 years","Female",80,81,100,113,103,477
"Arun 008C","E01031423","60-64 years","Female",55,56,55,61,71,298
"Arun 008C","E01031423","65-69 years","Female",103,92,83,75,76,429
"Arun 008C","E01031423","70-74 years","Female",103,109,106,107,104,529
"Arun 008C","E01031423","75-79 years","Female",73,81,95,104,107,460
"Arun 008C","E01031423","80-84 years","Female",75,74,74,64,60,347
"Arun 008C","E01031423","85+ years","Female",48,51,45,50,62,256
"Arun 008D","E01031424","0-4 years","Male",18,18,20,18,11,85
"Arun 008D","E01031424","5-9 years","Male",22,22,29,29,27,129
"Arun 008D","E01031424","10-14 years","Male",25,22,21,26,26,120
"Arun 008D","E01031424","15-19 years","Male",17,11,14,11,11,64
"Arun 008D","E01031424","20-24 years","Male",10,16,18,19,17,80
"Arun 008D","E01031424","25-29 years","Male",17,15,20,18,15,85
"Arun 008D","E01031424","30-34 years","Male",12,12,10,12,8,54
"Arun 008D","E01031424","35-39 years","Male",20,17,16,14,9,76
"Arun 008D","E01031424","40-44 years","Male",27,27,22,19,22,117
"Arun 008D","E01031424","45-49 years","Male",36,33,32,28,27,156
"Arun 008D","E01031424","50-54 years","Male",34,40,51,52,37,214
"Arun 008D","E01031424","55-59 years","Male",56,48,40,37,44,225
"Arun 008D","E01031424","60-64 years","Male",57,50,50,50,41,248
"Arun 008D","E01031424","65-69 years","Male",77,76,74,71,66,364
"Arun 008D","E01031424","70-74 years","Male",76,81,82,84,84,407
"Arun 008D","E01031424","75-79 years","Male",50,49,51,51,53,254
"Arun 008D","E01031424","80-84 years","Male",46,49,42,40,40,217
"Arun 008D","E01031424","85+ years","Male",47,55,50,51,56,259
"Arun 008D","E01031424","0-4 years","Female",12,9,15,9,7,52
"Arun 008D","E01031424","5-9 years","Female",21,18,17,17,14,87
"Arun 008D","E01031424","10-14 years","Female",15,15,15,15,18,78
"Arun 008D","E01031424","15-19 years","Female",17,19,17,20,12,85
"Arun 008D","E01031424","20-24 years","Female",14,15,18,16,20,83
"Arun 008D","E01031424","25-29 years","Female",12,7,7,8,5,39
"Arun 008D","E01031424","30-34 years","Female",17,16,16,18,13,80
"Arun 008D","E01031424","35-39 years","Female",20,17,22,23,25,107
"Arun 008D","E01031424","40-44 years","Female",42,33,28,26,28,157
"Arun 008D","E01031424","45-49 years","Female",44,41,36,31,28,180
"Arun 008D","E01031424","50-54 years","Female",43,52,53,48,44,240
"Arun 008D","E01031424","55-59 years","Female",54,50,45,44,47,240
"Arun 008D","E01031424","60-64 years","Female",65,71,71,67,65,339
"Arun 008D","E01031424","65-69 years","Female",97,83,79,85,85,429
"Arun 008D","E01031424","70-74 years","Female",85,97,97,93,99,471
"Arun 008D","E01031424","75-79 years","Female",75,81,80,82,77,395
"Arun 008D","E01031424","80-84 years","Female",66,62,63,65,61,317
"Arun 008D","E01031424","85+ years","Female",88,87,80,81,82,418
"Arun 009A","E01031398","0-4 years","Male",33,31,28,24,26,142
"Arun 009A","E01031398","5-9 years","Male",40,47,43,45,44,219
"Arun 009A","E01031398","10-14 years","Male",51,44,40,47,53,235
"Arun 009A","E01031398","15-19 years","Male",53,44,39,40,45,221
"Arun 009A","E01031398","20-24 years","Male",43,54,50,46,43,236
"Arun 009A","E01031398","25-29 years","Male",27,34,38,45,40,184
"Arun 009A","E01031398","30-34 years","Male",37,28,25,26,25,141
"Arun 009A","E01031398","35-39 years","Male",46,46,43,41,43,219
"Arun 009A","E01031398","40-44 years","Male",37,38,29,30,30,164
"Arun 009A","E01031398","45-49 years","Male",50,45,38,40,35,208
"Arun 009A","E01031398","50-54 years","Male",59,56,58,52,58,283
"Arun 009A","E01031398","55-59 years","Male",40,45,43,48,53,229
"Arun 009A","E01031398","60-64 years","Male",51,58,56,55,44,264
"Arun 009A","E01031398","65-69 years","Male",67,62,45,49,55,278
"Arun 009A","E01031398","70-74 years","Male",32,32,50,44,52,210
"Arun 009A","E01031398","75-79 years","Male",31,30,33,39,31,164
"Arun 009A","E01031398","80-84 years","Male",45,45,43,47,41,221
"Arun 009A","E01031398","85+ years","Male",18,20,25,24,24,111
"Arun 009A","E01031398","0-4 years","Female",20,22,21,23,22,108
"Arun 009A","E01031398","5-9 years","Female",34,29,31,30,27,151
"Arun 009A","E01031398","10-14 years","Female",30,36,31,28,43,168
"Arun 009A","E01031398","15-19 years","Female",41,41,36,37,32,187
"Arun 009A","E01031398","20-24 years","Female",30,33,30,28,25,146
"Arun 009A","E01031398","25-29 years","Female",29,25,27,29,30,140
"Arun 009A","E01031398","30-34 years","Female",30,31,27,19,26,133
"Arun 009A","E01031398","35-39 years","Female",37,41,35,39,35,187
"Arun 009A","E01031398","40-44 years","Female",37,34,35,30,34,170
"Arun 009A","E01031398","45-49 years","Female",56,56,50,51,45,258
"Arun 009A","E01031398","50-54 years","Female",55,52,56,60,65,288
"Arun 009A","E01031398","55-59 years","Female",57,61,62,53,53,286
"Arun 009A","E01031398","60-64 years","Female",59,52,53,57,58,279
"Arun 009A","E01031398","65-69 years","Female",64,67,66,66,63,326
"Arun 009A","E01031398","70-74 years","Female",38,51,57,61,59,266
"Arun 009A","E01031398","75-79 years","Female",55,45,40,42,38,220
"Arun 009A","E01031398","80-84 years","Female",27,27,37,37,37,165
"Arun 009A","E01031398","85+ years","Female",38,41,40,34,40,193
"Arun 009B","E01031399","0-4 years","Male",35,35,30,32,25,157
"Arun 009B","E01031399","5-9 years","Male",26,29,26,24,23,128
"Arun 009B","E01031399","10-14 years","Male",28,33,40,34,33,168
"Arun 009B","E01031399","15-19 years","Male",35,34,29,24,22,144
"Arun 009B","E01031399","20-24 years","Male",33,35,34,34,30,166
"Arun 009B","E01031399","25-29 years","Male",21,19,17,24,28,109
"Arun 009B","E01031399","30-34 years","Male",16,22,22,20,18,98
"Arun 009B","E01031399","35-39 years","Male",40,35,31,28,27,161
"Arun 009B","E01031399","40-44 years","Male",28,29,31,36,35,159
"Arun 009B","E01031399","45-49 years","Male",40,40,39,36,27,182
"Arun 009B","E01031399","50-54 years","Male",49,52,45,49,45,240
"Arun 009B","E01031399","55-59 years","Male",31,33,44,47,51,206
"Arun 009B","E01031399","60-64 years","Male",51,48,50,49,45,243
"Arun 009B","E01031399","65-69 years","Male",87,73,61,56,54,331
"Arun 009B","E01031399","70-74 years","Male",81,97,105,108,104,495
"Arun 009B","E01031399","75-79 years","Male",50,51,52,53,59,265
"Arun 009B","E01031399","80-84 years","Male",49,44,48,46,47,234
"Arun 009B","E01031399","85+ years","Male",39,46,53,51,56,245
"Arun 009B","E01031399","0-4 years","Female",18,21,23,21,19,102
"Arun 009B","E01031399","5-9 years","Female",31,39,38,38,34,180
"Arun 009B","E01031399","10-14 years","Female",42,37,38,37,30,184
"Arun 009B","E01031399","15-19 years","Female",27,31,25,27,30,140
"Arun 009B","E01031399","20-24 years","Female",29,23,22,20,18,112
"Arun 009B","E01031399","25-29 years","Female",20,28,30,26,19,123
"Arun 009B","E01031399","30-34 years","Female",32,29,29,31,24,145
"Arun 009B","E01031399","35-39 years","Female",44,48,43,39,36,210
"Arun 009B","E01031399","40-44 years","Female",33,28,32,34,35,162
"Arun 009B","E01031399","45-49 years","Female",46,51,47,46,44,234
"Arun 009B","E01031399","50-54 years","Female",52,45,44,46,47,234
"Arun 009B","E01031399","55-59 years","Female",52,50,58,54,50,264
"Arun 009B","E01031399","60-64 years","Female",74,82,85,83,77,401
"Arun 009B","E01031399","65-69 years","Female",107,110,95,88,84,484
"Arun 009B","E01031399","70-74 years","Female",95,95,102,112,122,526
"Arun 009B","E01031399","75-79 years","Female",54,60,62,65,60,301
"Arun 009B","E01031399","80-84 years","Female",56,60,56,56,59,287
"Arun 009B","E01031399","85+ years","Female",38,36,37,42,45,198
"Arun 009C","E01031409","0-4 years","Male",35,34,33,33,33,168
"Arun 009C","E01031409","5-9 years","Male",71,58,51,50,33,263
"Arun 009C","E01031409","10-14 years","Male",59,72,72,76,78,357
"Arun 009C","E01031409","15-19 years","Male",58,55,52,48,53,266
"Arun 009C","E01031409","20-24 years","Male",34,41,48,40,38,201
"Arun 009C","E01031409","25-29 years","Male",58,52,47,43,54,254
"Arun 009C","E01031409","30-34 years","Male",31,32,32,36,33,164
"Arun 009C","E01031409","35-39 years","Male",33,41,38,43,48,203
"Arun 009C","E01031409","40-44 years","Male",37,38,36,34,32,177
"Arun 009C","E01031409","45-49 years","Male",55,47,50,50,44,246
"Arun 009C","E01031409","50-54 years","Male",48,61,59,61,63,292
"Arun 009C","E01031409","55-59 years","Male",39,41,45,40,47,212
"Arun 009C","E01031409","60-64 years","Male",35,38,41,42,39,195
"Arun 009C","E01031409","65-69 years","Male",49,46,40,42,33,210
"Arun 009C","E01031409","70-74 years","Male",25,26,30,30,35,146
"Arun 009C","E01031409","75-79 years","Male",22,17,15,18,19,91
"Arun 009C","E01031409","80-84 years","Male",13,17,13,16,12,71
"Arun 009C","E01031409","85+ years","Male",12,15,10,11,12,60
"Arun 009C","E01031409","0-4 years","Female",45,37,42,38,35,197
"Arun 009C","E01031409","5-9 years","Female",29,37,39,43,39,187
"Arun 009C","E01031409","10-14 years","Female",49,41,40,41,43,214
"Arun 009C","E01031409","15-19 years","Female",49,52,50,46,47,244
"Arun 009C","E01031409","20-24 years","Female",32,33,31,30,27,153
"Arun 009C","E01031409","25-29 years","Female",35,31,27,26,28,147
"Arun 009C","E01031409","30-34 years","Female",33,33,37,37,36,176
"Arun 009C","E01031409","35-39 years","Female",47,47,51,50,42,237
"Arun 009C","E01031409","40-44 years","Female",49,43,34,41,48,215
"Arun 009C","E01031409","45-49 years","Female",53,51,49,41,37,231
"Arun 009C","E01031409","50-54 years","Female",34,34,35,42,48,193
"Arun 009C","E01031409","55-59 years","Female",48,49,46,44,36,223
"Arun 009C","E01031409","60-64 years","Female",61,51,56,52,54,274
"Arun 009C","E01031409","65-69 years","Female",53,46,44,48,51,242
"Arun 009C","E01031409","70-74 years","Female",31,38,37,44,41,191
"Arun 009C","E01031409","75-79 years","Female",32,36,38,32,36,174
"Arun 009C","E01031409","80-84 years","Female",10,12,14,15,15,66
"Arun 009C","E01031409","85+ years","Female",13,9,10,8,9,49
"Arun 009D","E01031455","0-4 years","Male",35,40,42,36,37,190
"Arun 009D","E01031455","5-9 years","Male",28,30,39,37,42,176
"Arun 009D","E01031455","10-14 years","Male",29,23,27,25,25,129
"Arun 009D","E01031455","15-19 years","Male",48,45,42,41,40,216
"Arun 009D","E01031455","20-24 years","Male",38,36,30,29,29,162
"Arun 009D","E01031455","25-29 years","Male",36,38,41,41,35,191
"Arun 009D","E01031455","30-34 years","Male",28,33,32,31,30,154
"Arun 009D","E01031455","35-39 years","Male",25,23,23,29,28,128
"Arun 009D","E01031455","40-44 years","Male",36,33,26,26,20,141
"Arun 009D","E01031455","45-49 years","Male",57,46,43,34,38,218
"Arun 009D","E01031455","50-54 years","Male",68,71,83,81,66,369
"Arun 009D","E01031455","55-59 years","Male",38,40,34,39,52,203
"Arun 009D","E01031455","60-64 years","Male",57,52,58,56,57,280
"Arun 009D","E01031455","65-69 years","Male",46,47,38,42,41,214
"Arun 009D","E01031455","70-74 years","Male",48,48,56,61,56,269
"Arun 009D","E01031455","75-79 years","Male",50,48,44,43,45,230
"Arun 009D","E01031455","80-84 years","Male",19,24,25,24,26,118
"Arun 009D","E01031455","85+ years","Male",28,25,31,24,26,134
"Arun 009D","E01031455","0-4 years","Female",46,45,44,38,38,211
"Arun 009D","E01031455","5-9 years","Female",27,32,34,35,35,163
"Arun 009D","E01031455","10-14 years","Female",44,44,45,37,38,208
"Arun 009D","E01031455","15-19 years","Female",39,28,21,23,21,132
"Arun 009D","E01031455","20-24 years","Female",38,36,37,32,30,173
"Arun 009D","E01031455","25-29 years","Female",41,47,42,45,40,215
"Arun 009D","E01031455","30-34 years","Female",32,39,38,33,39,181
"Arun 009D","E01031455","35-39 years","Female",37,39,37,38,36,187
"Arun 009D","E01031455","40-44 years","Female",37,35,31,31,24,158
"Arun 009D","E01031455","45-49 years","Female",41,51,42,36,42,212
"Arun 009D","E01031455","50-54 years","Female",55,47,46,44,39,231
"Arun 009D","E01031455","55-59 years","Female",57,65,74,77,82,355
"Arun 009D","E01031455","60-64 years","Female",32,27,28,32,39,158
"Arun 009D","E01031455","65-69 years","Female",59,55,49,49,44,256
"Arun 009D","E01031455","70-74 years","Female",53,56,64,69,68,310
"Arun 009D","E01031455","75-79 years","Female",48,46,51,49,55,249
"Arun 009D","E01031455","80-84 years","Female",47,52,55,64,67,285
"Arun 009D","E01031455","85+ years","Female",82,80,76,78,91,407
"Arun 009E","E01031461","0-4 years","Male",28,24,22,15,14,103
"Arun 009E","E01031461","5-9 years","Male",42,40,37,32,33,184
"Arun 009E","E01031461","10-14 years","Male",45,41,46,46,37,215
"Arun 009E","E01031461","15-19 years","Male",25,29,26,26,33,139
"Arun 009E","E01031461","20-24 years","Male",23,17,16,18,19,93
"Arun 009E","E01031461","25-29 years","Male",19,24,21,18,17,99
"Arun 009E","E01031461","30-34 years","Male",25,24,21,19,21,110
"Arun 009E","E01031461","35-39 years","Male",31,29,27,18,17,122
"Arun 009E","E01031461","40-44 years","Male",32,27,33,36,39,167
"Arun 009E","E01031461","45-49 years","Male",54,61,61,53,46,275
"Arun 009E","E01031461","50-54 years","Male",49,48,50,48,51,246
"Arun 009E","E01031461","55-59 years","Male",48,47,45,55,51,246
"Arun 009E","E01031461","60-64 years","Male",54,54,58,53,52,271
"Arun 009E","E01031461","65-69 years","Male",74,64,61,59,52,310
"Arun 009E","E01031461","70-74 years","Male",82,97,94,92,97,462
"Arun 009E","E01031461","75-79 years","Male",70,70,74,74,72,360
"Arun 009E","E01031461","80-84 years","Male",45,51,50,55,49,250
"Arun 009E","E01031461","85+ years","Male",46,44,47,45,46,228
"Arun 009E","E01031461","0-4 years","Female",18,20,16,15,13,82
"Arun 009E","E01031461","5-9 years","Female",31,37,31,34,29,162
"Arun 009E","E01031461","10-14 years","Female",40,39,36,29,23,167
"Arun 009E","E01031461","15-19 years","Female",30,29,33,33,36,161
"Arun 009E","E01031461","20-24 years","Female",19,23,23,26,24,115
"Arun 009E","E01031461","25-29 years","Female",29,28,30,25,25,137
"Arun 009E","E01031461","30-34 years","Female",21,19,17,18,16,91
"Arun 009E","E01031461","35-39 years","Female",36,35,31,24,21,147
"Arun 009E","E01031461","40-44 years","Female",40,34,42,42,42,200
"Arun 009E","E01031461","45-49 years","Female",51,58,51,49,42,251
"Arun 009E","E01031461","50-54 years","Female",60,60,64,61,59,304
"Arun 009E","E01031461","55-59 years","Female",67,72,75,79,78,371
"Arun 009E","E01031461","60-64 years","Female",72,69,68,70,66,345
"Arun 009E","E01031461","65-69 years","Female",113,101,105,92,89,500
"Arun 009E","E01031461","70-74 years","Female",81,100,107,109,107,504
"Arun 009E","E01031461","75-79 years","Female",71,69,75,81,93,389
"Arun 009E","E01031461","80-84 years","Female",65,59,62,66,61,313
"Arun 009E","E01031461","85+ years","Female",67,68,66,62,60,323
"Arun 009F","E01031469","0-4 years","Male",39,35,27,33,36,170
"Arun 009F","E01031469","5-9 years","Male",57,45,39,40,37,218
"Arun 009F","E01031469","10-14 years","Male",31,39,48,47,51,216
"Arun 009F","E01031469","15-19 years","Male",36,30,26,33,34,159
"Arun 009F","E01031469","20-24 years","Male",44,45,36,33,28,186
"Arun 009F","E01031469","25-29 years","Male",37,35,40,29,31,172
"Arun 009F","E01031469","30-34 years","Male",29,27,23,28,28,135
"Arun 009F","E01031469","35-39 years","Male",35,29,36,32,37,169
"Arun 009F","E01031469","40-44 years","Male",34,41,32,37,36,180
"Arun 009F","E01031469","45-49 years","Male",56,45,46,39,35,221
"Arun 009F","E01031469","50-54 years","Male",78,80,80,67,63,368
"Arun 009F","E01031469","55-59 years","Male",45,49,46,58,58,256
"Arun 009F","E01031469","60-64 years","Male",55,56,53,52,48,264
"Arun 009F","E01031469","65-69 years","Male",60,55,59,58,60,292
"Arun 009F","E01031469","70-74 years","Male",39,47,44,46,50,226
"Arun 009F","E01031469","75-79 years","Male",53,50,54,60,55,272
"Arun 009F","E01031469","80-84 years","Male",35,36,31,30,33,165
"Arun 009F","E01031469","85+ years","Male",27,26,29,31,36,149
"Arun 009F","E01031469","0-4 years","Female",32,33,36,39,39,179
"Arun 009F","E01031469","5-9 years","Female",54,50,45,48,58,255
"Arun 009F","E01031469","10-14 years","Female",38,43,46,45,43,215
"Arun 009F","E01031469","15-19 years","Female",31,30,28,36,36,161
"Arun 009F","E01031469","20-24 years","Female",24,26,24,23,26,123
"Arun 009F","E01031469","25-29 years","Female",47,44,45,39,31,206
"Arun 009F","E01031469","30-34 years","Female",47,48,45,45,57,242
"Arun 009F","E01031469","35-39 years","Female",39,31,34,37,36,177
"Arun 009F","E01031469","40-44 years","Female",34,42,35,39,34,184
"Arun 009F","E01031469","45-49 years","Female",81,78,76,56,54,345
"Arun 009F","E01031469","50-54 years","Female",57,48,51,57,56,269
"Arun 009F","E01031469","55-59 years","Female",69,67,67,67,57,327
"Arun 009F","E01031469","60-64 years","Female",68,71,69,67,73,348
"Arun 009F","E01031469","65-69 years","Female",55,54,57,62,58,286
"Arun 009F","E01031469","70-74 years","Female",49,50,50,54,63,266
"Arun 009F","E01031469","75-79 years","Female",49,47,53,53,43,245
"Arun 009F","E01031469","80-84 years","Female",49,50,47,42,53,241
"Arun 009F","E01031469","85+ years","Female",30,30,28,30,33,151
"Arun 010A","E01031411","0-4 years","Male",13,18,18,21,18,88
"Arun 010A","E01031411","5-9 years","Male",13,8,5,3,2,31
"Arun 010A","E01031411","10-14 years","Male",17,24,29,25,28,123
"Arun 010A","E01031411","15-19 years","Male",24,26,25,28,21,124
"Arun 010A","E01031411","20-24 years","Male",19,17,15,14,16,81
"Arun 010A","E01031411","25-29 years","Male",7,10,6,6,5,34
"Arun 010A","E01031411","30-34 years","Male",13,14,11,10,12,60
"Arun 010A","E01031411","35-39 years","Male",13,10,7,12,12,54
"Arun 010A","E01031411","40-44 years","Male",23,22,20,19,15,99
"Arun 010A","E01031411","45-49 years","Male",36,34,33,34,30,167
"Arun 010A","E01031411","50-54 years","Male",36,43,39,38,39,195
"Arun 010A","E01031411","55-59 years","Male",28,30,27,29,29,143
"Arun 010A","E01031411","60-64 years","Male",50,41,51,47,51,240
"Arun 010A","E01031411","65-69 years","Male",84,78,57,55,49,323
"Arun 010A","E01031411","70-74 years","Male",82,95,110,116,112,515
"Arun 010A","E01031411","75-79 years","Male",58,59,59,54,65,295
"Arun 010A","E01031411","80-84 years","Male",44,46,46,55,50,241
"Arun 010A","E01031411","85+ years","Male",50,50,48,44,42,234
"Arun 010A","E01031411","0-4 years","Female",9,10,8,8,8,43
"Arun 010A","E01031411","5-9 years","Female",20,21,19,18,12,90
"Arun 010A","E01031411","10-14 years","Female",23,18,24,22,17,104
"Arun 010A","E01031411","15-19 years","Female",14,16,15,15,17,77
"Arun 010A","E01031411","20-24 years","Female",4,6,7,8,8,33
"Arun 010A","E01031411","25-29 years","Female",14,12,15,13,15,69
"Arun 010A","E01031411","30-34 years","Female",14,11,8,12,12,57
"Arun 010A","E01031411","35-39 years","Female",10,9,11,10,9,49
"Arun 010A","E01031411","40-44 years","Female",26,24,27,20,19,116
"Arun 010A","E01031411","45-49 years","Female",34,32,37,42,42,187
"Arun 010A","E01031411","50-54 years","Female",37,38,31,27,24,157
"Arun 010A","E01031411","55-59 years","Female",57,58,55,53,54,277
"Arun 010A","E01031411","60-64 years","Female",71,67,60,64,62,324
"Arun 010A","E01031411","65-69 years","Female",107,91,95,86,82,461
"Arun 010A","E01031411","70-74 years","Female",90,118,121,126,125,580
"Arun 010A","E01031411","75-79 years","Female",68,64,81,81,88,382
"Arun 010A","E01031411","80-84 years","Female",60,57,48,54,56,275
"Arun 010A","E01031411","85+ years","Female",82,98,106,102,98,486
"Arun 010B","E01031413","0-4 years","Male",20,19,13,12,11,75
"Arun 010B","E01031413","5-9 years","Male",21,27,24,28,27,127
"Arun 010B","E01031413","10-14 years","Male",12,10,11,13,17,63
"Arun 010B","E01031413","15-19 years","Male",25,27,22,21,15,110
"Arun 010B","E01031413","20-24 years","Male",28,29,29,26,36,148
"Arun 010B","E01031413","25-29 years","Male",20,30,35,35,34,154
"Arun 010B","E01031413","30-34 years","Male",14,8,6,10,13,51
"Arun 010B","E01031413","35-39 years","Male",22,27,33,25,17,124
"Arun 010B","E01031413","40-44 years","Male",29,25,20,21,22,117
"Arun 010B","E01031413","45-49 years","Male",28,25,25,28,28,134
"Arun 010B","E01031413","50-54 years","Male",44,49,53,44,45,235
"Arun 010B","E01031413","55-59 years","Male",41,39,46,48,53,227
"Arun 010B","E01031413","60-64 years","Male",49,42,37,36,36,200
"Arun 010B","E01031413","65-69 years","Male",52,56,52,56,62,278
"Arun 010B","E01031413","70-74 years","Male",69,77,79,74,76,375
"Arun 010B","E01031413","75-79 years","Male",54,51,58,67,61,291
"Arun 010B","E01031413","80-84 years","Male",45,45,36,42,40,208
"Arun 010B","E01031413","85+ years","Male",64,59,58,47,41,269
"Arun 010B","E01031413","0-4 years","Female",13,11,13,15,12,64
"Arun 010B","E01031413","5-9 years","Female",30,35,28,34,32,159
"Arun 010B","E01031413","10-14 years","Female",26,26,25,22,22,121
"Arun 010B","E01031413","15-19 years","Female",21,19,24,21,20,105
"Arun 010B","E01031413","20-24 years","Female",14,17,21,16,12,80
"Arun 010B","E01031413","25-29 years","Female",15,14,17,9,12,67
"Arun 010B","E01031413","30-34 years","Female",19,17,15,19,20,90
"Arun 010B","E01031413","35-39 years","Female",26,20,17,18,22,103
"Arun 010B","E01031413","40-44 years","Female",35,31,34,29,28,157
"Arun 010B","E01031413","45-49 years","Female",52,50,40,46,36,224
"Arun 010B","E01031413","50-54 years","Female",55,59,61,51,56,282
"Arun 010B","E01031413","55-59 years","Female",53,51,52,55,53,264
"Arun 010B","E01031413","60-64 years","Female",51,50,62,63,60,286
"Arun 010B","E01031413","65-69 years","Female",87,93,78,70,76,404
"Arun 010B","E01031413","70-74 years","Female",63,75,97,105,101,441
"Arun 010B","E01031413","75-79 years","Female",83,77,71,66,76,373
"Arun 010B","E01031413","80-84 years","Female",43,45,55,56,58,257
"Arun 010B","E01031413","85+ years","Female",176,171,159,141,143,790
"Arun 010C","E01031457","0-4 years","Male",19,27,24,22,24,116
"Arun 010C","E01031457","5-9 years","Male",43,37,31,24,26,161
"Arun 010C","E01031457","10-14 years","Male",14,17,19,21,24,95
"Arun 010C","E01031457","15-19 years","Male",20,22,14,10,13,79
"Arun 010C","E01031457","20-24 years","Male",28,26,25,28,26,133
"Arun 010C","E01031457","25-29 years","Male",43,38,35,32,22,170
"Arun 010C","E01031457","30-34 years","Male",15,15,13,12,19,74
"Arun 010C","E01031457","35-39 years","Male",21,26,28,35,29,139
"Arun 010C","E01031457","40-44 years","Male",35,36,37,26,32,166
"Arun 010C","E01031457","45-49 years","Male",31,29,25,27,29,141
"Arun 010C","E01031457","50-54 years","Male",58,58,51,50,41,258
"Arun 010C","E01031457","55-59 years","Male",52,47,47,44,56,246
"Arun 010C","E01031457","60-64 years","Male",68,72,60,64,57,321
"Arun 010C","E01031457","65-69 years","Male",70,79,86,79,68,382
"Arun 010C","E01031457","70-74 years","Male",79,80,84,88,89,420
"Arun 010C","E01031457","75-79 years","Male",71,73,73,68,80,365
"Arun 010C","E01031457","80-84 years","Male",56,53,55,64,64,292
"Arun 010C","E01031457","85+ years","Male",66,70,65,62,65,328
"Arun 010C","E01031457","0-4 years","Female",31,28,27,17,21,124
"Arun 010C","E01031457","5-9 years","Female",30,35,42,39,40,186
"Arun 010C","E01031457","10-14 years","Female",17,20,25,28,28,118
"Arun 010C","E01031457","15-19 years","Female",16,16,14,14,14,74
"Arun 010C","E01031457","20-24 years","Female",12,18,14,13,13,70
"Arun 010C","E01031457","25-29 years","Female",35,27,31,29,29,151
"Arun 010C","E01031457","30-34 years","Female",26,33,29,23,27,138
"Arun 010C","E01031457","35-39 years","Female",28,30,34,32,27,151
"Arun 010C","E01031457","40-44 years","Female",17,23,24,27,29,120
"Arun 010C","E01031457","45-49 years","Female",46,42,39,34,24,185
"Arun 010C","E01031457","50-54 years","Female",50,49,54,59,56,268
"Arun 010C","E01031457","55-59 years","Female",42,36,42,46,46,212
"Arun 010C","E01031457","60-64 years","Female",78,77,79,68,67,369
"Arun 010C","E01031457","65-69 years","Female",99,91,91,97,97,475
"Arun 010C","E01031457","70-74 years","Female",108,118,116,128,130,600
"Arun 010C","E01031457","75-79 years","Female",105,98,91,87,90,471
"Arun 010C","E01031457","80-84 years","Female",77,77,87,91,94,426
"Arun 010C","E01031457","85+ years","Female",91,99,100,96,89,475
"Arun 010D","E01031458","0-4 years","Male",12,12,8,8,8,48
"Arun 010D","E01031458","5-9 years","Male",26,20,15,23,23,107
"Arun 010D","E01031458","10-14 years","Male",31,24,25,20,21,121
"Arun 010D","E01031458","15-19 years","Male",19,22,22,24,22,109
"Arun 010D","E01031458","20-24 years","Male",18,15,9,10,9,61
"Arun 010D","E01031458","25-29 years","Male",18,19,20,16,9,82
"Arun 010D","E01031458","30-34 years","Male",13,13,12,14,15,67
"Arun 010D","E01031458","35-39 years","Male",25,23,19,16,14,97
"Arun 010D","E01031458","40-44 years","Male",39,27,20,23,20,129
"Arun 010D","E01031458","45-49 years","Male",33,30,37,37,28,165
"Arun 010D","E01031458","50-54 years","Male",48,53,49,45,39,234
"Arun 010D","E01031458","55-59 years","Male",46,40,41,45,48,220
"Arun 010D","E01031458","60-64 years","Male",75,78,74,71,71,369
"Arun 010D","E01031458","65-69 years","Male",119,119,108,107,96,549
"Arun 010D","E01031458","70-74 years","Male",103,116,128,123,126,596
"Arun 010D","E01031458","75-79 years","Male",82,86,88,93,94,443
"Arun 010D","E01031458","80-84 years","Male",73,66,72,75,66,352
"Arun 010D","E01031458","85+ years","Male",49,55,51,58,60,273
"Arun 010D","E01031458","0-4 years","Female",19,15,17,23,23,97
"Arun 010D","E01031458","5-9 years","Female",13,12,12,11,9,57
"Arun 010D","E01031458","10-14 years","Female",26,22,20,19,19,106
"Arun 010D","E01031458","15-19 years","Female",30,36,30,28,30,154
"Arun 010D","E01031458","20-24 years","Female",21,26,19,27,14,107
"Arun 010D","E01031458","25-29 years","Female",10,12,13,12,19,66
"Arun 010D","E01031458","30-34 years","Female",14,13,17,15,11,70
"Arun 010D","E01031458","35-39 years","Female",30,27,20,24,18,119
"Arun 010D","E01031458","40-44 years","Female",38,32,32,28,23,153
"Arun 010D","E01031458","45-49 years","Female",55,56,50,52,58,271
"Arun 010D","E01031458","50-54 years","Female",48,50,59,57,57,271
"Arun 010D","E01031458","55-59 years","Female",53,66,59,62,63,303
"Arun 010D","E01031458","60-64 years","Female",84,80,83,92,80,419
"Arun 010D","E01031458","65-69 years","Female",167,141,128,114,116,666
"Arun 010D","E01031458","70-74 years","Female",113,138,142,154,162,709
"Arun 010D","E01031458","75-79 years","Female",97,101,113,101,99,511
"Arun 010D","E01031458","80-84 years","Female",91,94,96,94,98,473
"Arun 010D","E01031458","85+ years","Female",79,82,84,88,86,419
"Arun 010E","E01031460","0-4 years","Male",20,20,20,19,22,101
"Arun 010E","E01031460","5-9 years","Male",25,25,22,22,21,115
"Arun 010E","E01031460","10-14 years","Male",22,20,21,20,13,96
"Arun 010E","E01031460","15-19 years","Male",28,26,24,23,25,126
"Arun 010E","E01031460","20-24 years","Male",18,21,17,19,19,94
"Arun 010E","E01031460","25-29 years","Male",21,23,22,21,26,113
"Arun 010E","E01031460","30-34 years","Male",32,28,27,25,22,134
"Arun 010E","E01031460","35-39 years","Male",16,20,19,22,24,101
"Arun 010E","E01031460","40-44 years","Male",36,32,25,27,21,141
"Arun 010E","E01031460","45-49 years","Male",53,46,48,44,41,232
"Arun 010E","E01031460","50-54 years","Male",38,43,52,46,43,222
"Arun 010E","E01031460","55-59 years","Male",63,56,55,52,46,272
"Arun 010E","E01031460","60-64 years","Male",50,52,53,60,65,280
"Arun 010E","E01031460","65-69 years","Male",99,76,65,69,67,376
"Arun 010E","E01031460","70-74 years","Male",99,122,127,121,110,579
"Arun 010E","E01031460","75-79 years","Male",61,66,70,76,96,369
"Arun 010E","E01031460","80-84 years","Male",59,54,54,52,45,264
"Arun 010E","E01031460","85+ years","Male",63,69,75,79,74,360
"Arun 010E","E01031460","0-4 years","Female",20,21,17,29,26,113
"Arun 010E","E01031460","5-9 years","Female",19,16,13,14,20,82
"Arun 010E","E01031460","10-14 years","Female",24,22,21,21,14,102
"Arun 010E","E01031460","15-19 years","Female",19,22,15,20,19,95
"Arun 010E","E01031460","20-24 years","Female",18,18,21,17,17,91
"Arun 010E","E01031460","25-29 years","Female",32,29,20,22,18,121
"Arun 010E","E01031460","30-34 years","Female",21,24,34,34,32,145
"Arun 010E","E01031460","35-39 years","Female",21,17,17,17,19,91
"Arun 010E","E01031460","40-44 years","Female",33,30,21,23,15,122
"Arun 010E","E01031460","45-49 years","Female",39,38,43,40,50,210
"Arun 010E","E01031460","50-54 years","Female",46,47,59,52,46,250
"Arun 010E","E01031460","55-59 years","Female",67,65,66,66,63,327
"Arun 010E","E01031460","60-64 years","Female",64,65,68,65,65,327
"Arun 010E","E01031460","65-69 years","Female",131,125,110,101,96,563
"Arun 010E","E01031460","70-74 years","Female",124,142,146,163,154,729
"Arun 010E","E01031460","75-79 years","Female",74,72,88,88,107,429
"Arun 010E","E01031460","80-84 years","Female",79,79,82,83,78,401
"Arun 010E","E01031460","85+ years","Female",96,99,89,77,76,437
"Arun 011A","E01031400","0-4 years","Male",26,22,27,27,31,133
"Arun 011A","E01031400","5-9 years","Male",30,27,25,24,26,132
"Arun 011A","E01031400","10-14 years","Male",37,43,41,44,46,211
"Arun 011A","E01031400","15-19 years","Male",29,35,37,34,34,169
"Arun 011A","E01031400","20-24 years","Male",61,59,55,51,54,280
"Arun 011A","E01031400","25-29 years","Male",69,79,64,55,48,315
"Arun 011A","E01031400","30-34 years","Male",51,53,57,60,64,285
"Arun 011A","E01031400","35-39 years","Male",48,47,46,44,52,237
"Arun 011A","E01031400","40-44 years","Male",64,62,55,61,58,300
"Arun 011A","E01031400","45-49 years","Male",64,65,57,50,57,293
"Arun 011A","E01031400","50-54 years","Male",75,67,76,68,67,353
"Arun 011A","E01031400","55-59 years","Male",65,70,64,64,51,314
"Arun 011A","E01031400","60-64 years","Male",43,42,52,58,66,261
"Arun 011A","E01031400","65-69 years","Male",57,60,55,55,40,267
"Arun 011A","E01031400","70-74 years","Male",40,41,47,45,56,229
"Arun 011A","E01031400","75-79 years","Male",38,35,37,33,31,174
"Arun 011A","E01031400","80-84 years","Male",24,23,26,22,25,120
"Arun 011A","E01031400","85+ years","Male",26,25,25,27,20,123
"Arun 011A","E01031400","0-4 years","Female",34,40,25,21,23,143
"Arun 011A","E01031400","5-9 years","Female",26,29,26,18,21,120
"Arun 011A","E01031400","10-14 years","Female",25,35,31,42,43,176
"Arun 011A","E01031400","15-19 years","Female",46,33,36,33,29,177
"Arun 011A","E01031400","20-24 years","Female",51,49,34,33,41,208
"Arun 011A","E01031400","25-29 years","Female",57,44,42,40,44,227
"Arun 011A","E01031400","30-34 years","Female",32,37,35,37,34,175
"Arun 011A","E01031400","35-39 years","Female",38,47,40,42,41,208
"Arun 011A","E01031400","40-44 years","Female",50,49,51,49,45,244
"Arun 011A","E01031400","45-49 years","Female",65,63,63,47,51,289
"Arun 011A","E01031400","50-54 years","Female",47,48,51,51,51,248
"Arun 011A","E01031400","55-59 years","Female",51,49,42,46,51,239
"Arun 011A","E01031400","60-64 years","Female",50,53,58,57,57,275
"Arun 011A","E01031400","65-69 years","Female",62,57,52,56,55,282
"Arun 011A","E01031400","70-74 years","Female",52,51,48,51,56,258
"Arun 011A","E01031400","75-79 years","Female",38,39,39,40,35,191
"Arun 011A","E01031400","80-84 years","Female",23,26,31,34,39,153
"Arun 011A","E01031400","85+ years","Female",76,67,60,61,49,313
"Arun 011B","E01031428","0-4 years","Male",64,62,58,57,52,293
"Arun 011B","E01031428","5-9 years","Male",71,67,65,69,62,334
"Arun 011B","E01031428","10-14 years","Male",52,54,59,65,75,305
"Arun 011B","E01031428","15-19 years","Male",42,33,34,33,30,172
"Arun 011B","E01031428","20-24 years","Male",42,31,33,37,35,178
"Arun 011B","E01031428","25-29 years","Male",56,52,45,44,38,235
"Arun 011B","E01031428","30-34 years","Male",66,63,70,62,67,328
"Arun 011B","E01031428","35-39 years","Male",51,50,51,47,42,241
"Arun 011B","E01031428","40-44 years","Male",57,51,48,50,51,257
"Arun 011B","E01031428","45-49 years","Male",69,69,69,62,59,328
"Arun 011B","E01031428","50-54 years","Male",54,49,46,47,49,245
"Arun 011B","E01031428","55-59 years","Male",43,46,50,55,57,251
"Arun 011B","E01031428","60-64 years","Male",39,41,35,35,36,186
"Arun 011B","E01031428","65-69 years","Male",36,29,28,24,29,146
"Arun 011B","E01031428","70-74 years","Male",22,24,29,30,31,136
"Arun 011B","E01031428","75-79 years","Male",28,30,28,25,24,135
"Arun 011B","E01031428","80-84 years","Male",17,12,19,21,20,89
"Arun 011B","E01031428","85+ years","Male",7,11,7,9,5,39
"Arun 011B","E01031428","0-4 years","Female",57,61,59,48,54,279
"Arun 011B","E01031428","5-9 years","Female",48,56,54,56,59,273
"Arun 011B","E01031428","10-14 years","Female",47,36,34,37,42,196
"Arun 011B","E01031428","15-19 years","Female",42,46,37,40,35,200
"Arun 011B","E01031428","20-24 years","Female",76,66,64,53,59,318
"Arun 011B","E01031428","25-29 years","Female",51,51,49,43,43,237
"Arun 011B","E01031428","30-34 years","Female",55,60,65,62,54,296
"Arun 011B","E01031428","35-39 years","Female",53,59,58,62,72,304
"Arun 011B","E01031428","40-44 years","Female",69,62,55,55,42,283
"Arun 011B","E01031428","45-49 years","Female",67,58,60,67,82,334
"Arun 011B","E01031428","50-54 years","Female",58,58,57,60,59,292
"Arun 011B","E01031428","55-59 years","Female",39,40,42,47,51,219
"Arun 011B","E01031428","60-64 years","Female",30,31,37,37,38,173
"Arun 011B","E01031428","65-69 years","Female",56,54,53,40,37,240
"Arun 011B","E01031428","70-74 years","Female",29,34,36,41,42,182
"Arun 011B","E01031428","75-79 years","Female",17,14,18,17,19,85
"Arun 011B","E01031428","80-84 years","Female",21,16,15,17,13,82
"Arun 011B","E01031428","85+ years","Female",15,18,14,18,19,84
"Arun 011C","E01031454","0-4 years","Male",93,83,73,77,87,413
"Arun 011C","E01031454","5-9 years","Male",72,74,88,84,76,394
"Arun 011C","E01031454","10-14 years","Male",40,37,39,45,52,213
"Arun 011C","E01031454","15-19 years","Male",58,55,55,54,54,276
"Arun 011C","E01031454","20-24 years","Male",82,80,65,60,57,344
"Arun 011C","E01031454","25-29 years","Male",97,95,112,96,93,493
"Arun 011C","E01031454","30-34 years","Male",67,63,63,69,77,339
"Arun 011C","E01031454","35-39 years","Male",88,96,92,84,85,445
"Arun 011C","E01031454","40-44 years","Male",75,65,74,79,80,373
"Arun 011C","E01031454","45-49 years","Male",89,89,83,82,95,438
"Arun 011C","E01031454","50-54 years","Male",114,103,90,92,89,488
"Arun 011C","E01031454","55-59 years","Male",91,99,100,95,89,474
"Arun 011C","E01031454","60-64 years","Male",66,82,79,80,88,395
"Arun 011C","E01031454","65-69 years","Male",65,54,66,62,62,309
"Arun 011C","E01031454","70-74 years","Male",52,72,69,81,78,352
"Arun 011C","E01031454","75-79 years","Male",27,38,46,49,50,210
"Arun 011C","E01031454","80-84 years","Male",18,13,12,14,17,74
"Arun 011C","E01031454","85+ years","Male",14,18,16,25,22,95
"Arun 011C","E01031454","0-4 years","Female",89,86,80,71,80,406
"Arun 011C","E01031454","5-9 years","Female",52,51,52,51,52,258
"Arun 011C","E01031454","10-14 years","Female",58,55,52,60,59,284
"Arun 011C","E01031454","15-19 years","Female",48,47,51,51,57,254
"Arun 011C","E01031454","20-24 years","Female",79,77,72,66,63,357
"Arun 011C","E01031454","25-29 years","Female",100,95,98,96,88,477
"Arun 011C","E01031454","30-34 years","Female",70,71,68,67,74,350
"Arun 011C","E01031454","35-39 years","Female",91,86,81,70,73,401
"Arun 011C","E01031454","40-44 years","Female",78,77,77,78,71,381
"Arun 011C","E01031454","45-49 years","Female",67,68,71,76,79,361
"Arun 011C","E01031454","50-54 years","Female",107,112,105,104,111,539
"Arun 011C","E01031454","55-59 years","Female",82,84,89,91,92,438
"Arun 011C","E01031454","60-64 years","Female",64,67,62,68,75,336
"Arun 011C","E01031454","65-69 years","Female",56,64,65,58,65,308
"Arun 011C","E01031454","70-74 years","Female",49,50,53,60,59,271
"Arun 011C","E01031454","75-79 years","Female",21,26,31,26,30,134
"Arun 011C","E01031454","80-84 years","Female",28,31,27,23,22,131
"Arun 011C","E01031454","85+ years","Female",45,38,38,36,40,197
"Arun 011D","E01031456","0-4 years","Male",57,55,42,35,48,237
"Arun 011D","E01031456","5-9 years","Male",42,38,38,39,40,197
"Arun 011D","E01031456","10-14 years","Male",38,29,23,24,23,137
"Arun 011D","E01031456","15-19 years","Male",12,20,19,20,22,93
"Arun 011D","E01031456","20-24 years","Male",41,35,28,25,24,153
"Arun 011D","E01031456","25-29 years","Male",87,87,81,80,83,418
"Arun 011D","E01031456","30-34 years","Male",67,58,59,63,69,316
"Arun 011D","E01031456","35-39 years","Male",60,71,72,65,63,331
"Arun 011D","E01031456","40-44 years","Male",53,50,47,48,55,253
"Arun 011D","E01031456","45-49 years","Male",62,68,74,69,64,337
"Arun 011D","E01031456","50-54 years","Male",67,59,49,50,58,283
"Arun 011D","E01031456","55-59 years","Male",60,67,75,78,74,354
"Arun 011D","E01031456","60-64 years","Male",75,60,51,50,49,285
"Arun 011D","E01031456","65-69 years","Male",64,62,69,73,69,337
"Arun 011D","E01031456","70-74 years","Male",54,61,58,61,62,296
"Arun 011D","E01031456","75-79 years","Male",44,37,50,57,61,249
"Arun 011D","E01031456","80-84 years","Male",36,36,26,27,32,157
"Arun 011D","E01031456","85+ years","Male",26,34,27,25,24,136
"Arun 011D","E01031456","0-4 years","Female",56,57,53,58,53,277
"Arun 011D","E01031456","5-9 years","Female",23,25,26,23,25,122
"Arun 011D","E01031456","10-14 years","Female",36,31,34,37,31,169
"Arun 011D","E01031456","15-19 years","Female",31,38,30,26,29,154
"Arun 011D","E01031456","20-24 years","Female",60,61,50,46,47,264
"Arun 011D","E01031456","25-29 years","Female",72,67,54,53,53,299
"Arun 011D","E01031456","30-34 years","Female",52,54,57,62,62,287
"Arun 011D","E01031456","35-39 years","Female",61,53,56,65,51,286
"Arun 011D","E01031456","40-44 years","Female",52,56,49,47,56,260
"Arun 011D","E01031456","45-49 years","Female",43,48,47,39,30,207
"Arun 011D","E01031456","50-54 years","Female",61,60,53,57,64,295
"Arun 011D","E01031456","55-59 years","Female",61,66,69,71,66,333
"Arun 011D","E01031456","60-64 years","Female",36,45,51,48,58,238
"Arun 011D","E01031456","65-69 years","Female",48,53,53,59,59,272
"Arun 011D","E01031456","70-74 years","Female",42,43,51,45,52,233
"Arun 011D","E01031456","75-79 years","Female",44,44,43,42,40,213
"Arun 011D","E01031456","80-84 years","Female",40,38,46,53,50,227
"Arun 011D","E01031456","85+ years","Female",62,65,56,48,43,274
"Arun 012A","E01031401","0-4 years","Male",80,92,94,105,122,493
"Arun 012A","E01031401","5-9 years","Male",86,100,107,110,111,514
"Arun 012A","E01031401","10-14 years","Male",55,57,64,59,83,318
"Arun 012A","E01031401","15-19 years","Male",64,56,57,64,56,297
"Arun 012A","E01031401","20-24 years","Male",67,73,77,87,82,386
"Arun 012A","E01031401","25-29 years","Male",85,87,86,85,101,444
"Arun 012A","E01031401","30-34 years","Male",104,113,113,135,126,591
"Arun 012A","E01031401","35-39 years","Male",59,64,74,74,83,354
"Arun 012A","E01031401","40-44 years","Male",91,83,85,89,90,438
"Arun 012A","E01031401","45-49 years","Male",108,110,111,115,107,551
"Arun 012A","E01031401","50-54 years","Male",73,87,91,93,93,437
"Arun 012A","E01031401","55-59 years","Male",76,76,72,70,74,368
"Arun 012A","E01031401","60-64 years","Male",64,59,59,66,77,325
"Arun 012A","E01031401","65-69 years","Male",56,69,76,71,74,346
"Arun 012A","E01031401","70-74 years","Male",63,65,67,75,78,348
"Arun 012A","E01031401","75-79 years","Male",53,47,59,57,65,281
"Arun 012A","E01031401","80-84 years","Male",31,32,31,32,32,158
"Arun 012A","E01031401","85+ years","Male",12,18,14,15,13,72
"Arun 012A","E01031401","0-4 years","Female",129,134,132,137,138,670
"Arun 012A","E01031401","5-9 years","Female",97,113,114,114,136,574
"Arun 012A","E01031401","10-14 years","Female",57,60,64,69,85,335
"Arun 012A","E01031401","15-19 years","Female",85,80,83,71,66,385
"Arun 012A","E01031401","20-24 years","Female",64,60,64,75,72,335
"Arun 012A","E01031401","25-29 years","Female",140,138,138,137,129,682
"Arun 012A","E01031401","30-34 years","Female",96,96,108,112,127,539
"Arun 012A","E01031401","35-39 years","Female",76,85,91,109,113,474
"Arun 012A","E01031401","40-44 years","Female",88,88,87,83,98,444
"Arun 012A","E01031401","45-49 years","Female",91,86,88,93,97,455
"Arun 012A","E01031401","50-54 years","Female",102,89,88,98,103,480
"Arun 012A","E01031401","55-59 years","Female",76,86,94,92,93,441
"Arun 012A","E01031401","60-64 years","Female",72,74,80,89,96,411
"Arun 012A","E01031401","65-69 years","Female",81,84,82,90,91,428
"Arun 012A","E01031401","70-74 years","Female",75,90,95,91,103,454
"Arun 012A","E01031401","75-79 years","Female",50,49,53,56,53,261
"Arun 012A","E01031401","80-84 years","Female",34,30,29,37,43,173
"Arun 012A","E01031401","85+ years","Female",37,41,36,42,41,197
"Arun 012B","E01031402","0-4 years","Male",43,42,49,41,43,218
"Arun 012B","E01031402","5-9 years","Male",54,56,50,48,54,262
"Arun 012B","E01031402","10-14 years","Male",34,39,49,56,53,231
"Arun 012B","E01031402","15-19 years","Male",44,39,29,32,40,184
"Arun 012B","E01031402","20-24 years","Male",38,39,38,32,30,177
"Arun 012B","E01031402","25-29 years","Male",41,40,42,44,47,214
"Arun 012B","E01031402","30-34 years","Male",34,32,35,38,39,178
"Arun 012B","E01031402","35-39 years","Male",44,48,52,54,53,251
"Arun 012B","E01031402","40-44 years","Male",38,42,42,37,43,202
"Arun 012B","E01031402","45-49 years","Male",66,61,54,41,41,263
"Arun 012B","E01031402","50-54 years","Male",61,57,48,60,61,287
"Arun 012B","E01031402","55-59 years","Male",64,77,80,73,65,359
"Arun 012B","E01031402","60-64 years","Male",57,47,51,57,61,273
"Arun 012B","E01031402","65-69 years","Male",54,55,47,45,44,245
"Arun 012B","E01031402","70-74 years","Male",58,59,63,67,65,312
"Arun 012B","E01031402","75-79 years","Male",54,51,43,41,49,238
"Arun 012B","E01031402","80-84 years","Male",24,33,38,35,28,158
"Arun 012B","E01031402","85+ years","Male",24,25,25,24,32,130
"Arun 012B","E01031402","0-4 years","Female",41,37,43,45,45,211
"Arun 012B","E01031402","5-9 years","Female",30,33,35,36,42,176
"Arun 012B","E01031402","10-14 years","Female",42,37,35,35,41,190
"Arun 012B","E01031402","15-19 years","Female",33,29,32,34,32,160
"Arun 012B","E01031402","20-24 years","Female",22,25,27,26,26,126
"Arun 012B","E01031402","25-29 years","Female",44,52,49,49,44,238
"Arun 012B","E01031402","30-34 years","Female",44,40,49,50,50,233
"Arun 012B","E01031402","35-39 years","Female",47,52,52,53,56,260
"Arun 012B","E01031402","40-44 years","Female",43,47,47,37,42,216
"Arun 012B","E01031402","45-49 years","Female",72,59,53,55,47,286
"Arun 012B","E01031402","50-54 years","Female",53,60,60,53,51,277
"Arun 012B","E01031402","55-59 years","Female",46,49,51,61,60,267
"Arun 012B","E01031402","60-64 years","Female",66,63,61,57,58,305
"Arun 012B","E01031402","65-69 years","Female",78,71,62,67,76,354
"Arun 012B","E01031402","70-74 years","Female",58,63,68,64,55,308
"Arun 012B","E01031402","75-79 years","Female",47,50,51,51,52,251
"Arun 012B","E01031402","80-84 years","Female",41,37,34,34,38,184
"Arun 012B","E01031402","85+ years","Female",27,31,29,30,26,143
"Arun 012C","E01031403","0-4 years","Male",42,43,40,37,34,196
"Arun 012C","E01031403","5-9 years","Male",30,30,38,37,43,178
"Arun 012C","E01031403","10-14 years","Male",31,33,36,40,43,183
"Arun 012C","E01031403","15-19 years","Male",40,36,38,29,26,169
"Arun 012C","E01031403","20-24 years","Male",41,32,33,31,28,165
"Arun 012C","E01031403","25-29 years","Male",27,32,32,36,40,167
"Arun 012C","E01031403","30-34 years","Male",41,44,46,46,45,222
"Arun 012C","E01031403","35-39 years","Male",39,36,36,38,35,184
"Arun 012C","E01031403","40-44 years","Male",46,50,50,46,46,238
"Arun 012C","E01031403","45-49 years","Male",48,53,51,48,40,240
"Arun 012C","E01031403","50-54 years","Male",67,56,56,74,74,327
"Arun 012C","E01031403","55-59 years","Male",65,67,65,61,55,313
"Arun 012C","E01031403","60-64 years","Male",33,34,42,48,52,209
"Arun 012C","E01031403","65-69 years","Male",47,36,33,32,33,181
"Arun 012C","E01031403","70-74 years","Male",36,51,49,55,58,249
"Arun 012C","E01031403","75-79 years","Male",34,28,29,27,31,149
"Arun 012C","E01031403","80-84 years","Male",12,15,16,20,24,87
"Arun 012C","E01031403","85+ years","Male",12,14,12,7,5,50
"Arun 012C","E01031403","0-4 years","Female",36,45,37,28,34,180
"Arun 012C","E01031403","5-9 years","Female",49,54,47,44,46,240
"Arun 012C","E01031403","10-14 years","Female",34,30,36,43,45,188
"Arun 012C","E01031403","15-19 years","Female",40,32,30,24,27,153
"Arun 012C","E01031403","20-24 years","Female",57,53,47,46,43,246
"Arun 012C","E01031403","25-29 years","Female",35,37,34,30,32,168
"Arun 012C","E01031403","30-34 years","Female",73,56,57,58,54,298
"Arun 012C","E01031403","35-39 years","Female",37,48,52,59,62,258
"Arun 012C","E01031403","40-44 years","Female",48,46,40,42,40,216
"Arun 012C","E01031403","45-49 years","Female",52,56,57,64,61,290
"Arun 012C","E01031403","50-54 years","Female",66,57,59,54,48,284
"Arun 012C","E01031403","55-59 years","Female",54,63,63,67,68,315
"Arun 012C","E01031403","60-64 years","Female",51,43,51,52,53,250
"Arun 012C","E01031403","65-69 years","Female",49,53,45,47,44,238
"Arun 012C","E01031403","70-74 years","Female",38,33,37,40,50,198
"Arun 012C","E01031403","75-79 years","Female",42,41,40,31,21,175
"Arun 012C","E01031403","80-84 years","Female",25,33,36,36,37,167
"Arun 012C","E01031403","85+ years","Female",25,21,23,25,26,120
"Arun 012D","E01031405","0-4 years","Male",61,47,36,40,38,222
"Arun 012D","E01031405","5-9 years","Male",34,40,42,42,39,197
"Arun 012D","E01031405","10-14 years","Male",31,27,33,31,35,157
"Arun 012D","E01031405","15-19 years","Male",27,29,27,20,27,130
"Arun 012D","E01031405","20-24 years","Male",18,14,13,23,24,92
"Arun 012D","E01031405","25-29 years","Male",36,29,22,25,23,135
"Arun 012D","E01031405","30-34 years","Male",67,61,64,55,60,307
"Arun 012D","E01031405","35-39 years","Male",53,48,52,53,43,249
"Arun 012D","E01031405","40-44 years","Male",34,36,34,31,30,165
"Arun 012D","E01031405","45-49 years","Male",44,44,40,45,43,216
"Arun 012D","E01031405","50-54 years","Male",40,43,52,46,44,225
"Arun 012D","E01031405","55-59 years","Male",49,45,47,46,49,236
"Arun 012D","E01031405","60-64 years","Male",54,59,52,64,55,284
"Arun 012D","E01031405","65-69 years","Male",48,43,38,37,43,209
"Arun 012D","E01031405","70-74 years","Male",36,42,44,49,44,215
"Arun 012D","E01031405","75-79 years","Male",32,24,26,25,31,138
"Arun 012D","E01031405","80-84 years","Male",21,25,26,21,22,115
"Arun 012D","E01031405","85+ years","Male",23,17,20,25,25,110
"Arun 012D","E01031405","0-4 years","Female",36,35,29,29,29,158
"Arun 012D","E01031405","5-9 years","Female",41,39,40,33,29,182
"Arun 012D","E01031405","10-14 years","Female",29,26,23,21,29,128
"Arun 012D","E01031405","15-19 years","Female",33,35,46,36,30,180
"Arun 012D","E01031405","20-24 years","Female",25,30,23,22,22,122
"Arun 012D","E01031405","25-29 years","Female",37,29,28,32,34,160
"Arun 012D","E01031405","30-34 years","Female",59,59,59,52,51,280
"Arun 012D","E01031405","35-39 years","Female",45,44,45,54,42,230
"Arun 012D","E01031405","40-44 years","Female",36,38,31,30,46,181
"Arun 012D","E01031405","45-49 years","Female",39,34,38,36,33,180
"Arun 012D","E01031405","50-54 years","Female",42,43,47,52,52,236
"Arun 012D","E01031405","55-59 years","Female",53,49,42,47,46,237
"Arun 012D","E01031405","60-64 years","Female",45,48,54,54,60,261
"Arun 012D","E01031405","65-69 years","Female",56,53,51,45,44,249
"Arun 012D","E01031405","70-74 years","Female",38,45,45,52,55,235
"Arun 012D","E01031405","75-79 years","Female",48,45,53,47,47,240
"Arun 012D","E01031405","80-84 years","Female",35,33,32,40,37,177
"Arun 012D","E01031405","85+ years","Female",33,32,29,31,32,157
"Arun 012E","E01031406","0-4 years","Male",44,51,41,47,46,229
"Arun 012E","E01031406","5-9 years","Male",53,52,52,43,40,240
"Arun 012E","E01031406","10-14 years","Male",54,53,56,60,61,284
"Arun 012E","E01031406","15-19 years","Male",45,40,36,41,49,211
"Arun 012E","E01031406","20-24 years","Male",51,52,53,55,40,251
"Arun 012E","E01031406","25-29 years","Male",34,42,47,41,42,206
"Arun 012E","E01031406","30-34 years","Male",56,50,46,52,50,254
"Arun 012E","E01031406","35-39 years","Male",41,43,50,48,47,229
"Arun 012E","E01031406","40-44 years","Male",48,52,44,46,51,241
"Arun 012E","E01031406","45-49 years","Male",48,40,36,36,35,195
"Arun 012E","E01031406","50-54 years","Male",45,54,54,48,43,244
"Arun 012E","E01031406","55-59 years","Male",35,33,37,43,43,191
"Arun 012E","E01031406","60-64 years","Male",35,32,28,29,28,152
"Arun 012E","E01031406","65-69 years","Male",49,45,34,36,39,203
"Arun 012E","E01031406","70-74 years","Male",13,20,26,29,34,122
"Arun 012E","E01031406","75-79 years","Male",17,19,17,13,16,82
"Arun 012E","E01031406","80-84 years","Male",18,18,21,23,22,102
"Arun 012E","E01031406","85+ years","Male",10,12,8,12,14,56
"Arun 012E","E01031406","0-4 years","Female",55,55,48,42,48,248
"Arun 012E","E01031406","5-9 years","Female",51,43,44,37,47,222
"Arun 012E","E01031406","10-14 years","Female",50,47,50,56,53,256
"Arun 012E","E01031406","15-19 years","Female",33,35,38,50,42,198
"Arun 012E","E01031406","20-24 years","Female",29,29,28,24,21,131
"Arun 012E","E01031406","25-29 years","Female",38,31,33,35,31,168
"Arun 012E","E01031406","30-34 years","Female",55,62,57,52,56,282
"Arun 012E","E01031406","35-39 years","Female",47,47,55,62,64,275
"Arun 012E","E01031406","40-44 years","Female",32,37,37,39,42,187
"Arun 012E","E01031406","45-49 years","Female",53,48,49,48,39,237
"Arun 012E","E01031406","50-54 years","Female",46,46,52,51,46,241
"Arun 012E","E01031406","55-59 years","Female",51,41,37,37,46,212
"Arun 012E","E01031406","60-64 years","Female",49,55,46,51,53,254
"Arun 012E","E01031406","65-69 years","Female",40,49,51,50,48,238
"Arun 012E","E01031406","70-74 years","Female",20,27,27,30,32,136
"Arun 012E","E01031406","75-79 years","Female",21,19,19,18,19,96
"Arun 012E","E01031406","80-84 years","Female",18,19,26,26,26,115
"Arun 012E","E01031406","85+ years","Female",21,15,17,13,15,81
"Arun 013A","E01031417","0-4 years","Male",58,58,56,48,50,270
"Arun 013A","E01031417","5-9 years","Male",74,77,65,66,57,339
"Arun 013A","E01031417","10-14 years","Male",43,37,47,56,57,240
"Arun 013A","E01031417","15-19 years","Male",53,47,43,39,43,225
"Arun 013A","E01031417","20-24 years","Male",42,50,50,54,51,247
"Arun 013A","E01031417","25-29 years","Male",30,28,30,26,30,144
"Arun 013A","E01031417","30-34 years","Male",34,41,37,36,36,184
"Arun 013A","E01031417","35-39 years","Male",51,49,50,44,41,235
"Arun 013A","E01031417","40-44 years","Male",39,31,33,42,39,184
"Arun 013A","E01031417","45-49 years","Male",50,48,48,50,49,245
"Arun 013A","E01031417","50-54 years","Male",43,47,45,41,50,226
"Arun 013A","E01031417","55-59 years","Male",41,38,43,45,50,217
"Arun 013A","E01031417","60-64 years","Male",44,47,51,55,50,247
"Arun 013A","E01031417","65-69 years","Male",55,50,49,46,43,243
"Arun 013A","E01031417","70-74 years","Male",47,47,45,50,60,249
"Arun 013A","E01031417","75-79 years","Male",33,36,36,37,34,176
"Arun 013A","E01031417","80-84 years","Male",18,18,22,20,25,103
"Arun 013A","E01031417","85+ years","Male",18,19,21,19,22,99
"Arun 013A","E01031417","0-4 years","Female",64,63,56,53,46,282
"Arun 013A","E01031417","5-9 years","Female",57,55,48,51,47,258
"Arun 013A","E01031417","10-14 years","Female",64,72,75,73,66,350
"Arun 013A","E01031417","15-19 years","Female",27,24,20,21,24,116
"Arun 013A","E01031417","20-24 years","Female",38,42,39,34,32,185
"Arun 013A","E01031417","25-29 years","Female",40,33,34,37,42,186
"Arun 013A","E01031417","30-34 years","Female",50,54,56,50,42,252
"Arun 013A","E01031417","35-39 years","Female",65,64,62,58,57,306
"Arun 013A","E01031417","40-44 years","Female",52,48,47,53,47,247
"Arun 013A","E01031417","45-49 years","Female",51,54,62,64,69,300
"Arun 013A","E01031417","50-54 years","Female",52,50,49,50,49,250
"Arun 013A","E01031417","55-59 years","Female",71,66,61,56,59,313
"Arun 013A","E01031417","60-64 years","Female",39,37,46,53,58,233
"Arun 013A","E01031417","65-69 years","Female",63,62,52,46,50,273
"Arun 013A","E01031417","70-74 years","Female",54,61,65,75,74,329
"Arun 013A","E01031417","75-79 years","Female",34,40,42,45,37,198
"Arun 013A","E01031417","80-84 years","Female",36,34,36,33,32,171
"Arun 013A","E01031417","85+ years","Female",32,36,33,30,29,160
"Arun 013B","E01031438","0-4 years","Male",35,44,38,42,44,203
"Arun 013B","E01031438","5-9 years","Male",64,45,52,44,43,248
"Arun 013B","E01031438","10-14 years","Male",40,44,47,44,47,222
"Arun 013B","E01031438","15-19 years","Male",51,48,52,51,50,252
"Arun 013B","E01031438","20-24 years","Male",35,33,28,34,23,153
"Arun 013B","E01031438","25-29 years","Male",38,42,40,40,39,199
"Arun 013B","E01031438","30-34 years","Male",42,42,42,32,35,193
"Arun 013B","E01031438","35-39 years","Male",37,38,36,40,35,186
"Arun 013B","E01031438","40-44 years","Male",45,44,34,37,33,193
"Arun 013B","E01031438","45-49 years","Male",57,52,58,47,45,259
"Arun 013B","E01031438","50-54 years","Male",54,54,55,57,51,271
"Arun 013B","E01031438","55-59 years","Male",35,32,32,39,34,172
"Arun 013B","E01031438","60-64 years","Male",51,47,51,51,58,258
"Arun 013B","E01031438","65-69 years","Male",61,47,46,37,43,234
"Arun 013B","E01031438","70-74 years","Male",39,48,56,56,52,251
"Arun 013B","E01031438","75-79 years","Male",35,32,30,38,39,174
"Arun 013B","E01031438","80-84 years","Male",23,17,23,21,23,107
"Arun 013B","E01031438","85+ years","Male",21,21,21,27,29,119
"Arun 013B","E01031438","0-4 years","Female",40,38,38,33,35,184
"Arun 013B","E01031438","5-9 years","Female",55,57,52,52,51,267
"Arun 013B","E01031438","10-14 years","Female",49,45,40,44,37,215
"Arun 013B","E01031438","15-19 years","Female",39,41,41,41,44,206
"Arun 013B","E01031438","20-24 years","Female",33,31,39,31,31,165
"Arun 013B","E01031438","25-29 years","Female",44,40,34,42,40,200
"Arun 013B","E01031438","30-34 years","Female",41,40,43,35,36,195
"Arun 013B","E01031438","35-39 years","Female",36,43,44,46,49,218
"Arun 013B","E01031438","40-44 years","Female",66,57,48,60,50,281
"Arun 013B","E01031438","45-49 years","Female",64,64,60,54,63,305
"Arun 013B","E01031438","50-54 years","Female",50,51,59,52,53,265
"Arun 013B","E01031438","55-59 years","Female",54,53,55,59,62,283
"Arun 013B","E01031438","60-64 years","Female",43,53,56,63,63,278
"Arun 013B","E01031438","65-69 years","Female",53,43,41,43,44,224
"Arun 013B","E01031438","70-74 years","Female",60,63,58,57,59,297
"Arun 013B","E01031438","75-79 years","Female",37,39,43,46,40,205
"Arun 013B","E01031438","80-84 years","Female",39,36,36,34,37,182
"Arun 013B","E01031438","85+ years","Female",36,33,39,37,39,184
"Arun 013C","E01031439","0-4 years","Male",28,22,16,13,18,97
"Arun 013C","E01031439","5-9 years","Male",33,42,47,35,46,203
"Arun 013C","E01031439","10-14 years","Male",45,41,41,45,41,213
"Arun 013C","E01031439","15-19 years","Male",31,35,33,29,34,162
"Arun 013C","E01031439","20-24 years","Male",20,19,20,20,18,97
"Arun 013C","E01031439","25-29 years","Male",23,24,21,28,29,125
"Arun 013C","E01031439","30-34 years","Male",14,19,25,25,25,108
"Arun 013C","E01031439","35-39 years","Male",21,20,16,19,18,94
"Arun 013C","E01031439","40-44 years","Male",33,29,37,35,34,168
"Arun 013C","E01031439","45-49 years","Male",54,50,42,35,35,216
"Arun 013C","E01031439","50-54 years","Male",57,57,53,61,58,286
"Arun 013C","E01031439","55-59 years","Male",70,71,82,69,61,353
"Arun 013C","E01031439","60-64 years","Male",69,76,69,74,83,371
"Arun 013C","E01031439","65-69 years","Male",110,98,102,100,93,503
"Arun 013C","E01031439","70-74 years","Male",91,102,108,104,100,505
"Arun 013C","E01031439","75-79 years","Male",73,73,81,90,98,415
"Arun 013C","E01031439","80-84 years","Male",65,66,71,67,64,333
"Arun 013C","E01031439","85+ years","Male",53,60,63,60,61,297
"Arun 013C","E01031439","0-4 years","Female",14,14,16,15,14,73
"Arun 013C","E01031439","5-9 years","Female",29,26,21,18,19,113
"Arun 013C","E01031439","10-14 years","Female",48,41,39,33,31,192
"Arun 013C","E01031439","15-19 years","Female",39,42,43,44,44,212
"Arun 013C","E01031439","20-24 years","Female",23,21,20,18,20,102
"Arun 013C","E01031439","25-29 years","Female",25,28,22,24,26,125
"Arun 013C","E01031439","30-34 years","Female",18,11,12,14,11,66
"Arun 013C","E01031439","35-39 years","Female",22,23,31,28,30,134
"Arun 013C","E01031439","40-44 years","Female",40,33,32,31,28,164
"Arun 013C","E01031439","45-49 years","Female",55,54,45,41,42,237
"Arun 013C","E01031439","50-54 years","Female",88,85,74,64,57,368
"Arun 013C","E01031439","55-59 years","Female",82,77,83,89,83,414
"Arun 013C","E01031439","60-64 years","Female",80,85,96,86,91,438
"Arun 013C","E01031439","65-69 years","Female",118,119,111,99,92,539
"Arun 013C","E01031439","70-74 years","Female",114,122,140,152,151,679
"Arun 013C","E01031439","75-79 years","Female",82,84,78,79,87,410
"Arun 013C","E01031439","80-84 years","Female",67,70,71,74,68,350
"Arun 013C","E01031439","85+ years","Female",85,84,83,87,86,425
"Arun 013D","E01031440","0-4 years","Male",12,11,8,9,9,49
"Arun 013D","E01031440","5-9 years","Male",31,30,34,25,25,145
"Arun 013D","E01031440","10-14 years","Male",17,19,21,26,26,109
"Arun 013D","E01031440","15-19 years","Male",24,18,16,17,14,89
"Arun 013D","E01031440","20-24 years","Male",21,22,16,17,16,92
"Arun 013D","E01031440","25-29 years","Male",26,28,33,30,33,150
"Arun 013D","E01031440","30-34 years","Male",17,11,16,17,22,83
"Arun 013D","E01031440","35-39 years","Male",11,13,10,9,10,53
"Arun 013D","E01031440","40-44 years","Male",21,20,19,21,18,99
"Arun 013D","E01031440","45-49 years","Male",52,43,41,32,30,198
"Arun 013D","E01031440","50-54 years","Male",52,57,52,54,51,266
"Arun 013D","E01031440","55-59 years","Male",69,68,57,54,55,303
"Arun 013D","E01031440","60-64 years","Male",88,74,87,80,79,408
"Arun 013D","E01031440","65-69 years","Male",111,113,113,105,104,546
"Arun 013D","E01031440","70-74 years","Male",60,75,82,87,87,391
"Arun 013D","E01031440","75-79 years","Male",51,48,38,44,49,230
"Arun 013D","E01031440","80-84 years","Male",42,45,51,50,52,240
"Arun 013D","E01031440","85+ years","Male",36,40,39,37,39,191
"Arun 013D","E01031440","0-4 years","Female",21,16,16,18,20,91
"Arun 013D","E01031440","5-9 years","Female",30,27,19,20,20,116
"Arun 013D","E01031440","10-14 years","Female",23,20,19,17,14,93
"Arun 013D","E01031440","15-19 years","Female",29,31,37,34,28,159
"Arun 013D","E01031440","20-24 years","Female",14,13,11,13,17,68
"Arun 013D","E01031440","25-29 years","Female",15,14,19,12,13,73
"Arun 013D","E01031440","30-34 years","Female",21,26,19,21,20,107
"Arun 013D","E01031440","35-39 years","Female",24,18,17,15,14,88
"Arun 013D","E01031440","40-44 years","Female",32,31,30,34,33,160
"Arun 013D","E01031440","45-49 years","Female",52,54,43,37,33,219
"Arun 013D","E01031440","50-54 years","Female",58,55,63,59,60,295
"Arun 013D","E01031440","55-59 years","Female",59,65,64,66,67,321
"Arun 013D","E01031440","60-64 years","Female",93,91,83,84,72,423
"Arun 013D","E01031440","65-69 years","Female",105,102,101,86,90,484
"Arun 013D","E01031440","70-74 years","Female",94,100,110,117,115,536
"Arun 013D","E01031440","75-79 years","Female",56,56,59,62,68,301
"Arun 013D","E01031440","80-84 years","Female",39,37,40,39,38,193
"Arun 013D","E01031440","85+ years","Female",50,54,55,55,52,266
"Arun 014A","E01031404","0-4 years","Male",38,37,37,34,33,179
"Arun 014A","E01031404","5-9 years","Male",56,59,55,49,40,259
"Arun 014A","E01031404","10-14 years","Male",33,37,39,36,41,186
"Arun 014A","E01031404","15-19 years","Male",58,47,50,46,41,242
"Arun 014A","E01031404","20-24 years","Male",36,35,38,48,46,203
"Arun 014A","E01031404","25-29 years","Male",39,42,43,39,26,189
"Arun 014A","E01031404","30-34 years","Male",46,50,46,44,46,232
"Arun 014A","E01031404","35-39 years","Male",41,36,30,37,44,188
"Arun 014A","E01031404","40-44 years","Male",44,43,43,40,29,199
"Arun 014A","E01031404","45-49 years","Male",38,37,33,32,36,176
"Arun 014A","E01031404","50-54 years","Male",42,43,49,45,44,223
"Arun 014A","E01031404","55-59 years","Male",30,40,44,51,45,210
"Arun 014A","E01031404","60-64 years","Male",30,30,25,33,35,153
"Arun 014A","E01031404","65-69 years","Male",25,23,30,29,23,130
"Arun 014A","E01031404","70-74 years","Male",17,20,23,14,18,92
"Arun 014A","E01031404","75-79 years","Male",12,13,10,14,12,61
"Arun 014A","E01031404","80-84 years","Male",12,14,16,14,7,63
"Arun 014A","E01031404","85+ years","Male",9,13,15,13,13,63
"Arun 014A","E01031404","0-4 years","Female",40,33,28,19,25,145
"Arun 014A","E01031404","5-9 years","Female",42,45,48,50,50,235
"Arun 014A","E01031404","10-14 years","Female",40,39,39,41,38,197
"Arun 014A","E01031404","15-19 years","Female",39,46,46,44,49,224
"Arun 014A","E01031404","20-24 years","Female",35,44,40,36,34,189
"Arun 014A","E01031404","25-29 years","Female",40,36,34,35,40,185
"Arun 014A","E01031404","30-34 years","Female",35,30,35,37,40,177
"Arun 014A","E01031404","35-39 years","Female",45,51,52,48,40,236
"Arun 014A","E01031404","40-44 years","Female",52,46,43,35,44,220
"Arun 014A","E01031404","45-49 years","Female",61,66,63,62,48,300
"Arun 014A","E01031404","50-54 years","Female",41,39,44,50,52,226
"Arun 014A","E01031404","55-59 years","Female",38,37,43,32,35,185
"Arun 014A","E01031404","60-64 years","Female",38,39,36,36,38,187
"Arun 014A","E01031404","65-69 years","Female",14,18,18,23,21,94
"Arun 014A","E01031404","70-74 years","Female",13,21,18,17,20,89
"Arun 014A","E01031404","75-79 years","Female",17,12,16,18,17,80
"Arun 014A","E01031404","80-84 years","Female",8,9,12,7,7,43
"Arun 014A","E01031404","85+ years","Female",7,5,5,6,6,29
"Arun 014B","E01031433","0-4 years","Male",25,26,27,31,26,135
"Arun 014B","E01031433","5-9 years","Male",33,30,26,23,24,136
"Arun 014B","E01031433","10-14 years","Male",37,41,47,43,34,202
"Arun 014B","E01031433","15-19 years","Male",36,27,27,30,33,153
"Arun 014B","E01031433","20-24 years","Male",57,56,50,51,47,261
"Arun 014B","E01031433","25-29 years","Male",54,56,54,53,46,263
"Arun 014B","E01031433","30-34 years","Male",41,43,35,39,40,198
"Arun 014B","E01031433","35-39 years","Male",17,15,21,24,24,101
"Arun 014B","E01031433","40-44 years","Male",27,24,22,25,24,122
"Arun 014B","E01031433","45-49 years","Male",66,51,53,38,37,245
"Arun 014B","E01031433","50-54 years","Male",55,71,66,65,64,321
"Arun 014B","E01031433","55-59 years","Male",38,42,43,47,49,219
"Arun 014B","E01031433","60-64 years","Male",49,38,41,43,41,212
"Arun 014B","E01031433","65-69 years","Male",39,40,41,40,34,194
"Arun 014B","E01031433","70-74 years","Male",32,39,42,43,44,200
"Arun 014B","E01031433","75-79 years","Male",36,34,32,38,37,177
"Arun 014B","E01031433","80-84 years","Male",22,27,28,24,32,133
"Arun 014B","E01031433","85+ years","Male",12,15,16,16,14,73
"Arun 014B","E01031433","0-4 years","Female",23,23,24,29,29,128
"Arun 014B","E01031433","5-9 years","Female",32,30,33,28,26,149
"Arun 014B","E01031433","10-14 years","Female",30,25,28,38,38,159
"Arun 014B","E01031433","15-19 years","Female",34,35,38,37,30,174
"Arun 014B","E01031433","20-24 years","Female",73,72,62,73,77,357
"Arun 014B","E01031433","25-29 years","Female",41,49,46,49,47,232
"Arun 014B","E01031433","30-34 years","Female",41,38,42,42,42,205
"Arun 014B","E01031433","35-39 years","Female",26,28,29,31,37,151
"Arun 014B","E01031433","40-44 years","Female",39,29,31,28,27,154
"Arun 014B","E01031433","45-49 years","Female",67,60,54,57,48,286
"Arun 014B","E01031433","50-54 years","Female",58,73,78,74,77,360
"Arun 014B","E01031433","55-59 years","Female",37,37,42,48,50,214
"Arun 014B","E01031433","60-64 years","Female",45,47,47,48,46,233
"Arun 014B","E01031433","65-69 years","Female",54,51,44,44,44,237
"Arun 014B","E01031433","70-74 years","Female",51,56,61,57,54,279
"Arun 014B","E01031433","75-79 years","Female",52,51,55,49,51,258
"Arun 014B","E01031433","80-84 years","Female",21,26,30,39,39,155
"Arun 014B","E01031433","85+ years","Female",28,22,19,23,25,117
"Arun 014C","E01031434","0-4 years","Male",48,42,37,43,47,217
"Arun 014C","E01031434","5-9 years","Male",41,46,48,43,36,214
"Arun 014C","E01031434","10-14 years","Male",54,54,50,48,44,250
"Arun 014C","E01031434","15-19 years","Male",42,52,50,45,62,251
"Arun 014C","E01031434","20-24 years","Male",55,57,48,56,59,275
"Arun 014C","E01031434","25-29 years","Male",70,73,75,71,81,370
"Arun 014C","E01031434","30-34 years","Male",62,67,63,65,72,329
"Arun 014C","E01031434","35-39 years","Male",86,72,68,63,50,339
"Arun 014C","E01031434","40-44 years","Male",44,53,47,55,62,261
"Arun 014C","E01031434","45-49 years","Male",76,68,67,64,60,335
"Arun 014C","E01031434","50-54 years","Male",59,58,53,54,49,273
"Arun 014C","E01031434","55-59 years","Male",39,41,53,59,69,261
"Arun 014C","E01031434","60-64 years","Male",58,61,54,41,46,260
"Arun 014C","E01031434","65-69 years","Male",35,35,37,45,45,197
"Arun 014C","E01031434","70-74 years","Male",45,45,40,40,40,210
"Arun 014C","E01031434","75-79 years","Male",9,12,15,18,18,72
"Arun 014C","E01031434","80-84 years","Male",17,17,15,11,9,69
"Arun 014C","E01031434","85+ years","Male",14,16,15,19,14,78
"Arun 014C","E01031434","0-4 years","Female",55,39,39,37,27,197
"Arun 014C","E01031434","5-9 years","Female",41,46,42,38,40,207
"Arun 014C","E01031434","10-14 years","Female",27,33,31,36,42,169
"Arun 014C","E01031434","15-19 years","Female",37,40,37,32,28,174
"Arun 014C","E01031434","20-24 years","Female",64,69,66,68,73,340
"Arun 014C","E01031434","25-29 years","Female",53,48,48,47,38,234
"Arun 014C","E01031434","30-34 years","Female",65,63,50,47,50,275
"Arun 014C","E01031434","35-39 years","Female",65,64,67,71,68,335
"Arun 014C","E01031434","40-44 years","Female",49,52,57,51,59,268
"Arun 014C","E01031434","45-49 years","Female",63,62,49,49,45,268
"Arun 014C","E01031434","50-54 years","Female",65,60,61,58,65,309
"Arun 014C","E01031434","55-59 years","Female",49,53,54,58,61,275
"Arun 014C","E01031434","60-64 years","Female",47,49,50,49,42,237
"Arun 014C","E01031434","65-69 years","Female",38,36,35,34,35,178
"Arun 014C","E01031434","70-74 years","Female",34,40,42,42,36,194
"Arun 014C","E01031434","75-79 years","Female",19,19,22,20,25,105
"Arun 014C","E01031434","80-84 years","Female",44,26,26,26,32,154
"Arun 014C","E01031434","85+ years","Female",54,55,51,58,60,278
"Arun 014D","E01031441","0-4 years","Male",55,53,53,55,54,270
"Arun 014D","E01031441","5-9 years","Male",68,60,75,78,85,366
"Arun 014D","E01031441","10-14 years","Male",28,44,41,44,40,197
"Arun 014D","E01031441","15-19 years","Male",37,33,33,32,29,164
"Arun 014D","E01031441","20-24 years","Male",64,70,66,76,63,339
"Arun 014D","E01031441","25-29 years","Male",62,50,53,41,47,253
"Arun 014D","E01031441","30-34 years","Male",57,64,61,59,51,292
"Arun 014D","E01031441","35-39 years","Male",63,67,64,64,69,327
"Arun 014D","E01031441","40-44 years","Male",46,49,54,64,72,285
"Arun 014D","E01031441","45-49 years","Male",43,43,38,42,39,205
"Arun 014D","E01031441","50-54 years","Male",59,54,55,44,49,261
"Arun 014D","E01031441","55-59 years","Male",32,38,43,52,50,215
"Arun 014D","E01031441","60-64 years","Male",46,47,53,44,43,233
"Arun 014D","E01031441","65-69 years","Male",49,50,45,54,57,255
"Arun 014D","E01031441","70-74 years","Male",35,41,37,35,41,189
"Arun 014D","E01031441","75-79 years","Male",27,24,31,25,29,136
"Arun 014D","E01031441","80-84 years","Male",21,18,21,26,21,107
"Arun 014D","E01031441","85+ years","Male",27,23,21,19,22,112
"Arun 014D","E01031441","0-4 years","Female",79,73,71,73,60,356
"Arun 014D","E01031441","5-9 years","Female",41,43,36,43,52,215
"Arun 014D","E01031441","10-14 years","Female",33,35,35,38,30,171
"Arun 014D","E01031441","15-19 years","Female",33,38,32,33,34,170
"Arun 014D","E01031441","20-24 years","Female",41,33,36,33,33,176
"Arun 014D","E01031441","25-29 years","Female",62,63,55,50,49,279
"Arun 014D","E01031441","30-34 years","Female",71,71,78,75,81,376
"Arun 014D","E01031441","35-39 years","Female",51,60,60,73,66,310
"Arun 014D","E01031441","40-44 years","Female",39,43,42,52,57,233
"Arun 014D","E01031441","45-49 years","Female",71,73,66,59,66,335
"Arun 014D","E01031441","50-54 years","Female",63,59,60,59,56,297
"Arun 014D","E01031441","55-59 years","Female",74,86,90,90,83,423
"Arun 014D","E01031441","60-64 years","Female",44,46,47,55,64,256
"Arun 014D","E01031441","65-69 years","Female",57,50,54,51,52,264
"Arun 014D","E01031441","70-74 years","Female",40,53,53,52,46,244
"Arun 014D","E01031441","75-79 years","Female",48,40,39,34,29,190
"Arun 014D","E01031441","80-84 years","Female",37,37,34,39,41,188
"Arun 014D","E01031441","85+ years","Female",33,34,25,23,21,136
"Arun 014E","E01031442","0-4 years","Male",61,57,56,54,44,272
"Arun 014E","E01031442","5-9 years","Male",93,89,87,78,72,419
"Arun 014E","E01031442","10-14 years","Male",54,60,66,79,85,344
"Arun 014E","E01031442","15-19 years","Male",49,52,55,45,50,251
"Arun 014E","E01031442","20-24 years","Male",57,52,47,55,46,257
"Arun 014E","E01031442","25-29 years","Male",66,67,66,57,44,300
"Arun 014E","E01031442","30-34 years","Male",64,61,55,60,60,300
"Arun 014E","E01031442","35-39 years","Male",66,72,79,76,80,373
"Arun 014E","E01031442","40-44 years","Male",51,54,56,59,59,279
"Arun 014E","E01031442","45-49 years","Male",70,63,53,47,44,277
"Arun 014E","E01031442","50-54 years","Male",63,73,74,71,70,351
"Arun 014E","E01031442","55-59 years","Male",41,41,49,51,52,234
"Arun 014E","E01031442","60-64 years","Male",36,34,36,38,39,183
"Arun 014E","E01031442","65-69 years","Male",31,38,34,40,43,186
"Arun 014E","E01031442","70-74 years","Male",21,23,29,28,29,130
"Arun 014E","E01031442","75-79 years","Male",24,25,26,24,22,121
"Arun 014E","E01031442","80-84 years","Male",16,18,21,21,22,98
"Arun 014E","E01031442","85+ years","Male",12,11,14,14,7,58
"Arun 014E","E01031442","0-4 years","Female",49,46,30,33,33,191
"Arun 014E","E01031442","5-9 years","Female",47,46,54,58,67,272
"Arun 014E","E01031442","10-14 years","Female",40,38,37,39,40,194
"Arun 014E","E01031442","15-19 years","Female",46,46,47,43,36,218
"Arun 014E","E01031442","20-24 years","Female",66,57,55,60,67,305
"Arun 014E","E01031442","25-29 years","Female",70,72,69,57,49,317
"Arun 014E","E01031442","30-34 years","Female",78,71,69,78,70,366
"Arun 014E","E01031442","35-39 years","Female",50,61,62,69,69,311
"Arun 014E","E01031442","40-44 years","Female",44,42,43,43,53,225
"Arun 014E","E01031442","45-49 years","Female",62,60,52,46,45,265
"Arun 014E","E01031442","50-54 years","Female",73,75,76,83,80,387
"Arun 014E","E01031442","55-59 years","Female",54,65,76,77,67,339
"Arun 014E","E01031442","60-64 years","Female",48,53,54,59,64,278
"Arun 014E","E01031442","65-69 years","Female",29,35,32,39,43,178
"Arun 014E","E01031442","70-74 years","Female",31,25,27,26,29,138
"Arun 014E","E01031442","75-79 years","Female",26,24,29,25,21,125
"Arun 014E","E01031442","80-84 years","Female",22,23,21,24,28,118
"Arun 014E","E01031442","85+ years","Female",29,36,35,37,33,170
"Arun 015A","E01031416","0-4 years","Male",18,16,12,17,14,77
"Arun 015A","E01031416","5-9 years","Male",29,29,34,34,38,164
"Arun 015A","E01031416","10-14 years","Male",34,31,31,27,24,147
"Arun 015A","E01031416","15-19 years","Male",34,32,28,24,30,148
"Arun 015A","E01031416","20-24 years","Male",33,36,37,34,25,165
"Arun 015A","E01031416","25-29 years","Male",14,17,18,15,21,85
"Arun 015A","E01031416","30-34 years","Male",15,13,8,9,11,56
"Arun 015A","E01031416","35-39 years","Male",34,37,43,39,37,190
"Arun 015A","E01031416","40-44 years","Male",22,22,21,27,26,118
"Arun 015A","E01031416","45-49 years","Male",51,45,38,29,25,188
"Arun 015A","E01031416","50-54 years","Male",61,56,56,54,54,281
"Arun 015A","E01031416","55-59 years","Male",59,60,68,77,75,339
"Arun 015A","E01031416","60-64 years","Male",65,68,61,62,55,311
"Arun 015A","E01031416","65-69 years","Male",67,68,64,60,48,307
"Arun 015A","E01031416","70-74 years","Male",76,76,78,83,86,399
"Arun 015A","E01031416","75-79 years","Male",49,54,59,57,65,284
"Arun 015A","E01031416","80-84 years","Male",31,26,28,31,28,144
"Arun 015A","E01031416","85+ years","Male",30,26,29,30,32,147
"Arun 015A","E01031416","0-4 years","Female",21,23,34,27,26,131
"Arun 015A","E01031416","5-9 years","Female",42,38,33,38,41,192
"Arun 015A","E01031416","10-14 years","Female",25,30,39,37,40,171
"Arun 015A","E01031416","15-19 years","Female",51,44,30,38,40,203
"Arun 015A","E01031416","20-24 years","Female",18,21,25,23,25,112
"Arun 015A","E01031416","25-29 years","Female",15,15,17,15,15,77
"Arun 015A","E01031416","30-34 years","Female",13,13,15,17,20,78
"Arun 015A","E01031416","35-39 years","Female",36,36,37,34,25,168
"Arun 015A","E01031416","40-44 years","Female",30,31,30,29,31,151
"Arun 015A","E01031416","45-49 years","Female",55,52,45,43,38,233
"Arun 015A","E01031416","50-54 years","Female",74,64,64,62,58,322
"Arun 015A","E01031416","55-59 years","Female",78,87,89,87,94,435
"Arun 015A","E01031416","60-64 years","Female",66,62,70,84,79,361
"Arun 015A","E01031416","65-69 years","Female",103,97,80,68,64,412
"Arun 015A","E01031416","70-74 years","Female",64,82,97,100,92,435
"Arun 015A","E01031416","75-79 years","Female",40,32,34,47,58,211
"Arun 015A","E01031416","80-84 years","Female",34,33,33,31,34,165
"Arun 015A","E01031416","85+ years","Female",38,34,35,46,41,194
"Arun 015B","E01031418","0-4 years","Male",53,49,42,44,42,230
"Arun 015B","E01031418","5-9 years","Male",64,59,58,64,62,307
"Arun 015B","E01031418","10-14 years","Male",43,53,52,60,60,268
"Arun 015B","E01031418","15-19 years","Male",57,36,39,30,28,190
"Arun 015B","E01031418","20-24 years","Male",44,47,47,50,50,238
"Arun 015B","E01031418","25-29 years","Male",22,22,24,27,29,124
"Arun 015B","E01031418","30-34 years","Male",25,19,22,22,24,112
"Arun 015B","E01031418","35-39 years","Male",38,40,34,29,30,171
"Arun 015B","E01031418","40-44 years","Male",44,34,35,46,39,198
"Arun 015B","E01031418","45-49 years","Male",71,69,61,57,56,314
"Arun 015B","E01031418","50-54 years","Male",57,64,68,70,70,329
"Arun 015B","E01031418","55-59 years","Male",75,75,78,77,82,387
"Arun 015B","E01031418","60-64 years","Male",54,53,51,54,55,267
"Arun 015B","E01031418","65-69 years","Male",77,62,71,71,73,354
"Arun 015B","E01031418","70-74 years","Male",92,106,105,98,93,494
"Arun 015B","E01031418","75-79 years","Male",73,66,72,74,83,368
"Arun 015B","E01031418","80-84 years","Male",35,37,37,42,45,196
"Arun 015B","E01031418","85+ years","Male",33,40,37,38,37,185
"Arun 015B","E01031418","0-4 years","Female",56,47,44,38,31,216
"Arun 015B","E01031418","5-9 years","Female",54,70,71,70,76,341
"Arun 015B","E01031418","10-14 years","Female",61,50,49,61,60,281
"Arun 015B","E01031418","15-19 years","Female",35,39,45,36,39,194
"Arun 015B","E01031418","20-24 years","Female",42,37,44,41,38,202
"Arun 015B","E01031418","25-29 years","Female",17,16,17,18,19,87
"Arun 015B","E01031418","30-34 years","Female",45,31,32,30,42,180
"Arun 015B","E01031418","35-39 years","Female",55,56,49,51,41,252
"Arun 015B","E01031418","40-44 years","Female",66,65,70,62,65,328
"Arun 015B","E01031418","45-49 years","Female",72,67,69,68,64,340
"Arun 015B","E01031418","50-54 years","Female",54,53,55,60,63,285
"Arun 015B","E01031418","55-59 years","Female",64,62,66,63,62,317
"Arun 015B","E01031418","60-64 years","Female",83,83,82,76,78,402
"Arun 015B","E01031418","65-69 years","Female",97,86,91,81,87,442
"Arun 015B","E01031418","70-74 years","Female",90,94,89,100,91,464
"Arun 015B","E01031418","75-79 years","Female",75,70,81,77,88,391
"Arun 015B","E01031418","80-84 years","Female",61,61,56,54,65,297
"Arun 015B","E01031418","85+ years","Female",36,37,40,43,44,200
"Arun 015C","E01031419","0-4 years","Male",29,26,23,22,22,122
"Arun 015C","E01031419","5-9 years","Male",36,29,26,24,18,133
"Arun 015C","E01031419","10-14 years","Male",35,44,36,38,37,190
"Arun 015C","E01031419","15-19 years","Male",50,44,46,38,41,219
"Arun 015C","E01031419","20-24 years","Male",34,33,33,26,24,150
"Arun 015C","E01031419","25-29 years","Male",31,27,28,30,27,143
"Arun 015C","E01031419","30-34 years","Male",16,18,16,14,15,79
"Arun 015C","E01031419","35-39 years","Male",19,18,22,21,15,95
"Arun 015C","E01031419","40-44 years","Male",40,38,30,28,30,166
"Arun 015C","E01031419","45-49 years","Male",62,64,66,67,62,321
"Arun 015C","E01031419","50-54 years","Male",44,42,44,44,48,222
"Arun 015C","E01031419","55-59 years","Male",50,55,59,57,56,277
"Arun 015C","E01031419","60-64 years","Male",56,54,48,51,54,263
"Arun 015C","E01031419","65-69 years","Male",54,53,51,50,44,252
"Arun 015C","E01031419","70-74 years","Male",63,70,75,69,56,333
"Arun 015C","E01031419","75-79 years","Male",56,52,37,56,59,260
"Arun 015C","E01031419","80-84 years","Male",33,31,36,35,32,167
"Arun 015C","E01031419","85+ years","Male",24,22,23,27,32,128
"Arun 015C","E01031419","0-4 years","Female",28,22,25,33,25,133
"Arun 015C","E01031419","5-9 years","Female",40,30,28,29,32,159
"Arun 015C","E01031419","10-14 years","Female",37,44,41,38,45,205
"Arun 015C","E01031419","15-19 years","Female",36,29,32,33,34,164
"Arun 015C","E01031419","20-24 years","Female",44,35,35,41,45,200
"Arun 015C","E01031419","25-29 years","Female",16,19,19,19,23,96
"Arun 015C","E01031419","30-34 years","Female",28,21,27,27,21,124
"Arun 015C","E01031419","35-39 years","Female",45,43,43,45,41,217
"Arun 015C","E01031419","40-44 years","Female",38,33,37,33,32,173
"Arun 015C","E01031419","45-49 years","Female",84,77,65,56,50,332
"Arun 015C","E01031419","50-54 years","Female",74,78,72,80,79,383
"Arun 015C","E01031419","55-59 years","Female",54,57,63,57,63,294
"Arun 015C","E01031419","60-64 years","Female",62,58,62,69,66,317
"Arun 015C","E01031419","65-69 years","Female",87,94,75,71,67,394
"Arun 015C","E01031419","70-74 years","Female",73,74,91,99,96,433
"Arun 015C","E01031419","75-79 years","Female",60,59,47,48,58,272
"Arun 015C","E01031419","80-84 years","Female",39,41,50,53,50,233
"Arun 015C","E01031419","85+ years","Female",72,72,74,67,63,348
"Arun 015D","E01031420","0-4 years","Male",25,20,15,15,11,86
"Arun 015D","E01031420","5-9 years","Male",31,31,34,35,24,155
"Arun 015D","E01031420","10-14 years","Male",47,40,36,31,32,186
"Arun 015D","E01031420","15-19 years","Male",39,36,42,45,41,203
"Arun 015D","E01031420","20-24 years","Male",30,40,33,36,34,173
"Arun 015D","E01031420","25-29 years","Male",17,11,11,13,16,68
"Arun 015D","E01031420","30-34 years","Male",16,19,18,15,18,86
"Arun 015D","E01031420","35-39 years","Male",29,27,22,21,18,117
"Arun 015D","E01031420","40-44 years","Male",26,23,29,26,30,134
"Arun 015D","E01031420","45-49 years","Male",41,40,40,35,32,188
"Arun 015D","E01031420","50-54 years","Male",47,50,52,56,48,253
"Arun 015D","E01031420","55-59 years","Male",52,60,63,66,73,314
"Arun 015D","E01031420","60-64 years","Male",42,39,37,44,46,208
"Arun 015D","E01031420","65-69 years","Male",62,63,64,52,47,288
"Arun 015D","E01031420","70-74 years","Male",65,57,67,68,67,324
"Arun 015D","E01031420","75-79 years","Male",45,52,43,54,63,257
"Arun 015D","E01031420","80-84 years","Male",48,47,46,44,46,231
"Arun 015D","E01031420","85+ years","Male",42,41,47,49,55,234
"Arun 015D","E01031420","0-4 years","Female",28,30,32,27,27,144
"Arun 015D","E01031420","5-9 years","Female",39,40,44,46,45,214
"Arun 015D","E01031420","10-14 years","Female",36,35,41,39,36,187
"Arun 015D","E01031420","15-19 years","Female",39,42,50,46,53,230
"Arun 015D","E01031420","20-24 years","Female",21,24,20,22,22,109
"Arun 015D","E01031420","25-29 years","Female",22,25,31,38,34,150
"Arun 015D","E01031420","30-34 years","Female",18,17,15,13,15,78
"Arun 015D","E01031420","35-39 years","Female",22,26,29,24,22,123
"Arun 015D","E01031420","40-44 years","Female",43,43,44,36,35,201
"Arun 015D","E01031420","45-49 years","Female",60,54,49,45,53,261
"Arun 015D","E01031420","50-54 years","Female",64,67,63,75,67,336
"Arun 015D","E01031420","55-59 years","Female",49,57,61,61,65,293
"Arun 015D","E01031420","60-64 years","Female",64,59,59,53,52,287
"Arun 015D","E01031420","65-69 years","Female",85,80,71,75,64,375
"Arun 015D","E01031420","70-74 years","Female",80,95,103,103,104,485
"Arun 015D","E01031420","75-79 years","Female",78,72,77,81,86,394
"Arun 015D","E01031420","80-84 years","Female",57,60,65,72,75,329
"Arun 015D","E01031420","85+ years","Female",54,62,63,67,67,313
"Arun 015E","E01031421","0-4 years","Male",150,156,146,153,132,737
"Arun 015E","E01031421","5-9 years","Male",112,122,133,144,153,664
"Arun 015E","E01031421","10-14 years","Male",105,106,115,131,131,588
"Arun 015E","E01031421","15-19 years","Male",74,79,75,87,97,412
"Arun 015E","E01031421","20-24 years","Male",42,55,59,51,52,259
"Arun 015E","E01031421","25-29 years","Male",56,53,54,60,68,291
"Arun 015E","E01031421","30-34 years","Male",77,93,94,101,93,458
"Arun 015E","E01031421","35-39 years","Male",61,67,78,94,88,388
"Arun 015E","E01031421","40-44 years","Male",65,65,74,81,87,372
"Arun 015E","E01031421","45-49 years","Male",91,104,95,94,92,476
"Arun 015E","E01031421","50-54 years","Male",71,85,94,105,98,453
"Arun 015E","E01031421","55-59 years","Male",53,53,57,60,77,300
"Arun 015E","E01031421","60-64 years","Male",55,66,74,73,67,335
"Arun 015E","E01031421","65-69 years","Male",82,74,70,70,74,370
"Arun 015E","E01031421","70-74 years","Male",80,94,96,101,99,470
"Arun 015E","E01031421","75-79 years","Male",46,46,53,51,53,249
"Arun 015E","E01031421","80-84 years","Male",26,29,34,38,44,171
"Arun 015E","E01031421","85+ years","Male",37,38,39,38,39,191
"Arun 015E","E01031421","0-4 years","Female",108,116,112,117,104,557
"Arun 015E","E01031421","5-9 years","Female",119,127,143,162,164,715
"Arun 015E","E01031421","10-14 years","Female",83,100,111,113,144,551
"Arun 015E","E01031421","15-19 years","Female",75,70,71,87,90,393
"Arun 015E","E01031421","20-24 years","Female",59,72,71,75,67,344
"Arun 015E","E01031421","25-29 years","Female",107,110,111,107,104,539
"Arun 015E","E01031421","30-34 years","Female",88,89,98,112,112,499
"Arun 015E","E01031421","35-39 years","Female",83,100,111,119,113,526
"Arun 015E","E01031421","40-44 years","Female",74,85,80,96,112,447
"Arun 015E","E01031421","45-49 years","Female",94,101,117,113,102,527
"Arun 015E","E01031421","50-54 years","Female",79,87,92,98,96,452
"Arun 015E","E01031421","55-59 years","Female",74,89,85,94,112,454
"Arun 015E","E01031421","60-64 years","Female",66,55,72,59,62,314
"Arun 015E","E01031421","65-69 years","Female",108,103,87,88,84,470
"Arun 015E","E01031421","70-74 years","Female",80,102,101,104,105,492
"Arun 015E","E01031421","75-79 years","Female",54,57,64,68,71,314
"Arun 015E","E01031421","80-84 years","Female",42,43,51,46,44,226
"Arun 015E","E01031421","85+ years","Female",72,65,65,66,68,336
"Arun 016A","E01031443","0-4 years","Male",38,36,42,42,30,188
"Arun 016A","E01031443","5-9 years","Male",26,30,39,35,37,167
"Arun 016A","E01031443","10-14 years","Male",49,48,41,51,53,242
"Arun 016A","E01031443","15-19 years","Male",56,52,52,48,44,252
"Arun 016A","E01031443","20-24 years","Male",44,52,52,50,44,242
"Arun 016A","E01031443","25-29 years","Male",34,30,31,37,38,170
"Arun 016A","E01031443","30-34 years","Male",37,41,46,48,49,221
"Arun 016A","E01031443","35-39 years","Male",45,43,44,49,52,233
"Arun 016A","E01031443","40-44 years","Male",31,28,36,37,36,168
"Arun 016A","E01031443","45-49 years","Male",51,48,43,37,29,208
"Arun 016A","E01031443","50-54 years","Male",53,56,59,66,81,315
"Arun 016A","E01031443","55-59 years","Male",44,48,52,45,41,230
"Arun 016A","E01031443","60-64 years","Male",34,34,34,33,34,169
"Arun 016A","E01031443","65-69 years","Male",41,37,37,38,30,183
"Arun 016A","E01031443","70-74 years","Male",23,24,23,19,26,115
"Arun 016A","E01031443","75-79 years","Male",8,11,9,14,15,57
"Arun 016A","E01031443","80-84 years","Male",14,10,10,13,8,55
"Arun 016A","E01031443","85+ years","Male",7,7,6,6,4,30
"Arun 016A","E01031443","0-4 years","Female",52,48,50,45,41,236
"Arun 016A","E01031443","5-9 years","Female",39,38,50,46,45,218
"Arun 016A","E01031443","10-14 years","Female",46,43,48,49,56,242
"Arun 016A","E01031443","15-19 years","Female",37,43,40,43,39,202
"Arun 016A","E01031443","20-24 years","Female",37,40,38,37,35,187
"Arun 016A","E01031443","25-29 years","Female",36,34,34,34,32,170
"Arun 016A","E01031443","30-34 years","Female",35,36,40,39,45,195
"Arun 016A","E01031443","35-39 years","Female",45,50,59,54,50,258
"Arun 016A","E01031443","40-44 years","Female",48,46,45,47,54,240
"Arun 016A","E01031443","45-49 years","Female",60,60,55,52,46,273
"Arun 016A","E01031443","50-54 years","Female",73,65,65,66,59,328
"Arun 016A","E01031443","55-59 years","Female",36,43,45,46,52,222
"Arun 016A","E01031443","60-64 years","Female",40,37,40,39,44,200
"Arun 016A","E01031443","65-69 years","Female",40,45,49,54,45,233
"Arun 016A","E01031443","70-74 years","Female",32,32,37,39,42,182
"Arun 016A","E01031443","75-79 years","Female",23,16,14,18,23,94
"Arun 016A","E01031443","80-84 years","Female",11,18,19,18,21,87
"Arun 016A","E01031443","85+ years","Female",8,8,5,5,5,31
"Arun 016B","E01031444","0-4 years","Male",62,58,61,79,64,324
"Arun 016B","E01031444","5-9 years","Male",69,69,65,61,66,330
"Arun 016B","E01031444","10-14 years","Male",42,47,48,45,47,229
"Arun 016B","E01031444","15-19 years","Male",40,42,44,45,43,214
"Arun 016B","E01031444","20-24 years","Male",59,71,72,71,56,329
"Arun 016B","E01031444","25-29 years","Male",56,64,71,72,79,342
"Arun 016B","E01031444","30-34 years","Male",87,85,85,74,72,403
"Arun 016B","E01031444","35-39 years","Male",61,68,70,93,88,380
"Arun 016B","E01031444","40-44 years","Male",60,52,53,54,61,280
"Arun 016B","E01031444","45-49 years","Male",67,64,63,56,54,304
"Arun 016B","E01031444","50-54 years","Male",49,51,51,54,59,264
"Arun 016B","E01031444","55-59 years","Male",50,60,70,73,77,330
"Arun 016B","E01031444","60-64 years","Male",27,29,33,37,41,167
"Arun 016B","E01031444","65-69 years","Male",31,31,29,27,28,146
"Arun 016B","E01031444","70-74 years","Male",29,31,38,30,31,159
"Arun 016B","E01031444","75-79 years","Male",20,23,19,22,20,104
"Arun 016B","E01031444","80-84 years","Male",11,13,13,9,8,54
"Arun 016B","E01031444","85+ years","Male",12,12,6,7,5,42
"Arun 016B","E01031444","0-4 years","Female",62,52,52,48,51,265
"Arun 016B","E01031444","5-9 years","Female",47,43,44,41,37,212
"Arun 016B","E01031444","10-14 years","Female",38,39,34,42,39,192
"Arun 016B","E01031444","15-19 years","Female",55,46,49,49,44,243
"Arun 016B","E01031444","20-24 years","Female",99,85,86,79,83,432
"Arun 016B","E01031444","25-29 years","Female",66,81,80,76,74,377
"Arun 016B","E01031444","30-34 years","Female",56,51,63,68,68,306
"Arun 016B","E01031444","35-39 years","Female",71,69,62,55,46,303
"Arun 016B","E01031444","40-44 years","Female",47,43,57,54,53,254
"Arun 016B","E01031444","45-49 years","Female",75,69,69,76,78,367
"Arun 016B","E01031444","50-54 years","Female",77,84,92,95,83,431
"Arun 016B","E01031444","55-59 years","Female",50,48,50,47,60,255
"Arun 016B","E01031444","60-64 years","Female",46,40,43,50,53,232
"Arun 016B","E01031444","65-69 years","Female",24,26,26,27,29,132
"Arun 016B","E01031444","70-74 years","Female",23,22,26,30,30,131
"Arun 016B","E01031444","75-79 years","Female",19,22,26,27,20,114
"Arun 016B","E01031444","80-84 years","Female",6,9,6,5,4,30
"Arun 016B","E01031444","85+ years","Female",14,13,10,12,11,60
"Arun 016C","E01031450","0-4 years","Male",45,56,51,45,41,238
"Arun 016C","E01031450","5-9 years","Male",52,50,51,45,47,245
"Arun 016C","E01031450","10-14 years","Male",44,50,60,65,64,283
"Arun 016C","E01031450","15-19 years","Male",60,48,42,35,41,226
"Arun 016C","E01031450","20-24 years","Male",31,40,37,41,40,189
"Arun 016C","E01031450","25-29 years","Male",48,52,57,56,60,273
"Arun 016C","E01031450","30-34 years","Male",46,47,45,45,47,230
"Arun 016C","E01031450","35-39 years","Male",48,48,43,37,41,217
"Arun 016C","E01031450","40-44 years","Male",50,49,44,42,53,238
"Arun 016C","E01031450","45-49 years","Male",53,57,61,59,52,282
"Arun 016C","E01031450","50-54 years","Male",57,55,51,60,59,282
"Arun 016C","E01031450","55-59 years","Male",27,29,31,33,38,158
"Arun 016C","E01031450","60-64 years","Male",29,37,32,34,37,169
"Arun 016C","E01031450","65-69 years","Male",30,27,34,21,25,137
"Arun 016C","E01031450","70-74 years","Male",17,22,21,34,39,133
"Arun 016C","E01031450","75-79 years","Male",14,15,17,15,12,73
"Arun 016C","E01031450","80-84 years","Male",4,5,8,11,11,39
"Arun 016C","E01031450","85+ years","Male",10,7,8,7,5,37
"Arun 016C","E01031450","0-4 years","Female",58,60,38,36,41,233
"Arun 016C","E01031450","5-9 years","Female",51,50,61,59,53,274
"Arun 016C","E01031450","10-14 years","Female",43,45,45,49,55,237
"Arun 016C","E01031450","15-19 years","Female",47,43,46,45,38,219
"Arun 016C","E01031450","20-24 years","Female",50,56,46,53,50,255
"Arun 016C","E01031450","25-29 years","Female",76,59,55,66,78,334
"Arun 016C","E01031450","30-34 years","Female",51,59,56,56,52,274
"Arun 016C","E01031450","35-39 years","Female",47,42,47,48,52,236
"Arun 016C","E01031450","40-44 years","Female",51,55,48,43,41,238
"Arun 016C","E01031450","45-49 years","Female",49,49,51,52,57,258
"Arun 016C","E01031450","50-54 years","Female",66,67,65,67,64,329
"Arun 016C","E01031450","55-59 years","Female",44,50,46,53,58,251
"Arun 016C","E01031450","60-64 years","Female",28,34,40,40,41,183
"Arun 016C","E01031450","65-69 years","Female",17,19,22,24,25,107
"Arun 016C","E01031450","70-74 years","Female",21,22,24,26,22,115
"Arun 016C","E01031450","75-79 years","Female",22,22,19,17,23,103
"Arun 016C","E01031450","80-84 years","Female",11,12,16,15,15,69
"Arun 016C","E01031450","85+ years","Female",15,19,19,22,23,98
"Arun 016D","E01031451","0-4 years","Male",83,83,73,75,70,384
"Arun 016D","E01031451","5-9 years","Male",54,55,77,89,79,354
"Arun 016D","E01031451","10-14 years","Male",59,55,50,58,54,276
"Arun 016D","E01031451","15-19 years","Male",35,29,28,38,40,170
"Arun 016D","E01031451","20-24 years","Male",51,57,50,51,44,253
"Arun 016D","E01031451","25-29 years","Male",44,44,48,43,46,225
"Arun 016D","E01031451","30-34 years","Male",51,53,54,56,45,259
"Arun 016D","E01031451","35-39 years","Male",57,52,46,49,48,252
"Arun 016D","E01031451","40-44 years","Male",52,59,54,54,54,273
"Arun 016D","E01031451","45-49 years","Male",47,48,50,47,48,240
"Arun 016D","E01031451","50-54 years","Male",57,62,68,73,63,323
"Arun 016D","E01031451","55-59 years","Male",49,44,43,45,56,237
"Arun 016D","E01031451","60-64 years","Male",33,40,49,54,45,221
"Arun 016D","E01031451","65-69 years","Male",36,31,24,21,22,134
"Arun 016D","E01031451","70-74 years","Male",34,37,35,39,39,184
"Arun 016D","E01031451","75-79 years","Male",28,27,30,26,29,140
"Arun 016D","E01031451","80-84 years","Male",17,18,17,11,13,76
"Arun 016D","E01031451","85+ years","Male",12,10,10,10,8,50
"Arun 016D","E01031451","0-4 years","Female",70,72,71,84,74,371
"Arun 016D","E01031451","5-9 years","Female",89,99,104,99,105,496
"Arun 016D","E01031451","10-14 years","Female",29,36,50,55,66,236
"Arun 016D","E01031451","15-19 years","Female",40,32,31,31,35,169
"Arun 016D","E01031451","20-24 years","Female",44,48,46,36,35,209
"Arun 016D","E01031451","25-29 years","Female",73,71,63,60,55,322
"Arun 016D","E01031451","30-34 years","Female",73,76,80,87,89,405
"Arun 016D","E01031451","35-39 years","Female",51,57,62,60,59,289
"Arun 016D","E01031451","40-44 years","Female",67,52,52,56,57,284
"Arun 016D","E01031451","45-49 years","Female",54,56,58,62,61,291
"Arun 016D","E01031451","50-54 years","Female",58,57,54,51,50,270
"Arun 016D","E01031451","55-59 years","Female",46,44,50,48,46,234
"Arun 016D","E01031451","60-64 years","Female",33,39,39,44,50,205
"Arun 016D","E01031451","65-69 years","Female",41,48,40,32,34,195
"Arun 016D","E01031451","70-74 years","Female",42,39,44,51,46,222
"Arun 016D","E01031451","75-79 years","Female",30,33,34,28,37,162
"Arun 016D","E01031451","80-84 years","Female",30,34,29,34,30,157
"Arun 016D","E01031451","85+ years","Female",30,29,24,22,21,126
"Arun 016E","E01031452","0-4 years","Male",38,38,33,34,31,174
"Arun 016E","E01031452","5-9 years","Male",44,51,48,44,36,223
"Arun 016E","E01031452","10-14 years","Male",52,50,52,48,50,252
"Arun 016E","E01031452","15-19 years","Male",36,39,36,34,34,179
"Arun 016E","E01031452","20-24 years","Male",34,32,33,34,33,166
"Arun 016E","E01031452","25-29 years","Male",35,36,40,49,47,207
"Arun 016E","E01031452","30-34 years","Male",70,90,85,74,79,398
"Arun 016E","E01031452","35-39 years","Male",41,36,39,37,35,188
"Arun 016E","E01031452","40-44 years","Male",50,47,40,36,37,210
"Arun 016E","E01031452","45-49 years","Male",55,54,54,51,53,267
"Arun 016E","E01031452","50-54 years","Male",72,82,77,73,65,369
"Arun 016E","E01031452","55-59 years","Male",49,53,53,59,61,275
"Arun 016E","E01031452","60-64 years","Male",34,30,36,37,37,174
"Arun 016E","E01031452","65-69 years","Male",43,40,40,32,31,186
"Arun 016E","E01031452","70-74 years","Male",39,44,46,45,41,215
"Arun 016E","E01031452","75-79 years","Male",30,40,34,40,43,187
"Arun 016E","E01031452","80-84 years","Male",17,14,18,17,19,85
"Arun 016E","E01031452","85+ years","Male",26,28,22,32,32,140
"Arun 016E","E01031452","0-4 years","Female",30,35,34,25,24,148
"Arun 016E","E01031452","5-9 years","Female",42,29,31,41,40,183
"Arun 016E","E01031452","10-14 years","Female",47,55,49,48,58,257
"Arun 016E","E01031452","15-19 years","Female",38,38,47,44,33,200
"Arun 016E","E01031452","20-24 years","Female",54,53,59,56,47,269
"Arun 016E","E01031452","25-29 years","Female",28,33,31,32,41,165
"Arun 016E","E01031452","30-34 years","Female",52,54,57,49,52,264
"Arun 016E","E01031452","35-39 years","Female",44,41,35,46,47,213
"Arun 016E","E01031452","40-44 years","Female",41,48,46,40,34,209
"Arun 016E","E01031452","45-49 years","Female",68,58,63,60,56,305
"Arun 016E","E01031452","50-54 years","Female",66,77,71,72,70,356
"Arun 016E","E01031452","55-59 years","Female",58,55,56,56,62,287
"Arun 016E","E01031452","60-64 years","Female",43,46,45,50,46,230
"Arun 016E","E01031452","65-69 years","Female",38,34,36,34,33,175
"Arun 016E","E01031452","70-74 years","Female",42,47,43,33,42,207
"Arun 016E","E01031452","75-79 years","Female",29,28,26,32,30,145
"Arun 016E","E01031452","80-84 years","Female",24,28,30,36,35,153
"Arun 016E","E01031452","85+ years","Female",123,111,120,127,118,599
"Arun 017A","E01031431","0-4 years","Male",17,23,25,23,19,107
"Arun 017A","E01031431","5-9 years","Male",14,13,21,25,19,92
"Arun 017A","E01031431","10-14 years","Male",8,8,9,10,19,54
"Arun 017A","E01031431","15-19 years","Male",67,49,48,47,47,258
"Arun 017A","E01031431","20-24 years","Male",192,179,170,134,127,802
"Arun 017A","E01031431","25-29 years","Male",107,116,115,117,111,566
"Arun 017A","E01031431","30-34 years","Male",75,73,76,84,76,384
"Arun 017A","E01031431","35-39 years","Male",54,47,47,40,45,233
"Arun 017A","E01031431","40-44 years","Male",38,37,46,44,57,222
"Arun 017A","E01031431","45-49 years","Male",45,33,35,39,32,184
"Arun 017A","E01031431","50-54 years","Male",40,51,48,50,53,242
"Arun 017A","E01031431","55-59 years","Male",26,36,26,29,31,148
"Arun 017A","E01031431","60-64 years","Male",30,21,25,18,21,115
"Arun 017A","E01031431","65-69 years","Male",31,38,32,30,29,160
"Arun 017A","E01031431","70-74 years","Male",32,38,39,43,33,185
"Arun 017A","E01031431","75-79 years","Male",26,25,27,29,33,140
"Arun 017A","E01031431","80-84 years","Male",16,17,19,16,17,85
"Arun 017A","E01031431","85+ years","Male",12,15,14,16,13,70
"Arun 017A","E01031431","0-4 years","Female",19,19,18,17,11,84
"Arun 017A","E01031431","5-9 years","Female",16,14,12,9,8,59
"Arun 017A","E01031431","10-14 years","Female",22,22,31,34,43,152
"Arun 017A","E01031431","15-19 years","Female",88,99,77,71,68,403
"Arun 017A","E01031431","20-24 years","Female",158,145,138,125,108,674
"Arun 017A","E01031431","25-29 years","Female",85,80,62,48,52,327
"Arun 017A","E01031431","30-34 years","Female",53,47,38,36,38,212
"Arun 017A","E01031431","35-39 years","Female",29,24,26,32,28,139
"Arun 017A","E01031431","40-44 years","Female",27,23,24,21,24,119
"Arun 017A","E01031431","45-49 years","Female",25,24,22,17,17,105
"Arun 017A","E01031431","50-54 years","Female",29,26,31,29,22,137
"Arun 017A","E01031431","55-59 years","Female",33,36,37,33,31,170
"Arun 017A","E01031431","60-64 years","Female",45,46,42,50,45,228
"Arun 017A","E01031431","65-69 years","Female",59,47,52,47,47,252
"Arun 017A","E01031431","70-74 years","Female",42,48,50,49,43,232
"Arun 017A","E01031431","75-79 years","Female",40,39,41,41,37,198
"Arun 017A","E01031431","80-84 years","Female",29,36,37,36,37,175
"Arun 017A","E01031431","85+ years","Female",57,43,43,43,41,227
"Arun 017B","E01031432","0-4 years","Male",84,98,91,82,69,424
"Arun 017B","E01031432","5-9 years","Male",43,48,47,54,53,245
"Arun 017B","E01031432","10-14 years","Male",29,32,31,30,32,154
"Arun 017B","E01031432","15-19 years","Male",48,48,51,50,49,246
"Arun 017B","E01031432","20-24 years","Male",106,92,85,91,73,447
"Arun 017B","E01031432","25-29 years","Male",126,146,153,151,153,729
"Arun 017B","E01031432","30-34 years","Male",96,93,84,89,101,463
"Arun 017B","E01031432","35-39 years","Male",85,84,111,110,107,497
"Arun 017B","E01031432","40-44 years","Male",73,80,77,83,91,404
"Arun 017B","E01031432","45-49 years","Male",67,72,72,74,77,362
"Arun 017B","E01031432","50-54 years","Male",79,81,88,84,78,410
"Arun 017B","E01031432","55-59 years","Male",63,67,73,80,101,384
"Arun 017B","E01031432","60-64 years","Male",57,49,45,56,55,262
"Arun 017B","E01031432","65-69 years","Male",38,38,38,36,41,191
"Arun 017B","E01031432","70-74 years","Male",42,36,43,33,29,183
"Arun 017B","E01031432","75-79 years","Male",28,34,32,37,37,168
"Arun 017B","E01031432","80-84 years","Male",25,23,27,25,26,126
"Arun 017B","E01031432","85+ years","Male",17,18,19,18,19,91
"Arun 017B","E01031432","0-4 years","Female",54,48,61,52,43,258
"Arun 017B","E01031432","5-9 years","Female",37,43,42,43,48,213
"Arun 017B","E01031432","10-14 years","Female",30,31,29,35,25,150
"Arun 017B","E01031432","15-19 years","Female",25,32,32,35,44,168
"Arun 017B","E01031432","20-24 years","Female",98,85,66,72,81,402
"Arun 017B","E01031432","25-29 years","Female",147,133,129,120,102,631
"Arun 017B","E01031432","30-34 years","Female",92,103,102,113,126,536
"Arun 017B","E01031432","35-39 years","Female",68,76,76,71,68,359
"Arun 017B","E01031432","40-44 years","Female",70,73,85,80,86,394
"Arun 017B","E01031432","45-49 years","Female",62,61,73,81,83,360
"Arun 017B","E01031432","50-54 years","Female",90,74,71,72,63,370
"Arun 017B","E01031432","55-59 years","Female",55,55,59,66,74,309
"Arun 017B","E01031432","60-64 years","Female",50,66,58,53,59,286
"Arun 017B","E01031432","65-69 years","Female",49,46,39,35,47,216
"Arun 017B","E01031432","70-74 years","Female",43,44,52,54,54,247
"Arun 017B","E01031432","75-79 years","Female",25,27,30,24,24,130
"Arun 017B","E01031432","80-84 years","Female",33,30,35,36,32,166
"Arun 017B","E01031432","85+ years","Female",43,51,46,48,47,235
"Arun 017C","E01031435","0-4 years","Male",42,35,41,42,47,207
"Arun 017C","E01031435","5-9 years","Male",40,42,49,49,36,216
"Arun 017C","E01031435","10-14 years","Male",38,40,47,37,45,207
"Arun 017C","E01031435","15-19 years","Male",29,24,27,34,37,151
"Arun 017C","E01031435","20-24 years","Male",63,59,53,40,48,263
"Arun 017C","E01031435","25-29 years","Male",63,70,79,94,85,391
"Arun 017C","E01031435","30-34 years","Male",48,54,46,47,50,245
"Arun 017C","E01031435","35-39 years","Male",64,70,72,58,55,319
"Arun 017C","E01031435","40-44 years","Male",60,64,64,64,60,312
"Arun 017C","E01031435","45-49 years","Male",70,67,66,71,67,341
"Arun 017C","E01031435","50-54 years","Male",57,65,75,67,76,340
"Arun 017C","E01031435","55-59 years","Male",46,43,48,60,58,255
"Arun 017C","E01031435","60-64 years","Male",57,63,63,67,66,316
"Arun 017C","E01031435","65-69 years","Male",51,52,48,58,59,268
"Arun 017C","E01031435","70-74 years","Male",57,64,64,61,64,310
"Arun 017C","E01031435","75-79 years","Male",42,37,37,44,52,212
"Arun 017C","E01031435","80-84 years","Male",20,23,24,25,23,115
"Arun 017C","E01031435","85+ years","Male",23,25,26,20,21,115
"Arun 017C","E01031435","0-4 years","Female",30,25,26,32,24,137
"Arun 017C","E01031435","5-9 years","Female",59,63,65,65,52,304
"Arun 017C","E01031435","10-14 years","Female",34,25,34,44,57,194
"Arun 017C","E01031435","15-19 years","Female",30,33,33,30,32,158
"Arun 017C","E01031435","20-24 years","Female",50,41,45,42,34,212
"Arun 017C","E01031435","25-29 years","Female",82,85,74,68,76,385
"Arun 017C","E01031435","30-34 years","Female",64,63,68,71,62,328
"Arun 017C","E01031435","35-39 years","Female",56,57,48,55,48,264
"Arun 017C","E01031435","40-44 years","Female",59,58,61,55,51,284
"Arun 017C","E01031435","45-49 years","Female",49,53,54,51,59,266
"Arun 017C","E01031435","50-54 years","Female",60,51,50,59,53,273
"Arun 017C","E01031435","55-59 years","Female",47,57,59,53,66,282
"Arun 017C","E01031435","60-64 years","Female",42,43,51,56,51,243
"Arun 017C","E01031435","65-69 years","Female",58,61,53,43,38,253
"Arun 017C","E01031435","70-74 years","Female",61,55,59,61,64,300
"Arun 017C","E01031435","75-79 years","Female",35,42,45,43,46,211
"Arun 017C","E01031435","80-84 years","Female",31,32,32,24,22,141
"Arun 017C","E01031435","85+ years","Female",48,42,43,40,39,212
"Arun 017D","E01031436","0-4 years","Male",79,76,64,67,59,345
"Arun 017D","E01031436","5-9 years","Male",45,52,57,52,53,259
"Arun 017D","E01031436","10-14 years","Male",15,18,22,21,26,102
"Arun 017D","E01031436","15-19 years","Male",37,31,34,44,38,184
"Arun 017D","E01031436","20-24 years","Male",80,77,72,60,68,357
"Arun 017D","E01031436","25-29 years","Male",128,123,129,125,125,630
"Arun 017D","E01031436","30-34 years","Male",81,82,90,93,97,443
"Arun 017D","E01031436","35-39 years","Male",87,93,105,94,106,485
"Arun 017D","E01031436","40-44 years","Male",49,56,57,71,69,302
"Arun 017D","E01031436","45-49 years","Male",87,81,84,77,67,396
"Arun 017D","E01031436","50-54 years","Male",63,72,68,88,96,387
"Arun 017D","E01031436","55-59 years","Male",67,63,74,74,61,339
"Arun 017D","E01031436","60-64 years","Male",48,50,44,49,66,257
"Arun 017D","E01031436","65-69 years","Male",48,47,63,57,51,266
"Arun 017D","E01031436","70-74 years","Male",27,31,30,34,30,152
"Arun 017D","E01031436","75-79 years","Male",26,24,21,21,27,119
"Arun 017D","E01031436","80-84 years","Male",13,15,21,18,21,88
"Arun 017D","E01031436","85+ years","Male",19,15,16,19,19,88
"Arun 017D","E01031436","0-4 years","Female",84,63,71,67,81,366
"Arun 017D","E01031436","5-9 years","Female",51,62,66,57,57,293
"Arun 017D","E01031436","10-14 years","Female",19,23,23,32,33,130
"Arun 017D","E01031436","15-19 years","Female",27,27,15,18,22,109
"Arun 017D","E01031436","20-24 years","Female",97,95,93,78,71,434
"Arun 017D","E01031436","25-29 years","Female",118,113,104,102,91,528
"Arun 017D","E01031436","30-34 years","Female",70,68,78,79,91,386
"Arun 017D","E01031436","35-39 years","Female",77,74,83,86,77,397
"Arun 017D","E01031436","40-44 years","Female",57,61,59,55,67,299
"Arun 017D","E01031436","45-49 years","Female",67,64,58,62,61,312
"Arun 017D","E01031436","50-54 years","Female",95,113,115,109,114,546
"Arun 017D","E01031436","55-59 years","Female",63,72,73,65,76,349
"Arun 017D","E01031436","60-64 years","Female",37,39,33,43,44,196
"Arun 017D","E01031436","65-69 years","Female",47,41,45,42,34,209
"Arun 017D","E01031436","70-74 years","Female",39,43,49,54,54,239
"Arun 017D","E01031436","75-79 years","Female",42,49,45,39,37,212
"Arun 017D","E01031436","80-84 years","Female",34,29,27,25,32,147
"Arun 017D","E01031436","85+ years","Female",41,40,38,36,34,189
"Arun 017E","E01031437","0-4 years","Male",61,55,56,61,58,291
"Arun 017E","E01031437","5-9 years","Male",41,45,49,46,40,221
"Arun 017E","E01031437","10-14 years","Male",22,27,33,41,50,173
"Arun 017E","E01031437","15-19 years","Male",49,43,37,36,25,190
"Arun 017E","E01031437","20-24 years","Male",70,87,70,77,77,381
"Arun 017E","E01031437","25-29 years","Male",110,92,105,98,72,477
"Arun 017E","E01031437","30-34 years","Male",86,82,79,74,85,406
"Arun 017E","E01031437","35-39 years","Male",90,96,107,110,94,497
"Arun 017E","E01031437","40-44 years","Male",79,85,85,95,91,435
"Arun 017E","E01031437","45-49 years","Male",73,59,66,56,62,316
"Arun 017E","E01031437","50-54 years","Male",83,91,93,86,85,438
"Arun 017E","E01031437","55-59 years","Male",57,50,52,59,55,273
"Arun 017E","E01031437","60-64 years","Male",81,81,74,64,69,369
"Arun 017E","E01031437","65-69 years","Male",63,59,65,67,69,323
"Arun 017E","E01031437","70-74 years","Male",49,41,53,64,69,276
"Arun 017E","E01031437","75-79 years","Male",36,37,26,23,31,153
"Arun 017E","E01031437","80-84 years","Male",26,34,40,33,38,171
"Arun 017E","E01031437","85+ years","Male",36,42,35,37,52,202
"Arun 017E","E01031437","0-4 years","Female",75,77,69,60,60,341
"Arun 017E","E01031437","5-9 years","Female",36,32,46,53,42,209
"Arun 017E","E01031437","10-14 years","Female",29,29,27,29,27,141
"Arun 017E","E01031437","15-19 years","Female",28,32,36,29,34,159
"Arun 017E","E01031437","20-24 years","Female",57,58,56,46,44,261
"Arun 017E","E01031437","25-29 years","Female",94,91,90,97,87,459
"Arun 017E","E01031437","30-34 years","Female",89,94,92,86,76,437
"Arun 017E","E01031437","35-39 years","Female",63,66,60,76,86,351
"Arun 017E","E01031437","40-44 years","Female",52,50,71,66,56,295
"Arun 017E","E01031437","45-49 years","Female",62,71,64,65,63,325
"Arun 017E","E01031437","50-54 years","Female",63,62,64,65,76,330
"Arun 017E","E01031437","55-59 years","Female",59,55,59,57,54,284
"Arun 017E","E01031437","60-64 years","Female",47,37,46,50,55,235
"Arun 017E","E01031437","65-69 years","Female",61,60,62,57,52,292
"Arun 017E","E01031437","70-74 years","Female",58,66,68,63,63,318
"Arun 017E","E01031437","75-79 years","Female",43,48,38,55,50,234
"Arun 017E","E01031437","80-84 years","Female",35,33,38,32,30,168
"Arun 017E","E01031437","85+ years","Female",94,82,76,60,62,374
"Arun 017F","E01031453","0-4 years","Male",40,33,33,39,39,184
"Arun 017F","E01031453","5-9 years","Male",39,37,41,42,35,194
"Arun 017F","E01031453","10-14 years","Male",29,22,24,27,32,134
"Arun 017F","E01031453","15-19 years","Male",33,75,70,76,74,328
"Arun 017F","E01031453","20-24 years","Male",55,60,59,53,67,294
"Arun 017F","E01031453","25-29 years","Male",81,77,77,70,71,376
"Arun 017F","E01031453","30-34 years","Male",75,76,80,72,83,386
"Arun 017F","E01031453","35-39 years","Male",32,33,36,51,47,199
"Arun 017F","E01031453","40-44 years","Male",60,48,48,51,50,257
"Arun 017F","E01031453","45-49 years","Male",43,52,55,49,48,247
"Arun 017F","E01031453","50-54 years","Male",57,57,61,68,73,316
"Arun 017F","E01031453","55-59 years","Male",60,65,68,68,58,319
"Arun 017F","E01031453","60-64 years","Male",42,44,51,55,62,254
"Arun 017F","E01031453","65-69 years","Male",54,64,64,56,55,293
"Arun 017F","E01031453","70-74 years","Male",49,46,46,56,60,257
"Arun 017F","E01031453","75-79 years","Male",35,41,45,53,54,228
"Arun 017F","E01031453","80-84 years","Male",46,46,40,38,33,203
"Arun 017F","E01031453","85+ years","Male",32,37,38,47,41,195
"Arun 017F","E01031453","0-4 years","Female",36,43,43,40,34,196
"Arun 017F","E01031453","5-9 years","Female",24,20,25,24,25,118
"Arun 017F","E01031453","10-14 years","Female",25,28,29,33,29,144
"Arun 017F","E01031453","15-19 years","Female",45,46,49,45,42,227
"Arun 017F","E01031453","20-24 years","Female",79,74,73,68,68,362
"Arun 017F","E01031453","25-29 years","Female",55,65,77,74,63,334
"Arun 017F","E01031453","30-34 years","Female",42,49,41,51,62,245
"Arun 017F","E01031453","35-39 years","Female",35,39,44,47,41,206
"Arun 017F","E01031453","40-44 years","Female",30,30,27,30,31,148
"Arun 017F","E01031453","45-49 years","Female",61,57,58,54,55,285
"Arun 017F","E01031453","50-54 years","Female",86,73,74,91,89,413
"Arun 017F","E01031453","55-59 years","Female",59,74,66,76,73,348
"Arun 017F","E01031453","60-64 years","Female",60,49,61,60,60,290
"Arun 017F","E01031453","65-69 years","Female",43,41,55,51,51,241
"Arun 017F","E01031453","70-74 years","Female",51,59,46,49,46,251
"Arun 017F","E01031453","75-79 years","Female",55,45,48,45,48,241
"Arun 017F","E01031453","80-84 years","Female",62,60,58,60,42,282
"Arun 017F","E01031453","85+ years","Female",75,71,70,63,65,344
"Arun 018A","E01031380","0-4 years","Male",13,10,7,8,10,48
"Arun 018A","E01031380","5-9 years","Male",28,24,20,20,15,107
"Arun 018A","E01031380","10-14 years","Male",36,44,45,42,45,212
"Arun 018A","E01031380","15-19 years","Male",22,20,21,25,25,113
"Arun 018A","E01031380","20-24 years","Male",26,24,22,19,15,106
"Arun 018A","E01031380","25-29 years","Male",12,14,18,17,17,78
"Arun 018A","E01031380","30-34 years","Male",15,16,10,10,10,61
"Arun 018A","E01031380","35-39 years","Male",24,25,22,21,24,116
"Arun 018A","E01031380","40-44 years","Male",45,43,33,22,21,164
"Arun 018A","E01031380","45-49 years","Male",42,40,38,51,48,219
"Arun 018A","E01031380","50-54 years","Male",43,39,41,32,28,183
"Arun 018A","E01031380","55-59 years","Male",54,62,61,61,66,304
"Arun 018A","E01031380","60-64 years","Male",46,45,48,47,50,236
"Arun 018A","E01031380","65-69 years","Male",99,89,87,73,60,408
"Arun 018A","E01031380","70-74 years","Male",94,98,95,107,115,509
"Arun 018A","E01031380","75-79 years","Male",71,78,77,78,75,379
"Arun 018A","E01031380","80-84 years","Male",52,48,59,62,66,287
"Arun 018A","E01031380","85+ years","Male",45,48,52,48,51,244
"Arun 018A","E01031380","0-4 years","Female",19,11,11,10,6,57
"Arun 018A","E01031380","5-9 years","Female",29,32,25,23,18,127
"Arun 018A","E01031380","10-14 years","Female",18,25,28,33,32,136
"Arun 018A","E01031380","15-19 years","Female",28,17,18,17,21,101
"Arun 018A","E01031380","20-24 years","Female",23,25,24,26,19,117
"Arun 018A","E01031380","25-29 years","Female",31,28,27,24,31,141
"Arun 018A","E01031380","30-34 years","Female",10,10,9,14,13,56
"Arun 018A","E01031380","35-39 years","Female",27,24,15,15,14,95
"Arun 018A","E01031380","40-44 years","Female",42,43,36,34,28,183
"Arun 018A","E01031380","45-49 years","Female",38,36,38,35,39,186
"Arun 018A","E01031380","50-54 years","Female",51,40,44,42,42,219
"Arun 018A","E01031380","55-59 years","Female",61,68,64,58,52,303
"Arun 018A","E01031380","60-64 years","Female",64,67,64,67,64,326
"Arun 018A","E01031380","65-69 years","Female",112,99,102,87,80,480
"Arun 018A","E01031380","70-74 years","Female",113,129,113,121,122,598
"Arun 018A","E01031380","75-79 years","Female",68,73,94,95,90,420
"Arun 018A","E01031380","80-84 years","Female",53,52,55,65,69,294
"Arun 018A","E01031380","85+ years","Female",71,73,74,71,85,374
"Arun 018B","E01031381","0-4 years","Male",48,44,41,37,39,209
"Arun 018B","E01031381","5-9 years","Male",33,39,32,31,34,169
"Arun 018B","E01031381","10-14 years","Male",25,32,29,30,25,141
"Arun 018B","E01031381","15-19 years","Male",23,22,24,26,24,119
"Arun 018B","E01031381","20-24 years","Male",44,41,49,40,40,214
"Arun 018B","E01031381","25-29 years","Male",26,29,22,21,25,123
"Arun 018B","E01031381","30-34 years","Male",24,20,26,26,18,114
"Arun 018B","E01031381","35-39 years","Male",32,35,33,26,37,163
"Arun 018B","E01031381","40-44 years","Male",31,27,30,36,33,157
"Arun 018B","E01031381","45-49 years","Male",47,46,44,37,37,211
"Arun 018B","E01031381","50-54 years","Male",53,51,49,55,52,260
"Arun 018B","E01031381","55-59 years","Male",53,49,51,50,52,255
"Arun 018B","E01031381","60-64 years","Male",61,65,63,64,66,319
"Arun 018B","E01031381","65-69 years","Male",83,82,80,84,79,408
"Arun 018B","E01031381","70-74 years","Male",79,78,86,85,96,424
"Arun 018B","E01031381","75-79 years","Male",50,51,53,57,60,271
"Arun 018B","E01031381","80-84 years","Male",36,49,50,50,48,233
"Arun 018B","E01031381","85+ years","Male",67,63,58,60,55,303
"Arun 018B","E01031381","0-4 years","Female",27,31,31,27,21,137
"Arun 018B","E01031381","5-9 years","Female",19,19,18,26,25,107
"Arun 018B","E01031381","10-14 years","Female",26,29,28,26,25,134
"Arun 018B","E01031381","15-19 years","Female",32,32,27,27,25,143
"Arun 018B","E01031381","20-24 years","Female",33,26,25,23,32,139
"Arun 018B","E01031381","25-29 years","Female",19,22,20,17,14,92
"Arun 018B","E01031381","30-34 years","Female",38,39,40,32,38,187
"Arun 018B","E01031381","35-39 years","Female",28,37,40,38,45,188
"Arun 018B","E01031381","40-44 years","Female",44,40,48,49,44,225
"Arun 018B","E01031381","45-49 years","Female",46,47,46,40,34,213
"Arun 018B","E01031381","50-54 years","Female",51,52,47,50,49,249
"Arun 018B","E01031381","55-59 years","Female",52,53,51,50,46,252
"Arun 018B","E01031381","60-64 years","Female",73,66,66,78,83,366
"Arun 018B","E01031381","65-69 years","Female",101,96,98,92,101,488
"Arun 018B","E01031381","70-74 years","Female",80,84,97,93,91,445
"Arun 018B","E01031381","75-79 years","Female",65,77,75,79,73,369
"Arun 018B","E01031381","80-84 years","Female",53,48,49,50,59,259
"Arun 018B","E01031381","85+ years","Female",81,80,80,80,74,395
"Arun 018C","E01031382","0-4 years","Male",35,34,36,30,29,164
"Arun 018C","E01031382","5-9 years","Male",35,33,36,43,42,189
"Arun 018C","E01031382","10-14 years","Male",16,22,27,24,24,113
"Arun 018C","E01031382","15-19 years","Male",36,36,36,35,29,172
"Arun 018C","E01031382","20-24 years","Male",28,31,29,35,39,162
"Arun 018C","E01031382","25-29 years","Male",29,24,29,25,29,136
"Arun 018C","E01031382","30-34 years","Male",22,23,22,25,25,117
"Arun 018C","E01031382","35-39 years","Male",21,21,21,16,19,98
"Arun 018C","E01031382","40-44 years","Male",44,34,31,36,34,179
"Arun 018C","E01031382","45-49 years","Male",46,51,50,47,46,240
"Arun 018C","E01031382","50-54 years","Male",45,40,38,45,44,212
"Arun 018C","E01031382","55-59 years","Male",54,54,52,48,53,261
"Arun 018C","E01031382","60-64 years","Male",54,57,49,48,46,254
"Arun 018C","E01031382","65-69 years","Male",112,106,82,78,81,459
"Arun 018C","E01031382","70-74 years","Male",74,76,95,99,94,438
"Arun 018C","E01031382","75-79 years","Male",72,66,70,69,72,349
"Arun 018C","E01031382","80-84 years","Male",50,56,62,59,67,294
"Arun 018C","E01031382","85+ years","Male",46,47,45,53,53,244
"Arun 018C","E01031382","0-4 years","Female",26,19,22,22,25,114
"Arun 018C","E01031382","5-9 years","Female",25,29,27,24,21,126
"Arun 018C","E01031382","10-14 years","Female",31,30,32,32,27,152
"Arun 018C","E01031382","15-19 years","Female",25,22,21,27,36,131
"Arun 018C","E01031382","20-24 years","Female",15,15,12,16,14,72
"Arun 018C","E01031382","25-29 years","Female",28,28,27,21,20,124
"Arun 018C","E01031382","30-34 years","Female",29,26,24,28,21,128
"Arun 018C","E01031382","35-39 years","Female",45,44,34,39,37,199
"Arun 018C","E01031382","40-44 years","Female",39,43,51,44,43,220
"Arun 018C","E01031382","45-49 years","Female",32,35,39,48,47,201
"Arun 018C","E01031382","50-54 years","Female",61,52,49,43,48,253
"Arun 018C","E01031382","55-59 years","Female",71,75,74,77,72,369
"Arun 018C","E01031382","60-64 years","Female",68,68,57,63,65,321
"Arun 018C","E01031382","65-69 years","Female",108,99,96,78,83,464
"Arun 018C","E01031382","70-74 years","Female",101,104,100,112,111,528
"Arun 018C","E01031382","75-79 years","Female",76,81,96,101,104,458
"Arun 018C","E01031382","80-84 years","Female",66,60,55,60,60,301
"Arun 018C","E01031382","85+ years","Female",62,71,70,64,61,328
"Arun 018D","E01031383","0-4 years","Male",14,9,11,12,14,60
"Arun 018D","E01031383","5-9 years","Male",21,22,21,25,22,111
"Arun 018D","E01031383","10-14 years","Male",26,23,22,25,25,121
"Arun 018D","E01031383","15-19 years","Male",19,24,22,24,29,118
"Arun 018D","E01031383","20-24 years","Male",30,24,27,22,19,122
"Arun 018D","E01031383","25-29 years","Male",25,28,26,36,35,150
"Arun 018D","E01031383","30-34 years","Male",6,7,7,7,7,34
"Arun 018D","E01031383","35-39 years","Male",17,14,13,11,11,66
"Arun 018D","E01031383","40-44 years","Male",22,17,17,14,14,84
"Arun 018D","E01031383","45-49 years","Male",32,32,33,32,37,166
"Arun 018D","E01031383","50-54 years","Male",40,45,43,42,46,216
"Arun 018D","E01031383","55-59 years","Male",58,53,53,54,46,264
"Arun 018D","E01031383","60-64 years","Male",63,66,70,68,68,335
"Arun 018D","E01031383","65-69 years","Male",111,104,89,85,91,480
"Arun 018D","E01031383","70-74 years","Male",91,98,112,117,109,527
"Arun 018D","E01031383","75-79 years","Male",79,74,73,79,74,379
"Arun 018D","E01031383","80-84 years","Male",46,55,63,57,61,282
"Arun 018D","E01031383","85+ years","Male",39,34,36,42,44,195
"Arun 018D","E01031383","0-4 years","Female",12,12,12,15,12,63
"Arun 018D","E01031383","5-9 years","Female",25,25,20,16,11,97
"Arun 018D","E01031383","10-14 years","Female",16,17,23,24,24,104
"Arun 018D","E01031383","15-19 years","Female",26,24,17,12,14,93
"Arun 018D","E01031383","20-24 years","Female",17,19,21,21,21,99
"Arun 018D","E01031383","25-29 years","Female",12,17,17,16,13,75
"Arun 018D","E01031383","30-34 years","Female",11,11,11,18,17,68
"Arun 018D","E01031383","35-39 years","Female",16,13,15,20,17,81
"Arun 018D","E01031383","40-44 years","Female",25,26,25,24,21,121
"Arun 018D","E01031383","45-49 years","Female",32,38,33,30,32,165
"Arun 018D","E01031383","50-54 years","Female",65,54,56,60,58,293
"Arun 018D","E01031383","55-59 years","Female",74,85,81,66,61,367
"Arun 018D","E01031383","60-64 years","Female",79,78,84,81,85,407
"Arun 018D","E01031383","65-69 years","Female",114,107,92,92,80,485
"Arun 018D","E01031383","70-74 years","Female",91,98,110,113,123,535
"Arun 018D","E01031383","75-79 years","Female",80,76,77,76,70,379
"Arun 018D","E01031383","80-84 years","Female",74,79,72,72,80,377
"Arun 018D","E01031383","85+ years","Female",76,82,74,85,78,395
"Arun 018E","E01031384","0-4 years","Male",47,44,42,41,53,227
"Arun 018E","E01031384","5-9 years","Male",39,45,40,35,36,195
"Arun 018E","E01031384","10-14 years","Male",30,28,34,45,45,182
"Arun 018E","E01031384","15-19 years","Male",26,37,39,37,43,182
"Arun 018E","E01031384","20-24 years","Male",23,22,22,16,14,97
"Arun 018E","E01031384","25-29 years","Male",26,22,22,16,15,101
"Arun 018E","E01031384","30-34 years","Male",25,26,23,30,32,136
"Arun 018E","E01031384","35-39 years","Male",33,33,27,28,25,146
"Arun 018E","E01031384","40-44 years","Male",38,39,45,49,55,226
"Arun 018E","E01031384","45-49 years","Male",64,61,61,49,45,280
"Arun 018E","E01031384","50-54 years","Male",58,59,57,53,50,277
"Arun 018E","E01031384","55-59 years","Male",41,45,46,45,43,220
"Arun 018E","E01031384","60-64 years","Male",52,58,57,68,72,307
"Arun 018E","E01031384","65-69 years","Male",79,73,63,65,60,340
"Arun 018E","E01031384","70-74 years","Male",73,78,92,90,99,432
"Arun 018E","E01031384","75-79 years","Male",55,62,55,62,69,303
"Arun 018E","E01031384","80-84 years","Male",48,51,54,50,48,251
"Arun 018E","E01031384","85+ years","Male",45,53,51,49,49,247
"Arun 018E","E01031384","0-4 years","Female",29,24,27,30,30,140
"Arun 018E","E01031384","5-9 years","Female",35,39,34,37,40,185
"Arun 018E","E01031384","10-14 years","Female",29,28,32,31,32,152
"Arun 018E","E01031384","15-19 years","Female",23,28,29,27,31,138
"Arun 018E","E01031384","20-24 years","Female",32,28,31,26,22,139
"Arun 018E","E01031384","25-29 years","Female",26,24,28,23,23,124
"Arun 018E","E01031384","30-34 years","Female",39,29,26,31,32,157
"Arun 018E","E01031384","35-39 years","Female",34,47,35,43,42,201
"Arun 018E","E01031384","40-44 years","Female",52,45,51,38,39,225
"Arun 018E","E01031384","45-49 years","Female",33,41,43,51,49,217
"Arun 018E","E01031384","50-54 years","Female",71,64,60,48,38,281
"Arun 018E","E01031384","55-59 years","Female",79,77,72,75,76,379
"Arun 018E","E01031384","60-64 years","Female",54,57,65,75,73,324
"Arun 018E","E01031384","65-69 years","Female",100,96,83,80,69,428
"Arun 018E","E01031384","70-74 years","Female",82,88,90,96,117,473
"Arun 018E","E01031384","75-79 years","Female",70,66,76,75,74,361
"Arun 018E","E01031384","80-84 years","Female",69,70,66,66,62,333
"Arun 018E","E01031384","85+ years","Female",58,64,65,58,60,305
"Arun 019A","E01031385","0-4 years","Male",42,36,40,34,34,186
"Arun 019A","E01031385","5-9 years","Male",41,40,54,54,56,245
"Arun 019A","E01031385","10-14 years","Male",30,37,31,32,35,165
"Arun 019A","E01031385","15-19 years","Male",26,22,28,29,31,136
"Arun 019A","E01031385","20-24 years","Male",21,20,26,27,21,115
"Arun 019A","E01031385","25-29 years","Male",25,29,27,32,33,146
"Arun 019A","E01031385","30-34 years","Male",33,27,29,29,30,148
"Arun 019A","E01031385","35-39 years","Male",28,33,30,29,29,149
"Arun 019A","E01031385","40-44 years","Male",37,37,35,35,30,174
"Arun 019A","E01031385","45-49 years","Male",45,49,42,41,50,227
"Arun 019A","E01031385","50-54 years","Male",37,36,36,34,37,180
"Arun 019A","E01031385","55-59 years","Male",45,44,47,49,53,238
"Arun 019A","E01031385","60-64 years","Male",58,49,53,52,47,259
"Arun 019A","E01031385","65-69 years","Male",67,74,76,72,74,363
"Arun 019A","E01031385","70-74 years","Male",59,62,60,66,67,314
"Arun 019A","E01031385","75-79 years","Male",39,37,39,43,48,206
"Arun 019A","E01031385","80-84 years","Male",45,42,35,33,23,178
"Arun 019A","E01031385","85+ years","Male",29,29,34,35,37,164
"Arun 019A","E01031385","0-4 years","Female",36,33,35,34,34,172
"Arun 019A","E01031385","5-9 years","Female",36,37,38,36,35,182
"Arun 019A","E01031385","10-14 years","Female",47,40,45,44,45,221
"Arun 019A","E01031385","15-19 years","Female",30,33,35,35,33,166
"Arun 019A","E01031385","20-24 years","Female",25,24,28,27,26,130
"Arun 019A","E01031385","25-29 years","Female",26,25,27,27,28,133
"Arun 019A","E01031385","30-34 years","Female",37,32,35,29,33,166
"Arun 019A","E01031385","35-39 years","Female",33,34,37,40,40,184
"Arun 019A","E01031385","40-44 years","Female",56,57,55,50,50,268
"Arun 019A","E01031385","45-49 years","Female",48,44,44,41,49,226
"Arun 019A","E01031385","50-54 years","Female",40,41,40,42,44,207
"Arun 019A","E01031385","55-59 years","Female",53,55,54,48,45,255
"Arun 019A","E01031385","60-64 years","Female",58,53,55,63,64,293
"Arun 019A","E01031385","65-69 years","Female",81,76,76,71,67,371
"Arun 019A","E01031385","70-74 years","Female",74,89,88,86,76,413
"Arun 019A","E01031385","75-79 years","Female",65,54,55,58,66,298
"Arun 019A","E01031385","80-84 years","Female",48,52,50,46,45,241
"Arun 019A","E01031385","85+ years","Female",54,48,44,45,47,238
"Arun 019B","E01031445","0-4 years","Male",18,18,19,19,13,87
"Arun 019B","E01031445","5-9 years","Male",21,18,21,21,27,108
"Arun 019B","E01031445","10-14 years","Male",20,21,20,26,26,113
"Arun 019B","E01031445","15-19 years","Male",23,28,26,25,20,122
"Arun 019B","E01031445","20-24 years","Male",26,23,20,20,20,109
"Arun 019B","E01031445","25-29 years","Male",12,16,17,17,16,78
"Arun 019B","E01031445","30-34 years","Male",24,19,17,16,16,92
"Arun 019B","E01031445","35-39 years","Male",27,25,28,29,35,144
"Arun 019B","E01031445","40-44 years","Male",27,28,25,29,28,137
"Arun 019B","E01031445","45-49 years","Male",36,40,39,35,29,179
"Arun 019B","E01031445","50-54 years","Male",33,37,39,42,41,192
"Arun 019B","E01031445","55-59 years","Male",51,56,55,50,51,263
"Arun 019B","E01031445","60-64 years","Male",46,49,51,54,54,254
"Arun 019B","E01031445","65-69 years","Male",64,60,60,71,63,318
"Arun 019B","E01031445","70-74 years","Male",95,100,86,84,82,447
"Arun 019B","E01031445","75-79 years","Male",82,81,93,84,89,429
"Arun 019B","E01031445","80-84 years","Male",61,67,71,80,83,362
"Arun 019B","E01031445","85+ years","Male",33,29,37,45,41,185
"Arun 019B","E01031445","0-4 years","Female",16,12,13,16,16,73
"Arun 019B","E01031445","5-9 years","Female",21,16,15,17,17,86
"Arun 019B","E01031445","10-14 years","Female",13,11,12,15,16,67
"Arun 019B","E01031445","15-19 years","Female",30,33,26,22,22,133
"Arun 019B","E01031445","20-24 years","Female",15,13,15,18,17,78
"Arun 019B","E01031445","25-29 years","Female",18,16,17,15,17,83
"Arun 019B","E01031445","30-34 years","Female",21,17,21,27,24,110
"Arun 019B","E01031445","35-39 years","Female",29,23,18,15,20,105
"Arun 019B","E01031445","40-44 years","Female",22,25,27,33,32,139
"Arun 019B","E01031445","45-49 years","Female",37,46,44,44,40,211
"Arun 019B","E01031445","50-54 years","Female",56,50,44,43,41,234
"Arun 019B","E01031445","55-59 years","Female",38,53,54,60,61,266
"Arun 019B","E01031445","60-64 years","Female",62,58,61,62,61,304
"Arun 019B","E01031445","65-69 years","Female",85,73,73,76,79,386
"Arun 019B","E01031445","70-74 years","Female",112,114,108,102,96,532
"Arun 019B","E01031445","75-79 years","Female",79,85,82,90,98,434
"Arun 019B","E01031445","80-84 years","Female",64,66,71,68,63,332
"Arun 019B","E01031445","85+ years","Female",63,64,66,72,67,332
"Arun 019C","E01031446","0-4 years","Male",32,34,29,28,30,153
"Arun 019C","E01031446","5-9 years","Male",39,36,35,26,27,163
"Arun 019C","E01031446","10-14 years","Male",30,23,29,32,26,140
"Arun 019C","E01031446","15-19 years","Male",21,21,22,23,28,115
"Arun 019C","E01031446","20-24 years","Male",15,15,14,18,15,77
"Arun 019C","E01031446","25-29 years","Male",25,24,28,23,24,124
"Arun 019C","E01031446","30-34 years","Male",23,23,19,22,24,111
"Arun 019C","E01031446","35-39 years","Male",33,33,33,24,21,144
"Arun 019C","E01031446","40-44 years","Male",34,31,31,36,37,169
"Arun 019C","E01031446","45-49 years","Male",34,38,38,38,34,182
"Arun 019C","E01031446","50-54 years","Male",35,37,35,42,39,188
"Arun 019C","E01031446","55-59 years","Male",34,36,31,34,40,175
"Arun 019C","E01031446","60-64 years","Male",49,51,51,51,48,250
"Arun 019C","E01031446","65-69 years","Male",56,51,54,53,47,261
"Arun 019C","E01031446","70-74 years","Male",52,53,55,58,51,269
"Arun 019C","E01031446","75-79 years","Male",45,41,48,47,63,244
"Arun 019C","E01031446","80-84 years","Male",27,30,28,33,32,150
"Arun 019C","E01031446","85+ years","Male",29,26,20,26,28,129
"Arun 019C","E01031446","0-4 years","Female",39,34,24,28,31,156
"Arun 019C","E01031446","5-9 years","Female",39,48,49,54,55,245
"Arun 019C","E01031446","10-14 years","Female",21,21,19,20,17,98
"Arun 019C","E01031446","15-19 years","Female",25,28,28,33,31,145
"Arun 019C","E01031446","20-24 years","Female",22,13,17,15,16,83
"Arun 019C","E01031446","25-29 years","Female",28,29,30,34,28,149
"Arun 019C","E01031446","30-34 years","Female",38,36,37,37,36,184
"Arun 019C","E01031446","35-39 years","Female",40,38,34,30,31,173
"Arun 019C","E01031446","40-44 years","Female",35,33,37,34,34,173
"Arun 019C","E01031446","45-49 years","Female",37,36,36,43,41,193
"Arun 019C","E01031446","50-54 years","Female",43,47,49,38,43,220
"Arun 019C","E01031446","55-59 years","Female",47,46,48,48,43,232
"Arun 019C","E01031446","60-64 years","Female",39,44,49,48,46,226
"Arun 019C","E01031446","65-69 years","Female",73,67,71,66,60,337
"Arun 019C","E01031446","70-74 years","Female",50,50,58,56,60,274
"Arun 019C","E01031446","75-79 years","Female",58,54,46,48,48,254
"Arun 019C","E01031446","80-84 years","Female",31,35,40,40,45,191
"Arun 019C","E01031446","85+ years","Female",34,38,37,34,31,174
"Arun 019D","E01031447","0-4 years","Male",36,38,34,36,44,188
"Arun 019D","E01031447","5-9 years","Male",28,36,36,36,40,176
"Arun 019D","E01031447","10-14 years","Male",33,28,29,27,25,142
"Arun 019D","E01031447","15-19 years","Male",26,27,26,23,28,130
"Arun 019D","E01031447","20-24 years","Male",27,31,31,36,35,160
"Arun 019D","E01031447","25-29 years","Male",24,23,24,27,26,124
"Arun 019D","E01031447","30-34 years","Male",19,24,23,20,25,111
"Arun 019D","E01031447","35-39 years","Male",25,24,29,27,29,134
"Arun 019D","E01031447","40-44 years","Male",29,22,24,33,32,140
"Arun 019D","E01031447","45-49 years","Male",51,51,44,42,33,221
"Arun 019D","E01031447","50-54 years","Male",68,57,53,46,49,273
"Arun 019D","E01031447","55-59 years","Male",59,59,60,66,69,313
"Arun 019D","E01031447","60-64 years","Male",42,47,52,49,57,247
"Arun 019D","E01031447","65-69 years","Male",64,66,66,56,53,305
"Arun 019D","E01031447","70-74 years","Male",90,88,82,89,79,428
"Arun 019D","E01031447","75-79 years","Male",61,57,55,57,54,284
"Arun 019D","E01031447","80-84 years","Male",44,44,51,53,60,252
"Arun 019D","E01031447","85+ years","Male",33,40,38,35,38,184
"Arun 019D","E01031447","0-4 years","Female",30,26,29,30,25,140
"Arun 019D","E01031447","5-9 years","Female",34,32,43,43,47,199
"Arun 019D","E01031447","10-14 years","Female",26,29,32,36,42,165
"Arun 019D","E01031447","15-19 years","Female",29,24,23,19,23,118
"Arun 019D","E01031447","20-24 years","Female",18,15,17,18,17,85
"Arun 019D","E01031447","25-29 years","Female",18,17,13,11,14,73
"Arun 019D","E01031447","30-34 years","Female",27,28,34,41,39,169
"Arun 019D","E01031447","35-39 years","Female",26,26,28,28,39,147
"Arun 019D","E01031447","40-44 years","Female",38,35,32,29,36,170
"Arun 019D","E01031447","45-49 years","Female",44,37,42,36,31,190
"Arun 019D","E01031447","50-54 years","Female",58,58,57,55,47,275
"Arun 019D","E01031447","55-59 years","Female",65,62,54,65,80,326
"Arun 019D","E01031447","60-64 years","Female",46,57,67,71,71,312
"Arun 019D","E01031447","65-69 years","Female",98,84,78,66,63,389
"Arun 019D","E01031447","70-74 years","Female",89,96,106,105,100,496
"Arun 019D","E01031447","75-79 years","Female",62,63,63,58,53,299
"Arun 019D","E01031447","80-84 years","Female",49,50,51,57,65,272
"Arun 019D","E01031447","85+ years","Female",52,46,42,39,45,224
"Arun 019E","E01031448","0-4 years","Male",26,30,34,38,30,158
"Arun 019E","E01031448","5-9 years","Male",43,40,36,35,29,183
"Arun 019E","E01031448","10-14 years","Male",35,36,43,45,49,208
"Arun 019E","E01031448","15-19 years","Male",16,15,24,24,31,110
"Arun 019E","E01031448","20-24 years","Male",17,18,13,18,13,79
"Arun 019E","E01031448","25-29 years","Male",34,35,34,28,32,163
"Arun 019E","E01031448","30-34 years","Male",22,21,20,26,22,111
"Arun 019E","E01031448","35-39 years","Male",31,31,34,37,35,168
"Arun 019E","E01031448","40-44 years","Male",38,37,35,32,30,172
"Arun 019E","E01031448","45-49 years","Male",42,36,42,38,40,198
"Arun 019E","E01031448","50-54 years","Male",52,51,50,49,43,245
"Arun 019E","E01031448","55-59 years","Male",48,63,57,67,74,309
"Arun 019E","E01031448","60-64 years","Male",44,47,50,46,46,233
"Arun 019E","E01031448","65-69 years","Male",83,61,49,48,39,280
"Arun 019E","E01031448","70-74 years","Male",87,95,101,99,102,484
"Arun 019E","E01031448","75-79 years","Male",40,45,51,59,69,264
"Arun 019E","E01031448","80-84 years","Male",38,41,43,43,36,201
"Arun 019E","E01031448","85+ years","Male",28,28,32,28,30,146
"Arun 019E","E01031448","0-4 years","Female",46,33,41,30,26,176
"Arun 019E","E01031448","5-9 years","Female",30,39,37,40,37,183
"Arun 019E","E01031448","10-14 years","Female",23,23,23,29,34,132
"Arun 019E","E01031448","15-19 years","Female",22,17,17,11,11,78
"Arun 019E","E01031448","20-24 years","Female",29,35,33,29,26,152
"Arun 019E","E01031448","25-29 years","Female",18,21,23,23,21,106
"Arun 019E","E01031448","30-34 years","Female",28,30,28,26,22,134
"Arun 019E","E01031448","35-39 years","Female",38,35,37,40,35,185
"Arun 019E","E01031448","40-44 years","Female",25,29,31,35,33,153
"Arun 019E","E01031448","45-49 years","Female",50,51,55,51,49,256
"Arun 019E","E01031448","50-54 years","Female",62,65,69,62,57,315
"Arun 019E","E01031448","55-59 years","Female",71,66,71,70,79,357
"Arun 019E","E01031448","60-64 years","Female",63,63,59,67,68,320
"Arun 019E","E01031448","65-69 years","Female",97,87,83,76,63,406
"Arun 019E","E01031448","70-74 years","Female",81,106,103,109,110,509
"Arun 019E","E01031448","75-79 years","Female",70,70,71,60,68,339
"Arun 019E","E01031448","80-84 years","Female",54,45,49,48,48,244
"Arun 019E","E01031448","85+ years","Female",39,48,46,47,46,226
"Arun 019F","E01031449","0-4 years","Male",60,68,55,40,40,263
"Arun 019F","E01031449","5-9 years","Male",56,56,59,57,45,273
"Arun 019F","E01031449","10-14 years","Male",55,61,65,68,65,314
"Arun 019F","E01031449","15-19 years","Male",61,54,53,48,47,263
"Arun 019F","E01031449","20-24 years","Male",46,49,45,43,41,224
"Arun 019F","E01031449","25-29 years","Male",45,48,45,44,46,228
"Arun 019F","E01031449","30-34 years","Male",40,37,33,34,34,178
"Arun 019F","E01031449","35-39 years","Male",54,60,59,50,47,270
"Arun 019F","E01031449","40-44 years","Male",53,54,57,55,54,273
"Arun 019F","E01031449","45-49 years","Male",53,51,55,44,44,247
"Arun 019F","E01031449","50-54 years","Male",64,64,66,64,76,334
"Arun 019F","E01031449","55-59 years","Male",71,71,71,77,80,370
"Arun 019F","E01031449","60-64 years","Male",55,50,53,61,55,274
"Arun 019F","E01031449","65-69 years","Male",49,56,55,58,60,278
"Arun 019F","E01031449","70-74 years","Male",44,53,47,47,58,249
"Arun 019F","E01031449","75-79 years","Male",25,21,28,34,31,139
"Arun 019F","E01031449","80-84 years","Male",14,18,13,15,15,75
"Arun 019F","E01031449","85+ years","Male",6,4,4,3,3,20
"Arun 019F","E01031449","0-4 years","Female",47,42,40,40,42,211
"Arun 019F","E01031449","5-9 years","Female",47,51,54,53,51,256
"Arun 019F","E01031449","10-14 years","Female",44,38,45,46,46,219
"Arun 019F","E01031449","15-19 years","Female",49,50,47,47,46,239
"Arun 019F","E01031449","20-24 years","Female",38,34,39,32,29,172
"Arun 019F","E01031449","25-29 years","Female",42,39,32,35,36,184
"Arun 019F","E01031449","30-34 years","Female",49,56,46,50,48,249
"Arun 019F","E01031449","35-39 years","Female",46,46,59,58,50,259
"Arun 019F","E01031449","40-44 years","Female",76,72,67,57,56,328
"Arun 019F","E01031449","45-49 years","Female",62,66,59,56,58,301
"Arun 019F","E01031449","50-54 years","Female",78,77,94,90,78,417
"Arun 019F","E01031449","55-59 years","Female",43,57,57,63,75,295
"Arun 019F","E01031449","60-64 years","Female",64,65,68,70,58,325
"Arun 019F","E01031449","65-69 years","Female",58,60,65,73,69,325
"Arun 019F","E01031449","70-74 years","Female",44,53,38,37,49,221
"Arun 019F","E01031449","75-79 years","Female",38,28,35,34,36,171
"Arun 019F","E01031449","80-84 years","Female",30,37,40,42,40,189
"Arun 019F","E01031449","85+ years","Female",26,25,20,19,21,111
"Chichester 001A","E01031502","0-4 years","Male",61,65,57,53,49,285
"Chichester 001A","E01031502","5-9 years","Male",77,69,64,64,70,344
"Chichester 001A","E01031502","10-14 years","Male",62,63,73,78,65,341
"Chichester 001A","E01031502","15-19 years","Male",60,51,49,57,59,276
"Chichester 001A","E01031502","20-24 years","Male",32,24,27,23,23,129
"Chichester 001A","E01031502","25-29 years","Male",23,21,17,20,16,97
"Chichester 001A","E01031502","30-34 years","Male",13,13,11,6,8,51
"Chichester 001A","E01031502","35-39 years","Male",54,46,39,32,37,208
"Chichester 001A","E01031502","40-44 years","Male",77,74,71,63,50,335
"Chichester 001A","E01031502","45-49 years","Male",68,70,76,74,74,362
"Chichester 001A","E01031502","50-54 years","Male",70,68,65,74,71,348
"Chichester 001A","E01031502","55-59 years","Male",43,48,49,50,57,247
"Chichester 001A","E01031502","60-64 years","Male",44,44,43,46,38,215
"Chichester 001A","E01031502","65-69 years","Male",52,50,47,43,41,233
"Chichester 001A","E01031502","70-74 years","Male",23,31,31,28,31,144
"Chichester 001A","E01031502","75-79 years","Male",26,23,22,24,25,120
"Chichester 001A","E01031502","80-84 years","Male",16,14,18,20,24,92
"Chichester 001A","E01031502","85+ years","Male",7,9,7,7,5,35
"Chichester 001A","E01031502","0-4 years","Female",51,56,53,48,33,241
"Chichester 001A","E01031502","5-9 years","Female",110,109,100,101,101,521
"Chichester 001A","E01031502","10-14 years","Female",53,57,68,73,76,327
"Chichester 001A","E01031502","15-19 years","Female",31,36,38,40,37,182
"Chichester 001A","E01031502","20-24 years","Female",17,19,21,18,21,96
"Chichester 001A","E01031502","25-29 years","Female",17,18,15,23,17,90
"Chichester 001A","E01031502","30-34 years","Female",20,21,22,17,15,95
"Chichester 001A","E01031502","35-39 years","Female",60,62,54,49,43,268
"Chichester 001A","E01031502","40-44 years","Female",86,73,71,72,67,369
"Chichester 001A","E01031502","45-49 years","Female",69,79,91,99,92,430
"Chichester 001A","E01031502","50-54 years","Female",63,67,63,57,54,304
"Chichester 001A","E01031502","55-59 years","Female",70,68,80,80,70,368
"Chichester 001A","E01031502","60-64 years","Female",39,42,44,49,52,226
"Chichester 001A","E01031502","65-69 years","Female",43,48,44,40,33,208
"Chichester 001A","E01031502","70-74 years","Female",33,36,37,39,50,195
"Chichester 001A","E01031502","75-79 years","Female",17,19,20,23,20,99
"Chichester 001A","E01031502","80-84 years","Female",16,11,13,13,13,66
"Chichester 001A","E01031502","85+ years","Female",7,10,11,9,13,50
"Chichester 001B","E01031503","0-4 years","Male",40,37,35,31,38,181
"Chichester 001B","E01031503","5-9 years","Male",59,64,46,53,45,267
"Chichester 001B","E01031503","10-14 years","Male",74,72,75,82,77,380
"Chichester 001B","E01031503","15-19 years","Male",47,54,55,54,46,256
"Chichester 001B","E01031503","20-24 years","Male",52,37,39,39,35,202
"Chichester 001B","E01031503","25-29 years","Male",29,36,37,43,32,177
"Chichester 001B","E01031503","30-34 years","Male",25,28,25,27,24,129
"Chichester 001B","E01031503","35-39 years","Male",39,33,29,25,20,146
"Chichester 001B","E01031503","40-44 years","Male",48,46,36,44,51,225
"Chichester 001B","E01031503","45-49 years","Male",63,63,63,56,52,297
"Chichester 001B","E01031503","50-54 years","Male",81,78,78,86,76,399
"Chichester 001B","E01031503","55-59 years","Male",70,72,68,66,64,340
"Chichester 001B","E01031503","60-64 years","Male",51,50,45,49,53,248
"Chichester 001B","E01031503","65-69 years","Male",53,59,57,45,44,258
"Chichester 001B","E01031503","70-74 years","Male",62,72,75,87,71,367
"Chichester 001B","E01031503","75-79 years","Male",34,41,34,42,53,204
"Chichester 001B","E01031503","80-84 years","Male",24,27,20,21,20,112
"Chichester 001B","E01031503","85+ years","Male",18,22,25,24,25,114
"Chichester 001B","E01031503","0-4 years","Female",60,56,55,46,42,259
"Chichester 001B","E01031503","5-9 years","Female",47,53,66,75,77,318
"Chichester 001B","E01031503","10-14 years","Female",73,80,65,72,73,363
"Chichester 001B","E01031503","15-19 years","Female",29,26,32,34,34,155
"Chichester 001B","E01031503","20-24 years","Female",30,27,23,19,18,117
"Chichester 001B","E01031503","25-29 years","Female",26,35,33,35,29,158
"Chichester 001B","E01031503","30-34 years","Female",29,26,23,30,27,135
"Chichester 001B","E01031503","35-39 years","Female",49,43,43,46,47,228
"Chichester 001B","E01031503","40-44 years","Female",56,49,44,41,51,241
"Chichester 001B","E01031503","45-49 years","Female",57,73,78,77,74,359
"Chichester 001B","E01031503","50-54 years","Female",72,70,66,63,65,336
"Chichester 001B","E01031503","55-59 years","Female",75,73,70,82,79,379
"Chichester 001B","E01031503","60-64 years","Female",37,44,48,46,48,223
"Chichester 001B","E01031503","65-69 years","Female",48,47,45,39,41,220
"Chichester 001B","E01031503","70-74 years","Female",37,45,50,51,47,230
"Chichester 001B","E01031503","75-79 years","Female",21,20,25,27,31,124
"Chichester 001B","E01031503","80-84 years","Female",12,10,8,8,5,43
"Chichester 001B","E01031503","85+ years","Female",35,32,30,26,22,145
"Chichester 001C","E01031504","0-4 years","Male",60,47,45,44,44,240
"Chichester 001C","E01031504","5-9 years","Male",88,92,86,71,66,403
"Chichester 001C","E01031504","10-14 years","Male",67,70,74,77,75,363
"Chichester 001C","E01031504","15-19 years","Male",40,41,46,50,61,238
"Chichester 001C","E01031504","20-24 years","Male",31,27,24,25,22,129
"Chichester 001C","E01031504","25-29 years","Male",36,40,39,32,34,181
"Chichester 001C","E01031504","30-34 years","Male",54,45,36,42,40,217
"Chichester 001C","E01031504","35-39 years","Male",70,68,66,63,57,324
"Chichester 001C","E01031504","40-44 years","Male",77,74,69,61,53,334
"Chichester 001C","E01031504","45-49 years","Male",66,57,65,69,72,329
"Chichester 001C","E01031504","50-54 years","Male",77,82,80,73,73,385
"Chichester 001C","E01031504","55-59 years","Male",59,64,62,65,59,309
"Chichester 001C","E01031504","60-64 years","Male",62,65,67,76,79,349
"Chichester 001C","E01031504","65-69 years","Male",80,78,69,64,62,353
"Chichester 001C","E01031504","70-74 years","Male",70,83,90,71,85,399
"Chichester 001C","E01031504","75-79 years","Male",38,29,34,55,54,210
"Chichester 001C","E01031504","80-84 years","Male",38,37,32,29,31,167
"Chichester 001C","E01031504","85+ years","Male",29,30,29,32,28,148
"Chichester 001C","E01031504","0-4 years","Female",63,61,59,42,45,270
"Chichester 001C","E01031504","5-9 years","Female",89,90,76,77,72,404
"Chichester 001C","E01031504","10-14 years","Female",67,68,78,71,74,358
"Chichester 001C","E01031504","15-19 years","Female",53,61,65,75,67,321
"Chichester 001C","E01031504","20-24 years","Female",28,26,21,22,25,122
"Chichester 001C","E01031504","25-29 years","Female",29,32,37,35,31,164
"Chichester 001C","E01031504","30-34 years","Female",83,65,54,43,46,291
"Chichester 001C","E01031504","35-39 years","Female",80,85,77,78,76,396
"Chichester 001C","E01031504","40-44 years","Female",63,60,68,63,56,310
"Chichester 001C","E01031504","45-49 years","Female",68,77,76,79,81,381
"Chichester 001C","E01031504","50-54 years","Female",111,100,90,85,88,474
"Chichester 001C","E01031504","55-59 years","Female",76,73,77,84,90,400
"Chichester 001C","E01031504","60-64 years","Female",65,69,75,79,77,365
"Chichester 001C","E01031504","65-69 years","Female",66,66,56,59,60,307
"Chichester 001C","E01031504","70-74 years","Female",72,78,79,70,67,366
"Chichester 001C","E01031504","75-79 years","Female",50,47,55,57,56,265
"Chichester 001C","E01031504","80-84 years","Female",30,31,31,35,39,166
"Chichester 001C","E01031504","85+ years","Female",50,54,50,55,48,257
"Chichester 001D","E01031519","0-4 years","Male",33,40,25,20,25,143
"Chichester 001D","E01031519","5-9 years","Male",50,45,44,41,34,214
"Chichester 001D","E01031519","10-14 years","Male",55,60,61,62,56,294
"Chichester 001D","E01031519","15-19 years","Male",37,35,34,36,35,177
"Chichester 001D","E01031519","20-24 years","Male",30,26,25,22,21,124
"Chichester 001D","E01031519","25-29 years","Male",16,20,20,25,21,102
"Chichester 001D","E01031519","30-34 years","Male",26,19,21,22,21,109
"Chichester 001D","E01031519","35-39 years","Male",39,42,31,27,30,169
"Chichester 001D","E01031519","40-44 years","Male",45,38,42,36,37,198
"Chichester 001D","E01031519","45-49 years","Male",62,64,58,58,53,295
"Chichester 001D","E01031519","50-54 years","Male",51,54,44,48,51,248
"Chichester 001D","E01031519","55-59 years","Male",64,55,63,58,64,304
"Chichester 001D","E01031519","60-64 years","Male",52,55,54,62,54,277
"Chichester 001D","E01031519","65-69 years","Male",49,48,43,46,52,238
"Chichester 001D","E01031519","70-74 years","Male",39,48,53,53,53,246
"Chichester 001D","E01031519","75-79 years","Male",28,21,29,37,33,148
"Chichester 001D","E01031519","80-84 years","Male",13,15,14,15,15,72
"Chichester 001D","E01031519","85+ years","Male",19,18,22,17,22,98
"Chichester 001D","E01031519","0-4 years","Female",24,21,18,22,19,104
"Chichester 001D","E01031519","5-9 years","Female",45,47,38,32,34,196
"Chichester 001D","E01031519","10-14 years","Female",50,51,65,69,62,297
"Chichester 001D","E01031519","15-19 years","Female",46,46,29,33,36,190
"Chichester 001D","E01031519","20-24 years","Female",27,26,25,27,28,133
"Chichester 001D","E01031519","25-29 years","Female",28,28,33,24,22,135
"Chichester 001D","E01031519","30-34 years","Female",24,24,24,19,22,113
"Chichester 001D","E01031519","35-39 years","Female",43,37,33,27,29,169
"Chichester 001D","E01031519","40-44 years","Female",69,67,68,67,58,329
"Chichester 001D","E01031519","45-49 years","Female",54,60,58,57,60,289
"Chichester 001D","E01031519","50-54 years","Female",45,43,45,46,51,230
"Chichester 001D","E01031519","55-59 years","Female",69,72,64,56,63,324
"Chichester 001D","E01031519","60-64 years","Female",40,45,50,64,68,267
"Chichester 001D","E01031519","65-69 years","Female",52,52,51,44,37,236
"Chichester 001D","E01031519","70-74 years","Female",37,38,39,43,45,202
"Chichester 001D","E01031519","75-79 years","Female",28,36,37,40,45,186
"Chichester 001D","E01031519","80-84 years","Female",27,27,30,36,32,152
"Chichester 001D","E01031519","85+ years","Female",6,7,7,12,19,51
"Chichester 002A","E01031517","0-4 years","Male",46,54,53,52,45,250
"Chichester 002A","E01031517","5-9 years","Male",58,50,47,42,44,241
"Chichester 002A","E01031517","10-14 years","Male",72,78,73,77,71,371
"Chichester 002A","E01031517","15-19 years","Male",59,61,57,55,56,288
"Chichester 002A","E01031517","20-24 years","Male",28,29,31,28,25,141
"Chichester 002A","E01031517","25-29 years","Male",20,17,19,22,27,105
"Chichester 002A","E01031517","30-34 years","Male",33,39,47,46,40,205
"Chichester 002A","E01031517","35-39 years","Male",37,35,39,48,47,206
"Chichester 002A","E01031517","40-44 years","Male",54,49,50,42,42,237
"Chichester 002A","E01031517","45-49 years","Male",76,74,66,66,71,353
"Chichester 002A","E01031517","50-54 years","Male",87,94,93,91,85,450
"Chichester 002A","E01031517","55-59 years","Male",68,65,69,69,67,338
"Chichester 002A","E01031517","60-64 years","Male",58,62,73,76,74,343
"Chichester 002A","E01031517","65-69 years","Male",78,76,65,66,68,353
"Chichester 002A","E01031517","70-74 years","Male",66,69,71,75,71,352
"Chichester 002A","E01031517","75-79 years","Male",52,51,58,61,69,291
"Chichester 002A","E01031517","80-84 years","Male",24,25,32,30,35,146
"Chichester 002A","E01031517","85+ years","Male",21,22,26,32,32,133
"Chichester 002A","E01031517","0-4 years","Female",54,47,41,46,41,229
"Chichester 002A","E01031517","5-9 years","Female",73,79,83,82,76,393
"Chichester 002A","E01031517","10-14 years","Female",76,73,80,76,84,389
"Chichester 002A","E01031517","15-19 years","Female",36,35,36,38,50,195
"Chichester 002A","E01031517","20-24 years","Female",37,36,40,34,34,181
"Chichester 002A","E01031517","25-29 years","Female",14,15,13,17,19,78
"Chichester 002A","E01031517","30-34 years","Female",25,30,29,30,25,139
"Chichester 002A","E01031517","35-39 years","Female",45,43,44,48,42,222
"Chichester 002A","E01031517","40-44 years","Female",61,63,53,52,55,284
"Chichester 002A","E01031517","45-49 years","Female",95,98,92,90,88,463
"Chichester 002A","E01031517","50-54 years","Female",88,85,90,87,85,435
"Chichester 002A","E01031517","55-59 years","Female",70,75,77,88,85,395
"Chichester 002A","E01031517","60-64 years","Female",53,47,56,63,74,293
"Chichester 002A","E01031517","65-69 years","Female",80,85,78,76,73,392
"Chichester 002A","E01031517","70-74 years","Female",57,60,67,70,75,329
"Chichester 002A","E01031517","75-79 years","Female",41,35,47,57,62,242
"Chichester 002A","E01031517","80-84 years","Female",29,30,29,34,35,157
"Chichester 002A","E01031517","85+ years","Female",24,27,27,37,33,148
"Chichester 002B","E01031518","0-4 years","Male",21,25,29,31,29,135
"Chichester 002B","E01031518","5-9 years","Male",51,51,44,37,45,228
"Chichester 002B","E01031518","10-14 years","Male",45,49,50,50,49,243
"Chichester 002B","E01031518","15-19 years","Male",53,48,38,39,37,215
"Chichester 002B","E01031518","20-24 years","Male",28,23,28,28,31,138
"Chichester 002B","E01031518","25-29 years","Male",20,18,18,21,15,92
"Chichester 002B","E01031518","30-34 years","Male",17,13,13,18,19,80
"Chichester 002B","E01031518","35-39 years","Male",15,17,15,14,21,82
"Chichester 002B","E01031518","40-44 years","Male",36,23,26,30,31,146
"Chichester 002B","E01031518","45-49 years","Male",75,78,77,70,57,357
"Chichester 002B","E01031518","50-54 years","Male",65,67,64,61,65,322
"Chichester 002B","E01031518","55-59 years","Male",84,90,95,94,88,451
"Chichester 002B","E01031518","60-64 years","Male",68,73,75,68,71,355
"Chichester 002B","E01031518","65-69 years","Male",60,53,49,57,60,279
"Chichester 002B","E01031518","70-74 years","Male",57,63,66,61,62,309
"Chichester 002B","E01031518","75-79 years","Male",43,40,38,44,45,210
"Chichester 002B","E01031518","80-84 years","Male",25,22,32,32,34,145
"Chichester 002B","E01031518","85+ years","Male",18,23,21,20,20,102
"Chichester 002B","E01031518","0-4 years","Female",32,30,36,36,38,172
"Chichester 002B","E01031518","5-9 years","Female",43,52,57,52,59,263
"Chichester 002B","E01031518","10-14 years","Female",44,52,50,65,59,270
"Chichester 002B","E01031518","15-19 years","Female",50,47,41,40,35,213
"Chichester 002B","E01031518","20-24 years","Female",13,14,16,19,18,80
"Chichester 002B","E01031518","25-29 years","Female",16,22,21,22,28,109
"Chichester 002B","E01031518","30-34 years","Female",14,11,13,9,11,58
"Chichester 002B","E01031518","35-39 years","Female",35,37,28,29,31,160
"Chichester 002B","E01031518","40-44 years","Female",40,47,46,45,36,214
"Chichester 002B","E01031518","45-49 years","Female",70,51,58,52,56,287
"Chichester 002B","E01031518","50-54 years","Female",88,88,83,75,70,404
"Chichester 002B","E01031518","55-59 years","Female",86,98,98,99,94,475
"Chichester 002B","E01031518","60-64 years","Female",57,55,66,70,79,327
"Chichester 002B","E01031518","65-69 years","Female",60,55,54,57,63,289
"Chichester 002B","E01031518","70-74 years","Female",50,51,52,41,39,233
"Chichester 002B","E01031518","75-79 years","Female",42,40,40,56,61,239
"Chichester 002B","E01031518","80-84 years","Female",25,28,27,24,22,126
"Chichester 002B","E01031518","85+ years","Female",24,32,30,23,22,131
"Chichester 002C","E01031544","0-4 years","Male",36,40,44,36,29,185
"Chichester 002C","E01031544","5-9 years","Male",47,41,33,33,45,199
"Chichester 002C","E01031544","10-14 years","Male",35,39,34,34,35,177
"Chichester 002C","E01031544","15-19 years","Male",27,25,26,26,30,134
"Chichester 002C","E01031544","20-24 years","Male",18,21,27,30,22,118
"Chichester 002C","E01031544","25-29 years","Male",26,27,21,23,23,120
"Chichester 002C","E01031544","30-34 years","Male",24,17,20,15,15,91
"Chichester 002C","E01031544","35-39 years","Male",28,24,24,23,21,120
"Chichester 002C","E01031544","40-44 years","Male",40,35,33,31,37,176
"Chichester 002C","E01031544","45-49 years","Male",55,51,49,44,40,239
"Chichester 002C","E01031544","50-54 years","Male",41,40,40,41,38,200
"Chichester 002C","E01031544","55-59 years","Male",48,58,55,54,59,274
"Chichester 002C","E01031544","60-64 years","Male",44,46,48,54,56,248
"Chichester 002C","E01031544","65-69 years","Male",56,46,49,42,39,232
"Chichester 002C","E01031544","70-74 years","Male",39,48,56,52,51,246
"Chichester 002C","E01031544","75-79 years","Male",23,29,27,33,32,144
"Chichester 002C","E01031544","80-84 years","Male",20,22,22,19,24,107
"Chichester 002C","E01031544","85+ years","Male",5,4,4,4,4,21
"Chichester 002C","E01031544","0-4 years","Female",31,41,47,49,55,223
"Chichester 002C","E01031544","5-9 years","Female",41,43,34,25,31,174
"Chichester 002C","E01031544","10-14 years","Female",31,27,32,31,29,150
"Chichester 002C","E01031544","15-19 years","Female",34,44,43,43,44,208
"Chichester 002C","E01031544","20-24 years","Female",27,26,21,18,22,114
"Chichester 002C","E01031544","25-29 years","Female",25,25,24,20,18,112
"Chichester 002C","E01031544","30-34 years","Female",18,19,19,25,33,114
"Chichester 002C","E01031544","35-39 years","Female",37,34,28,27,24,150
"Chichester 002C","E01031544","40-44 years","Female",47,47,47,45,55,241
"Chichester 002C","E01031544","45-49 years","Female",47,44,37,31,25,184
"Chichester 002C","E01031544","50-54 years","Female",63,66,68,60,52,309
"Chichester 002C","E01031544","55-59 years","Female",42,39,38,42,55,216
"Chichester 002C","E01031544","60-64 years","Female",48,65,66,71,70,320
"Chichester 002C","E01031544","65-69 years","Female",46,45,48,44,47,230
"Chichester 002C","E01031544","70-74 years","Female",42,46,49,49,42,228
"Chichester 002C","E01031544","75-79 years","Female",24,19,20,27,29,119
"Chichester 002C","E01031544","80-84 years","Female",19,20,19,19,19,96
"Chichester 002C","E01031544","85+ years","Female",12,13,14,13,11,63
"Chichester 002D","E01031545","0-4 years","Male",30,22,20,18,16,106
"Chichester 002D","E01031545","5-9 years","Male",33,37,32,32,33,167
"Chichester 002D","E01031545","10-14 years","Male",35,36,37,36,35,179
"Chichester 002D","E01031545","15-19 years","Male",28,32,34,37,36,167
"Chichester 002D","E01031545","20-24 years","Male",27,17,18,16,17,95
"Chichester 002D","E01031545","25-29 years","Male",18,19,19,21,17,94
"Chichester 002D","E01031545","30-34 years","Male",19,19,17,13,14,82
"Chichester 002D","E01031545","35-39 years","Male",28,33,35,36,37,169
"Chichester 002D","E01031545","40-44 years","Male",32,29,30,25,22,138
"Chichester 002D","E01031545","45-49 years","Male",39,35,33,38,33,178
"Chichester 002D","E01031545","50-54 years","Male",58,58,54,54,60,284
"Chichester 002D","E01031545","55-59 years","Male",54,54,58,57,47,270
"Chichester 002D","E01031545","60-64 years","Male",55,52,55,53,56,271
"Chichester 002D","E01031545","65-69 years","Male",35,34,34,38,40,181
"Chichester 002D","E01031545","70-74 years","Male",44,45,50,45,48,232
"Chichester 002D","E01031545","75-79 years","Male",21,19,21,27,27,115
"Chichester 002D","E01031545","80-84 years","Male",22,26,21,18,17,104
"Chichester 002D","E01031545","85+ years","Male",17,12,15,21,25,90
"Chichester 002D","E01031545","0-4 years","Female",22,26,26,21,27,122
"Chichester 002D","E01031545","5-9 years","Female",31,40,43,44,41,199
"Chichester 002D","E01031545","10-14 years","Female",37,34,31,33,29,164
"Chichester 002D","E01031545","15-19 years","Female",38,33,31,34,34,170
"Chichester 002D","E01031545","20-24 years","Female",14,12,13,12,17,68
"Chichester 002D","E01031545","25-29 years","Female",24,21,25,27,25,122
"Chichester 002D","E01031545","30-34 years","Female",12,12,18,11,14,67
"Chichester 002D","E01031545","35-39 years","Female",27,31,24,23,22,127
"Chichester 002D","E01031545","40-44 years","Female",52,46,44,41,35,218
"Chichester 002D","E01031545","45-49 years","Female",48,43,43,41,43,218
"Chichester 002D","E01031545","50-54 years","Female",59,60,61,69,69,318
"Chichester 002D","E01031545","55-59 years","Female",57,55,60,53,53,278
"Chichester 002D","E01031545","60-64 years","Female",45,45,46,48,55,239
"Chichester 002D","E01031545","65-69 years","Female",42,40,39,45,41,207
"Chichester 002D","E01031545","70-74 years","Female",47,50,40,41,40,218
"Chichester 002D","E01031545","75-79 years","Female",37,38,39,42,42,198
"Chichester 002D","E01031545","80-84 years","Female",23,20,20,22,24,109
"Chichester 002D","E01031545","85+ years","Female",22,23,27,26,30,128
"Chichester 003A","E01031508","0-4 years","Male",46,48,40,36,35,205
"Chichester 003A","E01031508","5-9 years","Male",48,47,41,48,50,234
"Chichester 003A","E01031508","10-14 years","Male",52,67,74,68,60,321
"Chichester 003A","E01031508","15-19 years","Male",43,39,37,29,37,185
"Chichester 003A","E01031508","20-24 years","Male",38,35,35,36,28,172
"Chichester 003A","E01031508","25-29 years","Male",49,61,51,48,43,252
"Chichester 003A","E01031508","30-34 years","Male",24,25,30,31,35,145
"Chichester 003A","E01031508","35-39 years","Male",31,24,24,28,26,133
"Chichester 003A","E01031508","40-44 years","Male",67,65,47,43,44,266
"Chichester 003A","E01031508","45-49 years","Male",64,70,77,66,54,331
"Chichester 003A","E01031508","50-54 years","Male",85,77,76,78,81,397
"Chichester 003A","E01031508","55-59 years","Male",77,86,92,93,100,448
"Chichester 003A","E01031508","60-64 years","Male",89,85,75,76,78,403
"Chichester 003A","E01031508","65-69 years","Male",68,63,72,77,76,356
"Chichester 003A","E01031508","70-74 years","Male",65,75,77,72,77,366
"Chichester 003A","E01031508","75-79 years","Male",57,59,50,57,54,277
"Chichester 003A","E01031508","80-84 years","Male",51,47,51,50,50,249
"Chichester 003A","E01031508","85+ years","Male",33,32,36,36,34,171
"Chichester 003A","E01031508","0-4 years","Female",40,37,31,34,39,181
"Chichester 003A","E01031508","5-9 years","Female",47,55,54,55,59,270
"Chichester 003A","E01031508","10-14 years","Female",51,46,47,52,51,247
"Chichester 003A","E01031508","15-19 years","Female",55,52,52,44,47,250
"Chichester 003A","E01031508","20-24 years","Female",38,46,42,43,43,212
"Chichester 003A","E01031508","25-29 years","Female",34,37,43,34,33,181
"Chichester 003A","E01031508","30-34 years","Female",25,25,28,32,30,140
"Chichester 003A","E01031508","35-39 years","Female",35,42,38,39,41,195
"Chichester 003A","E01031508","40-44 years","Female",66,69,64,59,55,313
"Chichester 003A","E01031508","45-49 years","Female",81,71,76,73,66,367
"Chichester 003A","E01031508","50-54 years","Female",117,123,124,99,102,565
"Chichester 003A","E01031508","55-59 years","Female",90,83,90,110,114,487
"Chichester 003A","E01031508","60-64 years","Female",80,82,85,87,88,422
"Chichester 003A","E01031508","65-69 years","Female",68,69,68,64,74,343
"Chichester 003A","E01031508","70-74 years","Female",71,77,74,74,59,355
"Chichester 003A","E01031508","75-79 years","Female",46,48,53,53,69,269
"Chichester 003A","E01031508","80-84 years","Female",37,38,35,37,34,181
"Chichester 003A","E01031508","85+ years","Female",40,36,42,37,40,195
"Chichester 003B","E01031520","0-4 years","Male",26,25,27,39,43,160
"Chichester 003B","E01031520","5-9 years","Male",30,28,30,26,26,140
"Chichester 003B","E01031520","10-14 years","Male",47,43,42,41,39,212
"Chichester 003B","E01031520","15-19 years","Male",56,61,54,48,46,265
"Chichester 003B","E01031520","20-24 years","Male",32,35,43,36,35,181
"Chichester 003B","E01031520","25-29 years","Male",21,20,19,22,20,102
"Chichester 003B","E01031520","30-34 years","Male",19,19,23,21,17,99
"Chichester 003B","E01031520","35-39 years","Male",28,35,35,36,30,164
"Chichester 003B","E01031520","40-44 years","Male",35,25,30,30,34,154
"Chichester 003B","E01031520","45-49 years","Male",55,56,51,47,40,249
"Chichester 003B","E01031520","50-54 years","Male",52,64,61,69,67,313
"Chichester 003B","E01031520","55-59 years","Male",47,43,39,41,49,219
"Chichester 003B","E01031520","60-64 years","Male",42,50,58,50,49,249
"Chichester 003B","E01031520","65-69 years","Male",60,51,46,45,42,244
"Chichester 003B","E01031520","70-74 years","Male",46,42,44,48,44,224
"Chichester 003B","E01031520","75-79 years","Male",36,39,46,47,47,215
"Chichester 003B","E01031520","80-84 years","Male",35,34,33,27,22,151
"Chichester 003B","E01031520","85+ years","Male",36,24,27,31,29,147
"Chichester 003B","E01031520","0-4 years","Female",35,25,26,28,20,134
"Chichester 003B","E01031520","5-9 years","Female",44,40,52,49,40,225
"Chichester 003B","E01031520","10-14 years","Female",40,46,43,38,42,209
"Chichester 003B","E01031520","15-19 years","Female",35,34,36,35,39,179
"Chichester 003B","E01031520","20-24 years","Female",22,28,23,20,16,109
"Chichester 003B","E01031520","25-29 years","Female",20,16,19,20,21,96
"Chichester 003B","E01031520","30-34 years","Female",16,19,16,19,14,84
"Chichester 003B","E01031520","35-39 years","Female",32,28,32,26,29,147
"Chichester 003B","E01031520","40-44 years","Female",38,36,37,41,34,186
"Chichester 003B","E01031520","45-49 years","Female",73,69,67,58,53,320
"Chichester 003B","E01031520","50-54 years","Female",59,63,62,61,63,308
"Chichester 003B","E01031520","55-59 years","Female",46,47,52,54,57,256
"Chichester 003B","E01031520","60-64 years","Female",43,40,44,54,57,238
"Chichester 003B","E01031520","65-69 years","Female",66,64,50,43,35,258
"Chichester 003B","E01031520","70-74 years","Female",43,43,52,54,54,246
"Chichester 003B","E01031520","75-79 years","Female",27,38,35,38,36,174
"Chichester 003B","E01031520","80-84 years","Female",24,22,23,26,26,121
"Chichester 003B","E01031520","85+ years","Female",72,73,68,73,71,357
"Chichester 003C","E01031521","0-4 years","Male",24,20,20,14,14,92
"Chichester 003C","E01031521","5-9 years","Male",43,39,38,27,28,175
"Chichester 003C","E01031521","10-14 years","Male",37,41,38,46,47,209
"Chichester 003C","E01031521","15-19 years","Male",37,30,32,28,34,161
"Chichester 003C","E01031521","20-24 years","Male",18,25,25,26,22,116
"Chichester 003C","E01031521","25-29 years","Male",16,16,22,20,21,95
"Chichester 003C","E01031521","30-34 years","Male",19,22,14,12,11,78
"Chichester 003C","E01031521","35-39 years","Male",22,23,24,19,20,108
"Chichester 003C","E01031521","40-44 years","Male",41,32,34,31,28,166
"Chichester 003C","E01031521","45-49 years","Male",61,59,60,60,60,300
"Chichester 003C","E01031521","50-54 years","Male",51,51,53,52,53,260
"Chichester 003C","E01031521","55-59 years","Male",36,38,39,45,46,204
"Chichester 003C","E01031521","60-64 years","Male",73,70,66,54,49,312
"Chichester 003C","E01031521","65-69 years","Male",46,45,50,58,63,262
"Chichester 003C","E01031521","70-74 years","Male",34,39,37,40,34,184
"Chichester 003C","E01031521","75-79 years","Male",21,21,21,21,26,110
"Chichester 003C","E01031521","80-84 years","Male",17,14,15,19,24,89
"Chichester 003C","E01031521","85+ years","Male",9,11,18,20,18,76
"Chichester 003C","E01031521","0-4 years","Female",20,27,27,28,22,124
"Chichester 003C","E01031521","5-9 years","Female",42,34,44,35,26,181
"Chichester 003C","E01031521","10-14 years","Female",38,37,35,40,38,188
"Chichester 003C","E01031521","15-19 years","Female",39,37,39,38,45,198
"Chichester 003C","E01031521","20-24 years","Female",3,5,6,8,5,27
"Chichester 003C","E01031521","25-29 years","Female",20,21,20,15,25,101
"Chichester 003C","E01031521","30-34 years","Female",20,20,19,24,19,102
"Chichester 003C","E01031521","35-39 years","Female",23,22,21,21,18,105
"Chichester 003C","E01031521","40-44 years","Female",42,35,32,26,28,163
"Chichester 003C","E01031521","45-49 years","Female",47,38,36,37,40,198
"Chichester 003C","E01031521","50-54 years","Female",52,61,71,72,66,322
"Chichester 003C","E01031521","55-59 years","Female",49,41,39,45,43,217
"Chichester 003C","E01031521","60-64 years","Female",48,55,55,44,46,248
"Chichester 003C","E01031521","65-69 years","Female",54,44,44,38,38,218
"Chichester 003C","E01031521","70-74 years","Female",32,37,36,47,46,198
"Chichester 003C","E01031521","75-79 years","Female",25,26,31,29,25,136
"Chichester 003C","E01031521","80-84 years","Female",15,14,15,18,19,81
"Chichester 003C","E01031521","85+ years","Female",11,14,12,9,7,53
"Chichester 003D","E01031536","0-4 years","Male",24,24,27,35,35,145
"Chichester 003D","E01031536","5-9 years","Male",32,31,27,25,26,141
"Chichester 003D","E01031536","10-14 years","Male",57,38,41,43,48,227
"Chichester 003D","E01031536","15-19 years","Male",38,48,33,29,29,177
"Chichester 003D","E01031536","20-24 years","Male",18,19,20,24,23,104
"Chichester 003D","E01031536","25-29 years","Male",16,15,19,20,18,88
"Chichester 003D","E01031536","30-34 years","Male",12,9,10,9,8,48
"Chichester 003D","E01031536","35-39 years","Male",19,18,19,22,22,100
"Chichester 003D","E01031536","40-44 years","Male",28,34,29,34,33,158
"Chichester 003D","E01031536","45-49 years","Male",44,34,34,29,32,173
"Chichester 003D","E01031536","50-54 years","Male",63,66,66,55,53,303
"Chichester 003D","E01031536","55-59 years","Male",47,47,53,51,49,247
"Chichester 003D","E01031536","60-64 years","Male",52,54,48,53,60,267
"Chichester 003D","E01031536","65-69 years","Male",47,46,56,56,59,264
"Chichester 003D","E01031536","70-74 years","Male",29,32,34,38,36,169
"Chichester 003D","E01031536","75-79 years","Male",41,39,32,32,37,181
"Chichester 003D","E01031536","80-84 years","Male",22,18,25,26,30,121
"Chichester 003D","E01031536","85+ years","Male",21,19,19,24,20,103
"Chichester 003D","E01031536","0-4 years","Female",22,15,17,16,15,85
"Chichester 003D","E01031536","5-9 years","Female",26,20,25,24,21,116
"Chichester 003D","E01031536","10-14 years","Female",46,48,47,49,42,232
"Chichester 003D","E01031536","15-19 years","Female",38,31,32,28,32,161
"Chichester 003D","E01031536","20-24 years","Female",11,10,9,10,8,48
"Chichester 003D","E01031536","25-29 years","Female",22,17,24,16,21,100
"Chichester 003D","E01031536","30-34 years","Female",18,15,24,29,24,110
"Chichester 003D","E01031536","35-39 years","Female",20,14,14,14,12,74
"Chichester 003D","E01031536","40-44 years","Female",43,33,35,28,29,168
"Chichester 003D","E01031536","45-49 years","Female",49,45,53,56,56,259
"Chichester 003D","E01031536","50-54 years","Female",63,64,57,57,52,293
"Chichester 003D","E01031536","55-59 years","Female",51,57,55,60,64,287
"Chichester 003D","E01031536","60-64 years","Female",49,54,56,51,50,260
"Chichester 003D","E01031536","65-69 years","Female",49,39,44,46,47,225
"Chichester 003D","E01031536","70-74 years","Female",37,37,44,43,48,209
"Chichester 003D","E01031536","75-79 years","Female",40,47,39,36,38,200
"Chichester 003D","E01031536","80-84 years","Female",14,15,14,20,23,86
"Chichester 003D","E01031536","85+ years","Female",13,12,16,17,17,75
"Chichester 004A","E01031497","0-4 years","Male",36,37,36,43,33,185
"Chichester 004A","E01031497","5-9 years","Male",44,34,35,35,36,184
"Chichester 004A","E01031497","10-14 years","Male",53,55,56,54,56,274
"Chichester 004A","E01031497","15-19 years","Male",34,36,33,33,32,168
"Chichester 004A","E01031497","20-24 years","Male",25,21,16,19,20,101
"Chichester 004A","E01031497","25-29 years","Male",21,23,25,25,19,113
"Chichester 004A","E01031497","30-34 years","Male",39,35,31,33,34,172
"Chichester 004A","E01031497","35-39 years","Male",23,23,24,23,21,114
"Chichester 004A","E01031497","40-44 years","Male",52,49,48,47,45,241
"Chichester 004A","E01031497","45-49 years","Male",44,48,51,57,63,263
"Chichester 004A","E01031497","50-54 years","Male",61,57,58,58,52,286
"Chichester 004A","E01031497","55-59 years","Male",60,70,70,68,68,336
"Chichester 004A","E01031497","60-64 years","Male",51,58,70,58,62,299
"Chichester 004A","E01031497","65-69 years","Male",65,63,57,66,66,317
"Chichester 004A","E01031497","70-74 years","Male",44,42,53,57,61,257
"Chichester 004A","E01031497","75-79 years","Male",34,37,36,49,55,211
"Chichester 004A","E01031497","80-84 years","Male",25,28,24,21,21,119
"Chichester 004A","E01031497","85+ years","Male",15,17,23,22,21,98
"Chichester 004A","E01031497","0-4 years","Female",41,36,37,41,32,187
"Chichester 004A","E01031497","5-9 years","Female",22,32,30,32,36,152
"Chichester 004A","E01031497","10-14 years","Female",39,33,35,26,29,162
"Chichester 004A","E01031497","15-19 years","Female",38,36,31,37,27,169
"Chichester 004A","E01031497","20-24 years","Female",31,31,35,29,32,158
"Chichester 004A","E01031497","25-29 years","Female",29,27,29,34,29,148
"Chichester 004A","E01031497","30-34 years","Female",23,21,20,18,20,102
"Chichester 004A","E01031497","35-39 years","Female",30,30,38,36,29,163
"Chichester 004A","E01031497","40-44 years","Female",48,54,55,50,47,254
"Chichester 004A","E01031497","45-49 years","Female",62,53,57,64,62,298
"Chichester 004A","E01031497","50-54 years","Female",62,61,67,56,59,305
"Chichester 004A","E01031497","55-59 years","Female",44,51,53,63,69,280
"Chichester 004A","E01031497","60-64 years","Female",52,51,60,56,52,271
"Chichester 004A","E01031497","65-69 years","Female",62,56,56,69,72,315
"Chichester 004A","E01031497","70-74 years","Female",37,43,53,57,63,253
"Chichester 004A","E01031497","75-79 years","Female",29,31,33,37,39,169
"Chichester 004A","E01031497","80-84 years","Female",28,26,23,27,28,132
"Chichester 004A","E01031497","85+ years","Female",52,52,50,44,44,242
"Chichester 004C","E01031511","0-4 years","Male",49,37,23,34,35,178
"Chichester 004C","E01031511","5-9 years","Male",32,38,43,38,42,193
"Chichester 004C","E01031511","10-14 years","Male",48,43,44,37,36,208
"Chichester 004C","E01031511","15-19 years","Male",22,19,25,28,29,123
"Chichester 004C","E01031511","20-24 years","Male",17,15,16,15,15,78
"Chichester 004C","E01031511","25-29 years","Male",25,30,22,19,15,111
"Chichester 004C","E01031511","30-34 years","Male",25,24,27,31,32,139
"Chichester 004C","E01031511","35-39 years","Male",31,30,33,31,31,156
"Chichester 004C","E01031511","40-44 years","Male",30,29,26,27,29,141
"Chichester 004C","E01031511","45-49 years","Male",47,46,35,36,33,197
"Chichester 004C","E01031511","50-54 years","Male",52,58,52,50,48,260
"Chichester 004C","E01031511","55-59 years","Male",45,42,48,48,57,240
"Chichester 004C","E01031511","60-64 years","Male",37,44,41,38,40,200
"Chichester 004C","E01031511","65-69 years","Male",43,45,33,33,40,194
"Chichester 004C","E01031511","70-74 years","Male",56,60,67,66,63,312
"Chichester 004C","E01031511","75-79 years","Male",49,49,43,48,51,240
"Chichester 004C","E01031511","80-84 years","Male",36,31,34,32,41,174
"Chichester 004C","E01031511","85+ years","Male",23,23,31,34,28,139
"Chichester 004C","E01031511","0-4 years","Female",31,27,28,28,25,139
"Chichester 004C","E01031511","5-9 years","Female",42,36,51,44,49,222
"Chichester 004C","E01031511","10-14 years","Female",25,33,38,43,44,183
"Chichester 004C","E01031511","15-19 years","Female",17,18,18,16,25,94
"Chichester 004C","E01031511","20-24 years","Female",29,23,23,24,23,122
"Chichester 004C","E01031511","25-29 years","Female",30,33,32,30,28,153
"Chichester 004C","E01031511","30-34 years","Female",35,33,35,44,40,187
"Chichester 004C","E01031511","35-39 years","Female",36,34,38,35,35,178
"Chichester 004C","E01031511","40-44 years","Female",45,41,37,38,44,205
"Chichester 004C","E01031511","45-49 years","Female",52,55,44,36,39,226
"Chichester 004C","E01031511","50-54 years","Female",62,70,78,71,60,341
"Chichester 004C","E01031511","55-59 years","Female",38,30,31,40,44,183
"Chichester 004C","E01031511","60-64 years","Female",50,46,44,39,42,221
"Chichester 004C","E01031511","65-69 years","Female",61,58,61,60,49,289
"Chichester 004C","E01031511","70-74 years","Female",71,75,68,72,75,361
"Chichester 004C","E01031511","75-79 years","Female",69,66,62,66,69,332
"Chichester 004C","E01031511","80-84 years","Female",56,57,58,61,53,285
"Chichester 004C","E01031511","85+ years","Female",65,66,65,58,58,312
"Chichester 004D","E01031512","0-4 years","Male",72,58,53,49,52,284
"Chichester 004D","E01031512","5-9 years","Male",58,68,74,68,62,330
"Chichester 004D","E01031512","10-14 years","Male",50,55,60,78,68,311
"Chichester 004D","E01031512","15-19 years","Male",73,69,60,62,68,332
"Chichester 004D","E01031512","20-24 years","Male",44,46,45,43,46,224
"Chichester 004D","E01031512","25-29 years","Male",61,63,58,56,45,283
"Chichester 004D","E01031512","30-34 years","Male",63,68,69,64,66,330
"Chichester 004D","E01031512","35-39 years","Male",36,33,31,42,47,189
"Chichester 004D","E01031512","40-44 years","Male",50,50,47,42,37,226
"Chichester 004D","E01031512","45-49 years","Male",57,51,56,58,55,277
"Chichester 004D","E01031512","50-54 years","Male",60,62,70,69,71,332
"Chichester 004D","E01031512","55-59 years","Male",52,63,56,60,58,289
"Chichester 004D","E01031512","60-64 years","Male",64,69,66,59,56,314
"Chichester 004D","E01031512","65-69 years","Male",81,71,65,61,57,335
"Chichester 004D","E01031512","70-74 years","Male",42,53,62,61,63,281
"Chichester 004D","E01031512","75-79 years","Male",34,35,29,28,33,159
"Chichester 004D","E01031512","80-84 years","Male",18,17,20,22,21,98
"Chichester 004D","E01031512","85+ years","Male",20,21,20,19,16,96
"Chichester 004D","E01031512","0-4 years","Female",46,49,50,49,46,240
"Chichester 004D","E01031512","5-9 years","Female",78,67,75,78,77,375
"Chichester 004D","E01031512","10-14 years","Female",43,60,58,60,63,284
"Chichester 004D","E01031512","15-19 years","Female",55,52,51,57,48,263
"Chichester 004D","E01031512","20-24 years","Female",32,32,35,36,37,172
"Chichester 004D","E01031512","25-29 years","Female",70,67,59,55,49,300
"Chichester 004D","E01031512","30-34 years","Female",58,60,79,72,74,343
"Chichester 004D","E01031512","35-39 years","Female",58,56,55,58,56,283
"Chichester 004D","E01031512","40-44 years","Female",57,57,53,47,49,263
"Chichester 004D","E01031512","45-49 years","Female",75,66,64,72,70,347
"Chichester 004D","E01031512","50-54 years","Female",60,66,69,67,75,337
"Chichester 004D","E01031512","55-59 years","Female",76,69,69,69,64,347
"Chichester 004D","E01031512","60-64 years","Female",71,71,76,68,75,361
"Chichester 004D","E01031512","65-69 years","Female",85,80,70,75,63,373
"Chichester 004D","E01031512","70-74 years","Female",57,66,69,78,86,356
"Chichester 004D","E01031512","75-79 years","Female",51,48,54,47,53,253
"Chichester 004D","E01031512","80-84 years","Female",32,38,32,34,34,170
"Chichester 004D","E01031512","85+ years","Female",43,40,42,41,40,206
"Chichester 004F","E01032717","0-4 years","Male",61,79,70,77,65,352
"Chichester 004F","E01032717","5-9 years","Male",84,87,104,103,103,481
"Chichester 004F","E01032717","10-14 years","Male",54,61,62,65,72,314
"Chichester 004F","E01032717","15-19 years","Male",49,38,42,39,41,209
"Chichester 004F","E01032717","20-24 years","Male",55,51,46,34,37,223
"Chichester 004F","E01032717","25-29 years","Male",52,56,59,70,58,295
"Chichester 004F","E01032717","30-34 years","Male",60,65,70,69,67,331
"Chichester 004F","E01032717","35-39 years","Male",35,46,43,40,48,212
"Chichester 004F","E01032717","40-44 years","Male",66,59,61,56,59,301
"Chichester 004F","E01032717","45-49 years","Male",88,88,93,86,75,430
"Chichester 004F","E01032717","50-54 years","Male",126,125,109,110,114,584
"Chichester 004F","E01032717","55-59 years","Male",75,76,106,108,117,482
"Chichester 004F","E01032717","60-64 years","Male",110,117,108,104,103,542
"Chichester 004F","E01032717","65-69 years","Male",115,102,107,120,121,565
"Chichester 004F","E01032717","70-74 years","Male",77,85,80,91,89,422
"Chichester 004F","E01032717","75-79 years","Male",79,89,93,80,78,419
"Chichester 004F","E01032717","80-84 years","Male",49,47,60,65,69,290
"Chichester 004F","E01032717","85+ years","Male",40,42,40,47,45,214
"Chichester 004F","E01032717","0-4 years","Female",67,69,68,55,59,318
"Chichester 004F","E01032717","5-9 years","Female",72,69,75,81,77,374
"Chichester 004F","E01032717","10-14 years","Female",63,64,66,72,77,342
"Chichester 004F","E01032717","15-19 years","Female",54,52,57,64,68,295
"Chichester 004F","E01032717","20-24 years","Female",45,49,51,48,49,242
"Chichester 004F","E01032717","25-29 years","Female",57,59,47,54,50,267
"Chichester 004F","E01032717","30-34 years","Female",59,71,74,65,61,330
"Chichester 004F","E01032717","35-39 years","Female",70,67,72,66,55,330
"Chichester 004F","E01032717","40-44 years","Female",73,69,57,67,68,334
"Chichester 004F","E01032717","45-49 years","Female",99,109,96,83,84,471
"Chichester 004F","E01032717","50-54 years","Female",110,112,123,123,113,581
"Chichester 004F","E01032717","55-59 years","Female",101,121,119,120,133,594
"Chichester 004F","E01032717","60-64 years","Female",110,102,111,115,118,556
"Chichester 004F","E01032717","65-69 years","Female",131,137,118,118,113,617
"Chichester 004F","E01032717","70-74 years","Female",109,122,127,115,119,592
"Chichester 004F","E01032717","75-79 years","Female",92,94,97,108,113,504
"Chichester 004F","E01032717","80-84 years","Female",77,90,94,94,97,452
"Chichester 004F","E01032717","85+ years","Female",106,95,106,108,110,525
"Chichester 005A","E01031478","0-4 years","Male",22,26,31,21,27,127
"Chichester 005A","E01031478","5-9 years","Male",18,18,22,27,31,116
"Chichester 005A","E01031478","10-14 years","Male",43,34,28,28,30,163
"Chichester 005A","E01031478","15-19 years","Male",63,62,62,67,52,306
"Chichester 005A","E01031478","20-24 years","Male",20,12,16,17,21,86
"Chichester 005A","E01031478","25-29 years","Male",18,18,16,14,20,86
"Chichester 005A","E01031478","30-34 years","Male",11,11,10,8,11,51
"Chichester 005A","E01031478","35-39 years","Male",20,25,22,24,21,112
"Chichester 005A","E01031478","40-44 years","Male",24,21,24,19,20,108
"Chichester 005A","E01031478","45-49 years","Male",42,38,44,38,38,200
"Chichester 005A","E01031478","50-54 years","Male",55,51,41,48,49,244
"Chichester 005A","E01031478","55-59 years","Male",41,37,45,37,36,196
"Chichester 005A","E01031478","60-64 years","Male",48,49,45,47,50,239
"Chichester 005A","E01031478","65-69 years","Male",43,40,36,41,41,201
"Chichester 005A","E01031478","70-74 years","Male",54,58,55,51,48,266
"Chichester 005A","E01031478","75-79 years","Male",24,27,31,33,37,152
"Chichester 005A","E01031478","80-84 years","Male",18,17,17,14,12,78
"Chichester 005A","E01031478","85+ years","Male",13,18,20,23,21,95
"Chichester 005A","E01031478","0-4 years","Female",16,18,16,11,11,72
"Chichester 005A","E01031478","5-9 years","Female",24,19,18,16,14,91
"Chichester 005A","E01031478","10-14 years","Female",35,38,45,42,46,206
"Chichester 005A","E01031478","15-19 years","Female",56,48,50,43,41,238
"Chichester 005A","E01031478","20-24 years","Female",12,13,15,18,16,74
"Chichester 005A","E01031478","25-29 years","Female",10,7,7,5,8,37
"Chichester 005A","E01031478","30-34 years","Female",7,10,8,9,11,45
"Chichester 005A","E01031478","35-39 years","Female",23,33,35,28,26,145
"Chichester 005A","E01031478","40-44 years","Female",30,25,24,17,23,119
"Chichester 005A","E01031478","45-49 years","Female",31,19,19,18,18,105
"Chichester 005A","E01031478","50-54 years","Female",55,63,60,53,43,274
"Chichester 005A","E01031478","55-59 years","Female",48,51,48,52,53,252
"Chichester 005A","E01031478","60-64 years","Female",45,45,50,47,42,229
"Chichester 005A","E01031478","65-69 years","Female",57,50,46,52,58,263
"Chichester 005A","E01031478","70-74 years","Female",38,45,50,49,45,227
"Chichester 005A","E01031478","75-79 years","Female",36,43,43,40,35,197
"Chichester 005A","E01031478","80-84 years","Female",27,27,24,26,30,134
"Chichester 005A","E01031478","85+ years","Female",13,16,19,14,16,78
"Chichester 005B","E01031479","0-4 years","Male",26,18,21,21,18,104
"Chichester 005B","E01031479","5-9 years","Male",19,22,17,16,17,91
"Chichester 005B","E01031479","10-14 years","Male",42,42,46,41,47,218
"Chichester 005B","E01031479","15-19 years","Male",20,23,17,22,28,110
"Chichester 005B","E01031479","20-24 years","Male",10,8,12,9,9,48
"Chichester 005B","E01031479","25-29 years","Male",10,13,10,10,7,50
"Chichester 005B","E01031479","30-34 years","Male",8,6,5,5,6,30
"Chichester 005B","E01031479","35-39 years","Male",20,19,20,25,24,108
"Chichester 005B","E01031479","40-44 years","Male",23,19,14,17,15,88
"Chichester 005B","E01031479","45-49 years","Male",32,32,28,27,28,147
"Chichester 005B","E01031479","50-54 years","Male",50,50,45,46,42,233
"Chichester 005B","E01031479","55-59 years","Male",35,39,45,39,51,209
"Chichester 005B","E01031479","60-64 years","Male",39,37,33,32,26,167
"Chichester 005B","E01031479","65-69 years","Male",52,50,47,49,45,243
"Chichester 005B","E01031479","70-74 years","Male",36,36,47,41,41,201
"Chichester 005B","E01031479","75-79 years","Male",17,21,20,23,28,109
"Chichester 005B","E01031479","80-84 years","Male",13,15,14,18,23,83
"Chichester 005B","E01031479","85+ years","Male",24,19,22,27,20,112
"Chichester 005B","E01031479","0-4 years","Female",13,22,23,22,19,99
"Chichester 005B","E01031479","5-9 years","Female",22,16,7,8,13,66
"Chichester 005B","E01031479","10-14 years","Female",21,25,28,28,24,126
"Chichester 005B","E01031479","15-19 years","Female",17,15,13,13,12,70
"Chichester 005B","E01031479","20-24 years","Female",18,13,8,5,7,51
"Chichester 005B","E01031479","25-29 years","Female",27,34,33,31,24,149
"Chichester 005B","E01031479","30-34 years","Female",16,17,10,10,13,66
"Chichester 005B","E01031479","35-39 years","Female",18,18,15,21,14,86
"Chichester 005B","E01031479","40-44 years","Female",35,35,36,31,29,166
"Chichester 005B","E01031479","45-49 years","Female",39,37,33,28,34,171
"Chichester 005B","E01031479","50-54 years","Female",44,51,41,42,37,215
"Chichester 005B","E01031479","55-59 years","Female",33,35,41,40,50,199
"Chichester 005B","E01031479","60-64 years","Female",43,39,38,36,37,193
"Chichester 005B","E01031479","65-69 years","Female",68,60,63,50,52,293
"Chichester 005B","E01031479","70-74 years","Female",39,55,56,65,57,272
"Chichester 005B","E01031479","75-79 years","Female",28,23,29,32,35,147
"Chichester 005B","E01031479","80-84 years","Female",21,27,29,22,26,125
"Chichester 005B","E01031479","85+ years","Female",46,45,52,53,49,245
"Chichester 005C","E01031498","0-4 years","Male",22,24,16,11,11,84
"Chichester 005C","E01031498","5-9 years","Male",24,25,31,30,26,136
"Chichester 005C","E01031498","10-14 years","Male",35,29,24,25,26,139
"Chichester 005C","E01031498","15-19 years","Male",32,30,33,29,31,155
"Chichester 005C","E01031498","20-24 years","Male",23,24,29,29,27,132
"Chichester 005C","E01031498","25-29 years","Male",22,25,27,27,22,123
"Chichester 005C","E01031498","30-34 years","Male",16,14,11,11,15,67
"Chichester 005C","E01031498","35-39 years","Male",22,22,25,19,20,108
"Chichester 005C","E01031498","40-44 years","Male",20,20,23,22,21,106
"Chichester 005C","E01031498","45-49 years","Male",43,41,35,38,35,192
"Chichester 005C","E01031498","50-54 years","Male",62,59,64,51,41,277
"Chichester 005C","E01031498","55-59 years","Male",47,51,51,49,51,249
"Chichester 005C","E01031498","60-64 years","Male",30,27,22,30,34,143
"Chichester 005C","E01031498","65-69 years","Male",39,40,34,34,30,177
"Chichester 005C","E01031498","70-74 years","Male",37,31,38,36,36,178
"Chichester 005C","E01031498","75-79 years","Male",18,20,23,29,29,119
"Chichester 005C","E01031498","80-84 years","Male",22,20,15,14,15,86
"Chichester 005C","E01031498","85+ years","Male",11,14,16,14,11,66
"Chichester 005C","E01031498","0-4 years","Female",19,19,23,11,13,85
"Chichester 005C","E01031498","5-9 years","Female",39,41,40,32,30,182
"Chichester 005C","E01031498","10-14 years","Female",46,40,40,54,53,233
"Chichester 005C","E01031498","15-19 years","Female",34,34,28,31,36,163
"Chichester 005C","E01031498","20-24 years","Female",19,14,10,11,15,69
"Chichester 005C","E01031498","25-29 years","Female",16,15,11,10,13,65
"Chichester 005C","E01031498","30-34 years","Female",16,21,21,14,13,85
"Chichester 005C","E01031498","35-39 years","Female",24,26,30,29,26,135
"Chichester 005C","E01031498","40-44 years","Female",39,30,32,31,26,158
"Chichester 005C","E01031498","45-49 years","Female",51,53,49,48,55,256
"Chichester 005C","E01031498","50-54 years","Female",51,45,44,44,41,225
"Chichester 005C","E01031498","55-59 years","Female",52,58,55,54,50,269
"Chichester 005C","E01031498","60-64 years","Female",42,37,43,43,47,212
"Chichester 005C","E01031498","65-69 years","Female",38,39,39,39,33,188
"Chichester 005C","E01031498","70-74 years","Female",35,31,35,39,48,188
"Chichester 005C","E01031498","75-79 years","Female",17,18,20,21,23,99
"Chichester 005C","E01031498","80-84 years","Female",30,28,30,29,20,137
"Chichester 005C","E01031498","85+ years","Female",24,33,31,31,28,147
"Chichester 005D","E01031514","0-4 years","Male",38,34,33,31,32,168
"Chichester 005D","E01031514","5-9 years","Male",58,63,58,52,53,284
"Chichester 005D","E01031514","10-14 years","Male",44,41,46,49,52,232
"Chichester 005D","E01031514","15-19 years","Male",40,37,29,33,31,170
"Chichester 005D","E01031514","20-24 years","Male",28,23,31,31,33,146
"Chichester 005D","E01031514","25-29 years","Male",26,29,30,30,26,141
"Chichester 005D","E01031514","30-34 years","Male",28,22,22,21,20,113
"Chichester 005D","E01031514","35-39 years","Male",33,38,39,38,36,184
"Chichester 005D","E01031514","40-44 years","Male",45,37,29,31,29,171
"Chichester 005D","E01031514","45-49 years","Male",67,77,70,66,51,331
"Chichester 005D","E01031514","50-54 years","Male",49,48,55,56,70,278
"Chichester 005D","E01031514","55-59 years","Male",75,65,53,62,62,317
"Chichester 005D","E01031514","60-64 years","Male",60,64,70,74,75,343
"Chichester 005D","E01031514","65-69 years","Male",61,55,56,55,60,287
"Chichester 005D","E01031514","70-74 years","Male",65,72,66,69,75,347
"Chichester 005D","E01031514","75-79 years","Male",43,40,46,50,47,226
"Chichester 005D","E01031514","80-84 years","Male",53,52,45,45,41,236
"Chichester 005D","E01031514","85+ years","Male",55,49,48,45,47,244
"Chichester 005D","E01031514","0-4 years","Female",24,18,16,18,21,97
"Chichester 005D","E01031514","5-9 years","Female",45,52,40,41,35,213
"Chichester 005D","E01031514","10-14 years","Female",27,26,29,28,31,141
"Chichester 005D","E01031514","15-19 years","Female",42,44,38,30,32,186
"Chichester 005D","E01031514","20-24 years","Female",29,26,33,33,33,154
"Chichester 005D","E01031514","25-29 years","Female",29,26,28,26,24,133
"Chichester 005D","E01031514","30-34 years","Female",40,31,34,30,30,165
"Chichester 005D","E01031514","35-39 years","Female",35,41,41,42,36,195
"Chichester 005D","E01031514","40-44 years","Female",42,42,39,35,36,194
"Chichester 005D","E01031514","45-49 years","Female",75,74,72,70,71,362
"Chichester 005D","E01031514","50-54 years","Female",61,62,69,68,73,333
"Chichester 005D","E01031514","55-59 years","Female",45,47,47,44,44,227
"Chichester 005D","E01031514","60-64 years","Female",60,64,67,64,78,333
"Chichester 005D","E01031514","65-69 years","Female",70,67,57,52,42,288
"Chichester 005D","E01031514","70-74 years","Female",75,78,86,92,91,422
"Chichester 005D","E01031514","75-79 years","Female",63,61,64,72,75,335
"Chichester 005D","E01031514","80-84 years","Female",76,68,64,60,70,338
"Chichester 005D","E01031514","85+ years","Female",127,100,94,102,100,523
"Chichester 005E","E01031515","0-4 years","Male",51,51,52,41,41,236
"Chichester 005E","E01031515","5-9 years","Male",44,47,53,56,55,255
"Chichester 005E","E01031515","10-14 years","Male",52,57,52,63,78,302
"Chichester 005E","E01031515","15-19 years","Male",40,35,38,34,28,175
"Chichester 005E","E01031515","20-24 years","Male",35,33,36,38,33,175
"Chichester 005E","E01031515","25-29 years","Male",37,36,30,31,34,168
"Chichester 005E","E01031515","30-34 years","Male",35,40,44,47,45,211
"Chichester 005E","E01031515","35-39 years","Male",40,32,32,28,31,163
"Chichester 005E","E01031515","40-44 years","Male",39,41,36,39,38,193
"Chichester 005E","E01031515","45-49 years","Male",61,62,68,58,49,298
"Chichester 005E","E01031515","50-54 years","Male",51,48,44,51,49,243
"Chichester 005E","E01031515","55-59 years","Male",54,50,58,56,53,271
"Chichester 005E","E01031515","60-64 years","Male",39,40,44,50,53,226
"Chichester 005E","E01031515","65-69 years","Male",55,48,47,40,41,231
"Chichester 005E","E01031515","70-74 years","Male",46,43,43,45,52,229
"Chichester 005E","E01031515","75-79 years","Male",43,51,52,52,41,239
"Chichester 005E","E01031515","80-84 years","Male",19,16,21,24,27,107
"Chichester 005E","E01031515","85+ years","Male",22,25,18,26,28,119
"Chichester 005E","E01031515","0-4 years","Female",54,57,59,55,63,288
"Chichester 005E","E01031515","5-9 years","Female",61,57,58,54,52,282
"Chichester 005E","E01031515","10-14 years","Female",49,46,44,51,50,240
"Chichester 005E","E01031515","15-19 years","Female",38,33,29,25,26,151
"Chichester 005E","E01031515","20-24 years","Female",36,32,32,36,30,166
"Chichester 005E","E01031515","25-29 years","Female",45,47,43,44,39,218
"Chichester 005E","E01031515","30-34 years","Female",42,46,45,51,49,233
"Chichester 005E","E01031515","35-39 years","Female",59,58,58,52,51,278
"Chichester 005E","E01031515","40-44 years","Female",47,46,41,49,47,230
"Chichester 005E","E01031515","45-49 years","Female",64,54,58,52,63,291
"Chichester 005E","E01031515","50-54 years","Female",70,68,60,64,54,316
"Chichester 005E","E01031515","55-59 years","Female",45,48,61,62,60,276
"Chichester 005E","E01031515","60-64 years","Female",46,52,53,52,51,254
"Chichester 005E","E01031515","65-69 years","Female",66,55,48,46,45,260
"Chichester 005E","E01031515","70-74 years","Female",44,54,61,64,67,290
"Chichester 005E","E01031515","75-79 years","Female",40,36,28,31,29,164
"Chichester 005E","E01031515","80-84 years","Female",17,27,27,27,30,128
"Chichester 005E","E01031515","85+ years","Female",10,27,29,32,26,124
"Chichester 005F","E01031516","0-4 years","Male",36,33,26,26,21,142
"Chichester 005F","E01031516","5-9 years","Male",39,36,45,45,48,213
"Chichester 005F","E01031516","10-14 years","Male",38,43,45,42,46,214
"Chichester 005F","E01031516","15-19 years","Male",29,25,24,23,21,122
"Chichester 005F","E01031516","20-24 years","Male",29,30,30,34,28,151
"Chichester 005F","E01031516","25-29 years","Male",21,26,28,29,26,130
"Chichester 005F","E01031516","30-34 years","Male",15,15,19,20,18,87
"Chichester 005F","E01031516","35-39 years","Male",24,33,33,31,29,150
"Chichester 005F","E01031516","40-44 years","Male",34,29,32,28,28,151
"Chichester 005F","E01031516","45-49 years","Male",44,38,30,24,26,162
"Chichester 005F","E01031516","50-54 years","Male",65,64,64,65,54,312
"Chichester 005F","E01031516","55-59 years","Male",73,82,79,71,78,383
"Chichester 005F","E01031516","60-64 years","Male",61,62,60,68,70,321
"Chichester 005F","E01031516","65-69 years","Male",66,64,66,65,59,320
"Chichester 005F","E01031516","70-74 years","Male",52,53,48,51,55,259
"Chichester 005F","E01031516","75-79 years","Male",37,45,56,56,55,249
"Chichester 005F","E01031516","80-84 years","Male",18,17,16,21,26,98
"Chichester 005F","E01031516","85+ years","Male",19,14,14,13,13,73
"Chichester 005F","E01031516","0-4 years","Female",26,22,18,19,26,111
"Chichester 005F","E01031516","5-9 years","Female",29,30,32,31,25,147
"Chichester 005F","E01031516","10-14 years","Female",39,38,40,33,35,185
"Chichester 005F","E01031516","15-19 years","Female",37,40,39,41,41,198
"Chichester 005F","E01031516","20-24 years","Female",24,20,24,16,18,102
"Chichester 005F","E01031516","25-29 years","Female",24,30,28,27,23,132
"Chichester 005F","E01031516","30-34 years","Female",30,26,34,31,31,152
"Chichester 005F","E01031516","35-39 years","Female",20,20,20,24,22,106
"Chichester 005F","E01031516","40-44 years","Female",47,44,38,28,27,184
"Chichester 005F","E01031516","45-49 years","Female",57,57,54,55,59,282
"Chichester 005F","E01031516","50-54 years","Female",73,78,71,66,55,343
"Chichester 005F","E01031516","55-59 years","Female",68,60,73,78,88,367
"Chichester 005F","E01031516","60-64 years","Female",72,76,64,74,71,357
"Chichester 005F","E01031516","65-69 years","Female",76,54,63,60,65,318
"Chichester 005F","E01031516","70-74 years","Female",52,59,56,61,59,287
"Chichester 005F","E01031516","75-79 years","Female",32,41,41,45,52,211
"Chichester 005F","E01031516","80-84 years","Female",18,19,28,28,33,126
"Chichester 005F","E01031516","85+ years","Female",21,24,28,20,16,109
"Chichester 006A","E01031477","0-4 years","Male",58,63,60,57,55,293
"Chichester 006A","E01031477","5-9 years","Male",59,54,62,60,64,299
"Chichester 006A","E01031477","10-14 years","Male",52,54,48,52,57,263
"Chichester 006A","E01031477","15-19 years","Male",55,51,51,54,44,255
"Chichester 006A","E01031477","20-24 years","Male",44,35,36,33,34,182
"Chichester 006A","E01031477","25-29 years","Male",50,58,66,64,66,304
"Chichester 006A","E01031477","30-34 years","Male",40,34,33,29,32,168
"Chichester 006A","E01031477","35-39 years","Male",33,42,39,44,47,205
"Chichester 006A","E01031477","40-44 years","Male",54,41,48,49,53,245
"Chichester 006A","E01031477","45-49 years","Male",76,74,66,63,51,330
"Chichester 006A","E01031477","50-54 years","Male",87,97,107,98,103,492
"Chichester 006A","E01031477","55-59 years","Male",73,75,71,68,75,362
"Chichester 006A","E01031477","60-64 years","Male",86,78,94,101,98,457
"Chichester 006A","E01031477","65-69 years","Male",92,91,76,87,95,441
"Chichester 006A","E01031477","70-74 years","Male",48,50,64,61,63,286
"Chichester 006A","E01031477","75-79 years","Male",67,59,52,49,53,280
"Chichester 006A","E01031477","80-84 years","Male",37,39,40,40,41,197
"Chichester 006A","E01031477","85+ years","Male",25,33,40,37,37,172
"Chichester 006A","E01031477","0-4 years","Female",39,36,41,36,45,197
"Chichester 006A","E01031477","5-9 years","Female",68,63,53,49,48,281
"Chichester 006A","E01031477","10-14 years","Female",59,61,60,62,60,302
"Chichester 006A","E01031477","15-19 years","Female",36,35,36,42,47,196
"Chichester 006A","E01031477","20-24 years","Female",46,42,28,30,24,170
"Chichester 006A","E01031477","25-29 years","Female",42,44,46,42,42,216
"Chichester 006A","E01031477","30-34 years","Female",45,46,43,39,42,215
"Chichester 006A","E01031477","35-39 years","Female",48,50,53,55,55,261
"Chichester 006A","E01031477","40-44 years","Female",52,42,42,35,42,213
"Chichester 006A","E01031477","45-49 years","Female",102,94,88,89,78,451
"Chichester 006A","E01031477","50-54 years","Female",84,88,101,89,97,459
"Chichester 006A","E01031477","55-59 years","Female",100,94,94,108,95,491
"Chichester 006A","E01031477","60-64 years","Female",91,92,82,91,98,454
"Chichester 006A","E01031477","65-69 years","Female",94,86,92,90,94,456
"Chichester 006A","E01031477","70-74 years","Female",75,82,89,87,81,414
"Chichester 006A","E01031477","75-79 years","Female",71,70,72,70,59,342
"Chichester 006A","E01031477","80-84 years","Female",52,42,39,44,56,233
"Chichester 006A","E01031477","85+ years","Female",58,70,67,64,60,319
"Chichester 006B","E01031485","0-4 years","Male",19,21,19,18,22,99
"Chichester 006B","E01031485","5-9 years","Male",40,45,52,50,42,229
"Chichester 006B","E01031485","10-14 years","Male",36,35,34,39,43,187
"Chichester 006B","E01031485","15-19 years","Male",43,40,34,30,31,178
"Chichester 006B","E01031485","20-24 years","Male",26,27,31,29,26,139
"Chichester 006B","E01031485","25-29 years","Male",40,43,34,36,29,182
"Chichester 006B","E01031485","30-34 years","Male",18,26,27,29,31,131
"Chichester 006B","E01031485","35-39 years","Male",16,12,11,14,15,68
"Chichester 006B","E01031485","40-44 years","Male",30,31,30,24,26,141
"Chichester 006B","E01031485","45-49 years","Male",37,35,35,35,31,173
"Chichester 006B","E01031485","50-54 years","Male",49,51,42,45,46,233
"Chichester 006B","E01031485","55-59 years","Male",60,60,63,47,46,276
"Chichester 006B","E01031485","60-64 years","Male",49,63,56,66,60,294
"Chichester 006B","E01031485","65-69 years","Male",55,58,55,47,52,267
"Chichester 006B","E01031485","70-74 years","Male",45,40,43,49,52,229
"Chichester 006B","E01031485","75-79 years","Male",46,47,53,52,45,243
"Chichester 006B","E01031485","80-84 years","Male",56,49,48,44,46,243
"Chichester 006B","E01031485","85+ years","Male",53,56,57,58,60,284
"Chichester 006B","E01031485","0-4 years","Female",30,23,22,35,42,152
"Chichester 006B","E01031485","5-9 years","Female",26,30,24,31,29,140
"Chichester 006B","E01031485","10-14 years","Female",41,40,36,29,35,181
"Chichester 006B","E01031485","15-19 years","Female",39,34,39,37,35,184
"Chichester 006B","E01031485","20-24 years","Female",28,36,29,35,37,165
"Chichester 006B","E01031485","25-29 years","Female",22,20,18,18,17,95
"Chichester 006B","E01031485","30-34 years","Female",19,17,16,18,17,87
"Chichester 006B","E01031485","35-39 years","Female",23,23,24,26,34,130
"Chichester 006B","E01031485","40-44 years","Female",38,33,35,35,31,172
"Chichester 006B","E01031485","45-49 years","Female",51,49,44,43,42,229
"Chichester 006B","E01031485","50-54 years","Female",53,61,72,62,61,309
"Chichester 006B","E01031485","55-59 years","Female",60,67,62,57,51,297
"Chichester 006B","E01031485","60-64 years","Female",61,55,54,57,67,294
"Chichester 006B","E01031485","65-69 years","Female",68,66,57,56,48,295
"Chichester 006B","E01031485","70-74 years","Female",69,66,71,77,73,356
"Chichester 006B","E01031485","75-79 years","Female",75,78,70,61,61,345
"Chichester 006B","E01031485","80-84 years","Female",56,56,64,68,66,310
"Chichester 006B","E01031485","85+ years","Female",53,45,47,51,56,252
"Chichester 006C","E01031487","0-4 years","Male",29,32,28,27,21,137
"Chichester 006C","E01031487","5-9 years","Male",50,44,49,58,54,255
"Chichester 006C","E01031487","10-14 years","Male",34,36,33,29,32,164
"Chichester 006C","E01031487","15-19 years","Male",38,38,42,36,35,189
"Chichester 006C","E01031487","20-24 years","Male",81,76,69,60,42,328
"Chichester 006C","E01031487","25-29 years","Male",27,33,37,37,34,168
"Chichester 006C","E01031487","30-34 years","Male",27,32,36,30,29,154
"Chichester 006C","E01031487","35-39 years","Male",18,15,15,12,14,74
"Chichester 006C","E01031487","40-44 years","Male",34,35,30,26,28,153
"Chichester 006C","E01031487","45-49 years","Male",40,44,42,43,38,207
"Chichester 006C","E01031487","50-54 years","Male",26,24,26,23,25,124
"Chichester 006C","E01031487","55-59 years","Male",40,43,44,40,39,206
"Chichester 006C","E01031487","60-64 years","Male",53,56,50,59,54,272
"Chichester 006C","E01031487","65-69 years","Male",63,55,63,58,61,300
"Chichester 006C","E01031487","70-74 years","Male",66,66,69,65,65,331
"Chichester 006C","E01031487","75-79 years","Male",51,51,53,64,60,279
"Chichester 006C","E01031487","80-84 years","Male",28,30,25,28,30,141
"Chichester 006C","E01031487","85+ years","Male",43,51,53,48,52,247
"Chichester 006C","E01031487","0-4 years","Female",28,49,40,30,38,185
"Chichester 006C","E01031487","5-9 years","Female",27,25,22,24,26,124
"Chichester 006C","E01031487","10-14 years","Female",33,36,32,40,37,178
"Chichester 006C","E01031487","15-19 years","Female",45,42,34,28,40,189
"Chichester 006C","E01031487","20-24 years","Female",51,47,57,44,42,241
"Chichester 006C","E01031487","25-29 years","Female",19,20,19,24,27,109
"Chichester 006C","E01031487","30-34 years","Female",19,25,15,9,7,75
"Chichester 006C","E01031487","35-39 years","Female",24,29,28,27,26,134
"Chichester 006C","E01031487","40-44 years","Female",39,42,32,31,31,175
"Chichester 006C","E01031487","45-49 years","Female",54,51,60,48,44,257
"Chichester 006C","E01031487","50-54 years","Female",51,46,38,36,37,208
"Chichester 006C","E01031487","55-59 years","Female",47,44,50,49,46,236
"Chichester 006C","E01031487","60-64 years","Female",54,58,53,59,67,291
"Chichester 006C","E01031487","65-69 years","Female",87,78,69,62,68,364
"Chichester 006C","E01031487","70-74 years","Female",70,73,79,84,78,384
"Chichester 006C","E01031487","75-79 years","Female",59,62,65,57,64,307
"Chichester 006C","E01031487","80-84 years","Female",40,35,42,54,52,223
"Chichester 006C","E01031487","85+ years","Female",54,56,54,57,53,274
"Chichester 006D","E01031509","0-4 years","Male",68,61,66,69,71,335
"Chichester 006D","E01031509","5-9 years","Male",73,81,82,89,97,422
"Chichester 006D","E01031509","10-14 years","Male",47,53,71,64,86,321
"Chichester 006D","E01031509","15-19 years","Male",83,68,63,70,72,356
"Chichester 006D","E01031509","20-24 years","Male",49,57,55,50,52,263
"Chichester 006D","E01031509","25-29 years","Male",58,65,60,63,61,307
"Chichester 006D","E01031509","30-34 years","Male",52,48,54,53,44,251
"Chichester 006D","E01031509","35-39 years","Male",66,66,68,70,80,350
"Chichester 006D","E01031509","40-44 years","Male",75,79,78,72,63,367
"Chichester 006D","E01031509","45-49 years","Male",84,74,91,85,93,427
"Chichester 006D","E01031509","50-54 years","Male",108,106,91,81,80,466
"Chichester 006D","E01031509","55-59 years","Male",105,98,97,106,111,517
"Chichester 006D","E01031509","60-64 years","Male",72,87,111,119,128,517
"Chichester 006D","E01031509","65-69 years","Male",80,87,79,74,74,394
"Chichester 006D","E01031509","70-74 years","Male",66,63,79,80,86,374
"Chichester 006D","E01031509","75-79 years","Male",51,69,67,72,66,325
"Chichester 006D","E01031509","80-84 years","Male",49,45,43,47,48,232
"Chichester 006D","E01031509","85+ years","Male",26,28,27,32,40,153
"Chichester 006D","E01031509","0-4 years","Female",68,80,79,91,89,407
"Chichester 006D","E01031509","5-9 years","Female",70,56,70,69,78,343
"Chichester 006D","E01031509","10-14 years","Female",90,86,82,77,84,419
"Chichester 006D","E01031509","15-19 years","Female",60,61,61,60,64,306
"Chichester 006D","E01031509","20-24 years","Female",63,69,64,55,48,299
"Chichester 006D","E01031509","25-29 years","Female",74,62,65,59,68,328
"Chichester 006D","E01031509","30-34 years","Female",44,54,65,62,59,284
"Chichester 006D","E01031509","35-39 years","Female",74,72,65,72,80,363
"Chichester 006D","E01031509","40-44 years","Female",88,94,94,83,92,451
"Chichester 006D","E01031509","45-49 years","Female",103,90,96,103,100,492
"Chichester 006D","E01031509","50-54 years","Female",113,117,120,112,111,573
"Chichester 006D","E01031509","55-59 years","Female",131,136,127,117,121,632
"Chichester 006D","E01031509","60-64 years","Female",96,104,104,118,124,546
"Chichester 006D","E01031509","65-69 years","Female",95,92,104,97,102,490
"Chichester 006D","E01031509","70-74 years","Female",93,100,98,110,126,527
"Chichester 006D","E01031509","75-79 years","Female",54,56,64,64,64,302
"Chichester 006D","E01031509","80-84 years","Female",53,52,52,47,45,249
"Chichester 006D","E01031509","85+ years","Female",41,55,59,65,68,288
"Chichester 007A","E01031506","0-4 years","Male",37,31,26,21,23,138
"Chichester 007A","E01031506","5-9 years","Male",34,44,42,44,45,209
"Chichester 007A","E01031506","10-14 years","Male",40,45,41,35,39,200
"Chichester 007A","E01031506","15-19 years","Male",37,35,38,38,34,182
"Chichester 007A","E01031506","20-24 years","Male",19,22,26,23,19,109
"Chichester 007A","E01031506","25-29 years","Male",4,5,5,6,8,28
"Chichester 007A","E01031506","30-34 years","Male",14,12,9,10,10,55
"Chichester 007A","E01031506","35-39 years","Male",27,25,26,22,23,123
"Chichester 007A","E01031506","40-44 years","Male",27,30,26,20,18,121
"Chichester 007A","E01031506","45-49 years","Male",46,45,45,47,44,227
"Chichester 007A","E01031506","50-54 years","Male",70,60,49,47,44,270
"Chichester 007A","E01031506","55-59 years","Male",49,57,69,71,70,316
"Chichester 007A","E01031506","60-64 years","Male",44,40,38,37,39,198
"Chichester 007A","E01031506","65-69 years","Male",44,50,49,47,54,244
"Chichester 007A","E01031506","70-74 years","Male",58,63,65,61,63,310
"Chichester 007A","E01031506","75-79 years","Male",36,39,40,54,46,215
"Chichester 007A","E01031506","80-84 years","Male",26,23,21,25,25,120
"Chichester 007A","E01031506","85+ years","Male",25,22,26,30,28,131
"Chichester 007A","E01031506","0-4 years","Female",16,18,19,25,30,108
"Chichester 007A","E01031506","5-9 years","Female",29,29,29,19,20,126
"Chichester 007A","E01031506","10-14 years","Female",37,40,33,38,35,183
"Chichester 007A","E01031506","15-19 years","Female",40,34,31,30,30,165
"Chichester 007A","E01031506","20-24 years","Female",17,17,15,18,19,86
"Chichester 007A","E01031506","25-29 years","Female",13,18,15,13,7,66
"Chichester 007A","E01031506","30-34 years","Female",35,30,27,27,32,151
"Chichester 007A","E01031506","35-39 years","Female",24,28,35,35,45,167
"Chichester 007A","E01031506","40-44 years","Female",40,38,31,27,26,162
"Chichester 007A","E01031506","45-49 years","Female",48,43,47,47,46,231
"Chichester 007A","E01031506","50-54 years","Female",58,61,56,58,54,287
"Chichester 007A","E01031506","55-59 years","Female",56,66,68,66,64,320
"Chichester 007A","E01031506","60-64 years","Female",43,44,44,49,51,231
"Chichester 007A","E01031506","65-69 years","Female",63,61,59,53,51,287
"Chichester 007A","E01031506","70-74 years","Female",61,52,59,60,67,299
"Chichester 007A","E01031506","75-79 years","Female",21,33,34,36,35,159
"Chichester 007A","E01031506","80-84 years","Female",30,27,27,23,18,125
"Chichester 007A","E01031506","85+ years","Female",23,29,33,26,29,140
"Chichester 007B","E01031507","0-4 years","Male",29,27,26,24,15,121
"Chichester 007B","E01031507","5-9 years","Male",32,34,39,42,42,189
"Chichester 007B","E01031507","10-14 years","Male",38,37,40,33,34,182
"Chichester 007B","E01031507","15-19 years","Male",30,30,28,34,29,151
"Chichester 007B","E01031507","20-24 years","Male",18,14,13,15,17,77
"Chichester 007B","E01031507","25-29 years","Male",15,20,21,15,17,88
"Chichester 007B","E01031507","30-34 years","Male",18,16,17,17,11,79
"Chichester 007B","E01031507","35-39 years","Male",31,29,34,27,29,150
"Chichester 007B","E01031507","40-44 years","Male",30,20,18,19,24,111
"Chichester 007B","E01031507","45-49 years","Male",45,55,54,43,45,242
"Chichester 007B","E01031507","50-54 years","Male",64,56,55,56,47,278
"Chichester 007B","E01031507","55-59 years","Male",53,57,63,61,63,297
"Chichester 007B","E01031507","60-64 years","Male",62,61,54,47,52,276
"Chichester 007B","E01031507","65-69 years","Male",53,50,49,56,62,270
"Chichester 007B","E01031507","70-74 years","Male",40,44,47,40,37,208
"Chichester 007B","E01031507","75-79 years","Male",40,40,40,36,33,189
"Chichester 007B","E01031507","80-84 years","Male",34,43,36,42,38,193
"Chichester 007B","E01031507","85+ years","Male",9,9,11,16,13,58
"Chichester 007B","E01031507","0-4 years","Female",20,21,22,20,16,99
"Chichester 007B","E01031507","5-9 years","Female",18,16,13,17,20,84
"Chichester 007B","E01031507","10-14 years","Female",28,31,29,36,33,157
"Chichester 007B","E01031507","15-19 years","Female",32,28,26,17,22,125
"Chichester 007B","E01031507","20-24 years","Female",21,22,18,17,16,94
"Chichester 007B","E01031507","25-29 years","Female",17,18,20,17,14,86
"Chichester 007B","E01031507","30-34 years","Female",31,28,29,29,24,141
"Chichester 007B","E01031507","35-39 years","Female",21,24,25,30,28,128
"Chichester 007B","E01031507","40-44 years","Female",20,17,17,13,16,83
"Chichester 007B","E01031507","45-49 years","Female",59,53,50,49,46,257
"Chichester 007B","E01031507","50-54 years","Female",56,62,59,54,54,285
"Chichester 007B","E01031507","55-59 years","Female",59,54,58,49,45,265
"Chichester 007B","E01031507","60-64 years","Female",51,59,58,65,68,301
"Chichester 007B","E01031507","65-69 years","Female",71,62,61,58,59,311
"Chichester 007B","E01031507","70-74 years","Female",29,35,41,42,48,195
"Chichester 007B","E01031507","75-79 years","Female",40,35,39,38,33,185
"Chichester 007B","E01031507","80-84 years","Female",20,24,23,19,20,106
"Chichester 007B","E01031507","85+ years","Female",13,14,19,18,16,80
"Chichester 007C","E01031531","0-4 years","Male",28,33,33,29,30,153
"Chichester 007C","E01031531","5-9 years","Male",39,40,51,50,50,230
"Chichester 007C","E01031531","10-14 years","Male",33,32,30,28,29,152
"Chichester 007C","E01031531","15-19 years","Male",32,35,31,29,29,156
"Chichester 007C","E01031531","20-24 years","Male",29,26,25,21,24,125
"Chichester 007C","E01031531","25-29 years","Male",24,28,29,20,18,119
"Chichester 007C","E01031531","30-34 years","Male",24,21,24,25,32,126
"Chichester 007C","E01031531","35-39 years","Male",25,24,25,26,19,119
"Chichester 007C","E01031531","40-44 years","Male",41,40,39,32,41,193
"Chichester 007C","E01031531","45-49 years","Male",56,54,53,49,40,252
"Chichester 007C","E01031531","50-54 years","Male",38,35,38,37,40,188
"Chichester 007C","E01031531","55-59 years","Male",51,60,64,57,55,287
"Chichester 007C","E01031531","60-64 years","Male",28,30,30,35,35,158
"Chichester 007C","E01031531","65-69 years","Male",51,46,40,34,37,208
"Chichester 007C","E01031531","70-74 years","Male",44,52,53,57,54,260
"Chichester 007C","E01031531","75-79 years","Male",36,30,32,32,43,173
"Chichester 007C","E01031531","80-84 years","Male",22,21,22,24,17,106
"Chichester 007C","E01031531","85+ years","Male",29,28,26,24,25,132
"Chichester 007C","E01031531","0-4 years","Female",24,28,34,26,23,135
"Chichester 007C","E01031531","5-9 years","Female",38,41,40,49,57,225
"Chichester 007C","E01031531","10-14 years","Female",34,38,40,39,41,192
"Chichester 007C","E01031531","15-19 years","Female",29,27,28,27,32,143
"Chichester 007C","E01031531","20-24 years","Female",18,14,13,14,14,73
"Chichester 007C","E01031531","25-29 years","Female",18,22,26,26,23,115
"Chichester 007C","E01031531","30-34 years","Female",24,22,20,22,28,116
"Chichester 007C","E01031531","35-39 years","Female",36,33,33,34,32,168
"Chichester 007C","E01031531","40-44 years","Female",36,38,47,42,41,204
"Chichester 007C","E01031531","45-49 years","Female",41,42,44,39,32,198
"Chichester 007C","E01031531","50-54 years","Female",52,42,40,38,44,216
"Chichester 007C","E01031531","55-59 years","Female",42,47,50,47,48,234
"Chichester 007C","E01031531","60-64 years","Female",35,36,28,34,35,168
"Chichester 007C","E01031531","65-69 years","Female",67,56,52,45,42,262
"Chichester 007C","E01031531","70-74 years","Female",49,56,68,68,65,306
"Chichester 007C","E01031531","75-79 years","Female",40,49,40,45,48,222
"Chichester 007C","E01031531","80-84 years","Female",25,22,24,27,27,125
"Chichester 007C","E01031531","85+ years","Female",44,43,38,40,41,206
"Chichester 007D","E01031533","0-4 years","Male",35,46,42,46,36,205
"Chichester 007D","E01031533","5-9 years","Male",33,44,42,44,45,208
"Chichester 007D","E01031533","10-14 years","Male",31,32,40,33,38,174
"Chichester 007D","E01031533","15-19 years","Male",42,34,30,32,35,173
"Chichester 007D","E01031533","20-24 years","Male",29,22,24,22,23,120
"Chichester 007D","E01031533","25-29 years","Male",27,38,35,32,29,161
"Chichester 007D","E01031533","30-34 years","Male",33,31,29,25,27,145
"Chichester 007D","E01031533","35-39 years","Male",24,27,30,37,41,159
"Chichester 007D","E01031533","40-44 years","Male",39,39,30,32,37,177
"Chichester 007D","E01031533","45-49 years","Male",37,40,39,33,30,179
"Chichester 007D","E01031533","50-54 years","Male",44,44,46,48,48,230
"Chichester 007D","E01031533","55-59 years","Male",49,44,35,41,44,213
"Chichester 007D","E01031533","60-64 years","Male",38,40,42,37,39,196
"Chichester 007D","E01031533","65-69 years","Male",35,30,31,30,30,156
"Chichester 007D","E01031533","70-74 years","Male",23,28,28,33,35,147
"Chichester 007D","E01031533","75-79 years","Male",26,17,15,14,18,90
"Chichester 007D","E01031533","80-84 years","Male",19,22,23,19,19,102
"Chichester 007D","E01031533","85+ years","Male",24,22,23,24,24,117
"Chichester 007D","E01031533","0-4 years","Female",34,34,34,28,24,154
"Chichester 007D","E01031533","5-9 years","Female",39,37,33,36,42,187
"Chichester 007D","E01031533","10-14 years","Female",50,45,48,46,44,233
"Chichester 007D","E01031533","15-19 years","Female",33,33,42,42,39,189
"Chichester 007D","E01031533","20-24 years","Female",29,30,27,23,25,134
"Chichester 007D","E01031533","25-29 years","Female",25,30,28,32,30,145
"Chichester 007D","E01031533","30-34 years","Female",37,38,35,34,36,180
"Chichester 007D","E01031533","35-39 years","Female",38,45,39,44,46,212
"Chichester 007D","E01031533","40-44 years","Female",48,44,52,43,38,225
"Chichester 007D","E01031533","45-49 years","Female",60,59,57,51,55,282
"Chichester 007D","E01031533","50-54 years","Female",45,53,50,56,52,256
"Chichester 007D","E01031533","55-59 years","Female",38,36,41,42,47,204
"Chichester 007D","E01031533","60-64 years","Female",42,51,47,45,48,233
"Chichester 007D","E01031533","65-69 years","Female",38,36,40,46,50,210
"Chichester 007D","E01031533","70-74 years","Female",32,37,38,35,37,179
"Chichester 007D","E01031533","75-79 years","Female",24,20,16,20,29,109
"Chichester 007D","E01031533","80-84 years","Female",22,21,22,21,20,106
"Chichester 007D","E01031533","85+ years","Female",32,33,35,34,36,170
"Chichester 007E","E01031543","0-4 years","Male",78,66,62,66,56,328
"Chichester 007E","E01031543","5-9 years","Male",84,91,86,84,100,445
"Chichester 007E","E01031543","10-14 years","Male",73,74,71,71,70,359
"Chichester 007E","E01031543","15-19 years","Male",59,59,66,55,53,292
"Chichester 007E","E01031543","20-24 years","Male",51,51,47,47,38,234
"Chichester 007E","E01031543","25-29 years","Male",41,36,42,50,58,227
"Chichester 007E","E01031543","30-34 years","Male",35,32,37,38,33,175
"Chichester 007E","E01031543","35-39 years","Male",45,42,33,31,33,184
"Chichester 007E","E01031543","40-44 years","Male",79,74,69,57,58,337
"Chichester 007E","E01031543","45-49 years","Male",90,90,84,71,77,412
"Chichester 007E","E01031543","50-54 years","Male",95,97,95,106,96,489
"Chichester 007E","E01031543","55-59 years","Male",87,89,95,94,103,468
"Chichester 007E","E01031543","60-64 years","Male",75,71,78,81,82,387
"Chichester 007E","E01031543","65-69 years","Male",73,66,68,79,75,361
"Chichester 007E","E01031543","70-74 years","Male",65,73,67,65,65,335
"Chichester 007E","E01031543","75-79 years","Male",46,40,38,43,53,220
"Chichester 007E","E01031543","80-84 years","Male",37,40,50,45,41,213
"Chichester 007E","E01031543","85+ years","Male",13,18,16,23,20,90
"Chichester 007E","E01031543","0-4 years","Female",51,54,46,49,57,257
"Chichester 007E","E01031543","5-9 years","Female",77,79,83,70,65,374
"Chichester 007E","E01031543","10-14 years","Female",75,77,75,76,74,377
"Chichester 007E","E01031543","15-19 years","Female",54,53,53,62,67,289
"Chichester 007E","E01031543","20-24 years","Female",33,26,29,32,32,152
"Chichester 007E","E01031543","25-29 years","Female",44,41,39,39,39,202
"Chichester 007E","E01031543","30-34 years","Female",45,49,49,49,44,236
"Chichester 007E","E01031543","35-39 years","Female",66,68,71,67,65,337
"Chichester 007E","E01031543","40-44 years","Female",80,72,68,67,64,351
"Chichester 007E","E01031543","45-49 years","Female",92,94,89,94,94,463
"Chichester 007E","E01031543","50-54 years","Female",123,105,109,93,96,526
"Chichester 007E","E01031543","55-59 years","Female",79,96,86,99,102,462
"Chichester 007E","E01031543","60-64 years","Female",67,72,76,79,80,374
"Chichester 007E","E01031543","65-69 years","Female",94,76,77,71,70,388
"Chichester 007E","E01031543","70-74 years","Female",85,85,82,86,82,420
"Chichester 007E","E01031543","75-79 years","Female",52,53,59,57,58,279
"Chichester 007E","E01031543","80-84 years","Female",44,45,45,47,44,225
"Chichester 007E","E01031543","85+ years","Female",27,34,41,40,43,185
"Chichester 008A","E01031482","0-4 years","Male",75,86,73,72,69,375
"Chichester 008A","E01031482","5-9 years","Male",38,45,47,46,49,225
"Chichester 008A","E01031482","10-14 years","Male",41,43,49,50,40,223
"Chichester 008A","E01031482","15-19 years","Male",27,26,33,41,46,173
"Chichester 008A","E01031482","20-24 years","Male",99,87,70,77,66,399
"Chichester 008A","E01031482","25-29 years","Male",66,68,74,63,65,336
"Chichester 008A","E01031482","30-34 years","Male",95,87,82,77,71,412
"Chichester 008A","E01031482","35-39 years","Male",43,44,49,55,62,253
"Chichester 008A","E01031482","40-44 years","Male",40,42,39,41,38,200
"Chichester 008A","E01031482","45-49 years","Male",45,47,45,41,38,216
"Chichester 008A","E01031482","50-54 years","Male",52,49,49,43,47,240
"Chichester 008A","E01031482","55-59 years","Male",40,37,32,42,39,190
"Chichester 008A","E01031482","60-64 years","Male",46,42,38,33,36,195
"Chichester 008A","E01031482","65-69 years","Male",28,30,35,34,37,164
"Chichester 008A","E01031482","70-74 years","Male",16,30,31,35,31,143
"Chichester 008A","E01031482","75-79 years","Male",16,14,10,8,7,55
"Chichester 008A","E01031482","80-84 years","Male",22,24,19,17,12,94
"Chichester 008A","E01031482","85+ years","Male",9,7,10,9,12,47
"Chichester 008A","E01031482","0-4 years","Female",66,60,52,50,48,276
"Chichester 008A","E01031482","5-9 years","Female",36,44,35,45,49,209
"Chichester 008A","E01031482","10-14 years","Female",25,23,33,38,39,158
"Chichester 008A","E01031482","15-19 years","Female",27,25,27,21,24,124
"Chichester 008A","E01031482","20-24 years","Female",89,71,68,64,55,347
"Chichester 008A","E01031482","25-29 years","Female",60,66,63,67,64,320
"Chichester 008A","E01031482","30-34 years","Female",70,71,67,71,59,338
"Chichester 008A","E01031482","35-39 years","Female",49,53,62,58,63,285
"Chichester 008A","E01031482","40-44 years","Female",40,34,41,42,35,192
"Chichester 008A","E01031482","45-49 years","Female",50,57,47,49,49,252
"Chichester 008A","E01031482","50-54 years","Female",52,47,47,45,47,238
"Chichester 008A","E01031482","55-59 years","Female",47,46,44,47,53,237
"Chichester 008A","E01031482","60-64 years","Female",41,43,56,49,39,228
"Chichester 008A","E01031482","65-69 years","Female",42,41,33,39,42,197
"Chichester 008A","E01031482","70-74 years","Female",22,28,33,29,30,142
"Chichester 008A","E01031482","75-79 years","Female",20,19,22,18,16,95
"Chichester 008A","E01031482","80-84 years","Female",25,26,17,21,20,109
"Chichester 008A","E01031482","85+ years","Female",10,16,17,16,20,79
"Chichester 008B","E01031483","0-4 years","Male",70,71,67,62,50,320
"Chichester 008B","E01031483","5-9 years","Male",97,76,80,69,81,403
"Chichester 008B","E01031483","10-14 years","Male",52,60,61,72,76,321
"Chichester 008B","E01031483","15-19 years","Male",72,64,75,78,73,362
"Chichester 008B","E01031483","20-24 years","Male",200,189,160,162,140,851
"Chichester 008B","E01031483","25-29 years","Male",77,92,101,102,112,484
"Chichester 008B","E01031483","30-34 years","Male",71,70,73,70,71,355
"Chichester 008B","E01031483","35-39 years","Male",83,82,82,90,85,422
"Chichester 008B","E01031483","40-44 years","Male",84,87,87,76,79,413
"Chichester 008B","E01031483","45-49 years","Male",83,82,80,89,81,415
"Chichester 008B","E01031483","50-54 years","Male",86,87,94,90,95,452
"Chichester 008B","E01031483","55-59 years","Male",58,61,61,70,74,324
"Chichester 008B","E01031483","60-64 years","Male",44,48,56,56,54,258
"Chichester 008B","E01031483","65-69 years","Male",37,38,36,37,43,191
"Chichester 008B","E01031483","70-74 years","Male",39,42,31,32,32,176
"Chichester 008B","E01031483","75-79 years","Male",14,25,32,38,38,147
"Chichester 008B","E01031483","80-84 years","Male",17,12,10,7,13,59
"Chichester 008B","E01031483","85+ years","Male",13,15,10,12,9,59
"Chichester 008B","E01031483","0-4 years","Female",78,82,85,78,72,395
"Chichester 008B","E01031483","5-9 years","Female",53,62,59,63,57,294
"Chichester 008B","E01031483","10-14 years","Female",40,45,55,47,51,238
"Chichester 008B","E01031483","15-19 years","Female",91,84,73,77,76,401
"Chichester 008B","E01031483","20-24 years","Female",174,185,150,147,154,810
"Chichester 008B","E01031483","25-29 years","Female",88,84,94,94,87,447
"Chichester 008B","E01031483","30-34 years","Female",76,68,66,75,82,367
"Chichester 008B","E01031483","35-39 years","Female",93,85,85,84,77,424
"Chichester 008B","E01031483","40-44 years","Female",90,87,84,93,103,457
"Chichester 008B","E01031483","45-49 years","Female",88,84,86,83,80,421
"Chichester 008B","E01031483","50-54 years","Female",83,84,78,77,73,395
"Chichester 008B","E01031483","55-59 years","Female",75,79,75,74,87,390
"Chichester 008B","E01031483","60-64 years","Female",42,49,50,59,56,256
"Chichester 008B","E01031483","65-69 years","Female",48,45,45,49,52,239
"Chichester 008B","E01031483","70-74 years","Female",35,42,47,47,40,211
"Chichester 008B","E01031483","75-79 years","Female",23,23,25,22,30,123
"Chichester 008B","E01031483","80-84 years","Female",21,22,18,18,14,93
"Chichester 008B","E01031483","85+ years","Female",17,19,19,19,22,96
"Chichester 008C","E01031486","0-4 years","Male",15,10,8,13,21,67
"Chichester 008C","E01031486","5-9 years","Male",20,27,22,22,25,116
"Chichester 008C","E01031486","10-14 years","Male",13,12,11,13,10,59
"Chichester 008C","E01031486","15-19 years","Male",106,111,101,70,80,468
"Chichester 008C","E01031486","20-24 years","Male",167,157,136,106,94,660
"Chichester 008C","E01031486","25-29 years","Male",88,86,91,84,81,430
"Chichester 008C","E01031486","30-34 years","Male",58,61,70,59,58,306
"Chichester 008C","E01031486","35-39 years","Male",47,41,38,42,36,204
"Chichester 008C","E01031486","40-44 years","Male",33,36,32,35,38,174
"Chichester 008C","E01031486","45-49 years","Male",48,62,59,52,51,272
"Chichester 008C","E01031486","50-54 years","Male",38,37,42,57,64,238
"Chichester 008C","E01031486","55-59 years","Male",47,46,49,33,34,209
"Chichester 008C","E01031486","60-64 years","Male",30,39,39,53,44,205
"Chichester 008C","E01031486","65-69 years","Male",34,32,32,29,35,162
"Chichester 008C","E01031486","70-74 years","Male",39,43,39,39,37,197
"Chichester 008C","E01031486","75-79 years","Male",37,35,34,33,33,172
"Chichester 008C","E01031486","80-84 years","Male",32,34,41,43,36,186
"Chichester 008C","E01031486","85+ years","Male",33,33,30,31,34,161
"Chichester 008C","E01031486","0-4 years","Female",23,25,26,29,32,135
"Chichester 008C","E01031486","5-9 years","Female",18,21,21,19,17,96
"Chichester 008C","E01031486","10-14 years","Female",23,25,20,16,16,100
"Chichester 008C","E01031486","15-19 years","Female",151,133,112,98,109,603
"Chichester 008C","E01031486","20-24 years","Female",205,206,196,169,153,929
"Chichester 008C","E01031486","25-29 years","Female",50,54,54,46,52,256
"Chichester 008C","E01031486","30-34 years","Female",42,40,39,43,46,210
"Chichester 008C","E01031486","35-39 years","Female",37,45,40,42,39,203
"Chichester 008C","E01031486","40-44 years","Female",40,35,34,28,27,164
"Chichester 008C","E01031486","45-49 years","Female",29,35,33,40,44,181
"Chichester 008C","E01031486","50-54 years","Female",46,49,61,49,55,260
"Chichester 008C","E01031486","55-59 years","Female",38,37,34,42,42,193
"Chichester 008C","E01031486","60-64 years","Female",62,58,61,51,53,285
"Chichester 008C","E01031486","65-69 years","Female",55,54,49,48,48,254
"Chichester 008C","E01031486","70-74 years","Female",80,77,71,81,64,373
"Chichester 008C","E01031486","75-79 years","Female",73,83,84,79,84,403
"Chichester 008C","E01031486","80-84 years","Female",54,52,62,64,69,301
"Chichester 008C","E01031486","85+ years","Female",88,89,85,92,88,442
"Chichester 008D","E01031488","0-4 years","Male",84,107,101,91,90,473
"Chichester 008D","E01031488","5-9 years","Male",60,59,59,62,75,315
"Chichester 008D","E01031488","10-14 years","Male",82,95,97,92,79,445
"Chichester 008D","E01031488","15-19 years","Male",83,90,91,74,94,432
"Chichester 008D","E01031488","20-24 years","Male",221,231,225,211,200,1088
"Chichester 008D","E01031488","25-29 years","Male",117,120,123,127,138,625
"Chichester 008D","E01031488","30-34 years","Male",103,113,128,126,116,586
"Chichester 008D","E01031488","35-39 years","Male",75,89,94,99,101,458
"Chichester 008D","E01031488","40-44 years","Male",56,52,50,57,61,276
"Chichester 008D","E01031488","45-49 years","Male",55,56,60,56,70,297
"Chichester 008D","E01031488","50-54 years","Male",68,63,75,67,77,350
"Chichester 008D","E01031488","55-59 years","Male",38,39,39,52,57,225
"Chichester 008D","E01031488","60-64 years","Male",54,55,50,50,53,262
"Chichester 008D","E01031488","65-69 years","Male",58,62,64,61,61,306
"Chichester 008D","E01031488","70-74 years","Male",30,44,56,56,55,241
"Chichester 008D","E01031488","75-79 years","Male",31,39,36,37,41,184
"Chichester 008D","E01031488","80-84 years","Male",21,20,25,30,30,126
"Chichester 008D","E01031488","85+ years","Male",12,18,23,25,21,99
"Chichester 008D","E01031488","0-4 years","Female",79,90,97,95,94,455
"Chichester 008D","E01031488","5-9 years","Female",89,90,98,98,102,477
"Chichester 008D","E01031488","10-14 years","Female",53,67,66,75,89,350
"Chichester 008D","E01031488","15-19 years","Female",105,118,102,73,87,485
"Chichester 008D","E01031488","20-24 years","Female",205,206,208,189,168,976
"Chichester 008D","E01031488","25-29 years","Female",132,121,120,111,114,598
"Chichester 008D","E01031488","30-34 years","Female",91,112,119,122,117,561
"Chichester 008D","E01031488","35-39 years","Female",96,103,101,100,110,510
"Chichester 008D","E01031488","40-44 years","Female",65,74,76,72,81,368
"Chichester 008D","E01031488","45-49 years","Female",59,63,68,76,87,353
"Chichester 008D","E01031488","50-54 years","Female",76,65,77,80,73,371
"Chichester 008D","E01031488","55-59 years","Female",70,86,85,88,89,418
"Chichester 008D","E01031488","60-64 years","Female",62,78,86,85,87,398
"Chichester 008D","E01031488","65-69 years","Female",71,73,69,78,77,368
"Chichester 008D","E01031488","70-74 years","Female",49,68,71,67,80,335
"Chichester 008D","E01031488","75-79 years","Female",47,47,57,69,66,286
"Chichester 008D","E01031488","80-84 years","Female",18,22,27,30,33,130
"Chichester 008D","E01031488","85+ years","Female",19,31,35,42,45,172
"Chichester 008E","E01031494","0-4 years","Male",71,70,78,68,65,352
"Chichester 008E","E01031494","5-9 years","Male",51,63,64,63,59,300
"Chichester 008E","E01031494","10-14 years","Male",37,33,35,42,46,193
"Chichester 008E","E01031494","15-19 years","Male",25,26,27,33,33,144
"Chichester 008E","E01031494","20-24 years","Male",62,66,62,51,44,285
"Chichester 008E","E01031494","25-29 years","Male",57,59,58,51,49,274
"Chichester 008E","E01031494","30-34 years","Male",59,56,54,61,62,292
"Chichester 008E","E01031494","35-39 years","Male",36,36,42,42,40,196
"Chichester 008E","E01031494","40-44 years","Male",28,34,34,31,28,155
"Chichester 008E","E01031494","45-49 years","Male",39,32,36,29,30,166
"Chichester 008E","E01031494","50-54 years","Male",48,52,41,47,57,245
"Chichester 008E","E01031494","55-59 years","Male",40,37,38,38,40,193
"Chichester 008E","E01031494","60-64 years","Male",35,38,40,48,47,208
"Chichester 008E","E01031494","65-69 years","Male",37,33,38,34,38,180
"Chichester 008E","E01031494","70-74 years","Male",32,34,36,33,35,170
"Chichester 008E","E01031494","75-79 years","Male",30,31,30,34,35,160
"Chichester 008E","E01031494","80-84 years","Male",22,19,19,14,13,87
"Chichester 008E","E01031494","85+ years","Male",34,36,37,37,31,175
"Chichester 008E","E01031494","0-4 years","Female",51,57,50,61,69,288
"Chichester 008E","E01031494","5-9 years","Female",47,48,47,54,50,246
"Chichester 008E","E01031494","10-14 years","Female",46,46,55,53,64,264
"Chichester 008E","E01031494","15-19 years","Female",25,28,28,27,32,140
"Chichester 008E","E01031494","20-24 years","Female",54,57,51,40,39,241
"Chichester 008E","E01031494","25-29 years","Female",63,58,63,60,52,296
"Chichester 008E","E01031494","30-34 years","Female",38,45,44,43,41,211
"Chichester 008E","E01031494","35-39 years","Female",39,49,52,64,58,262
"Chichester 008E","E01031494","40-44 years","Female",49,44,43,41,47,224
"Chichester 008E","E01031494","45-49 years","Female",61,53,52,52,55,273
"Chichester 008E","E01031494","50-54 years","Female",77,68,73,66,59,343
"Chichester 008E","E01031494","55-59 years","Female",63,68,73,74,84,362
"Chichester 008E","E01031494","60-64 years","Female",38,41,36,45,42,202
"Chichester 008E","E01031494","65-69 years","Female",42,39,40,40,41,202
"Chichester 008E","E01031494","70-74 years","Female",39,44,47,51,57,238
"Chichester 008E","E01031494","75-79 years","Female",38,34,28,26,24,150
"Chichester 008E","E01031494","80-84 years","Female",46,39,38,31,36,190
"Chichester 008E","E01031494","85+ years","Female",48,50,51,55,54,258
"Chichester 008F","E01031495","0-4 years","Male",33,35,25,25,19,137
"Chichester 008F","E01031495","5-9 years","Male",22,23,27,25,24,121
"Chichester 008F","E01031495","10-14 years","Male",27,25,22,38,40,152
"Chichester 008F","E01031495","15-19 years","Male",30,23,18,23,23,117
"Chichester 008F","E01031495","20-24 years","Male",72,57,51,39,31,250
"Chichester 008F","E01031495","25-29 years","Male",35,37,35,34,30,171
"Chichester 008F","E01031495","30-34 years","Male",37,33,37,36,36,179
"Chichester 008F","E01031495","35-39 years","Male",38,31,31,40,36,176
"Chichester 008F","E01031495","40-44 years","Male",56,47,49,48,49,249
"Chichester 008F","E01031495","45-49 years","Male",54,48,46,37,37,222
"Chichester 008F","E01031495","50-54 years","Male",45,43,41,48,51,228
"Chichester 008F","E01031495","55-59 years","Male",46,57,60,60,62,285
"Chichester 008F","E01031495","60-64 years","Male",45,37,39,37,39,197
"Chichester 008F","E01031495","65-69 years","Male",46,57,55,48,49,255
"Chichester 008F","E01031495","70-74 years","Male",35,42,47,53,57,234
"Chichester 008F","E01031495","75-79 years","Male",33,25,25,30,30,143
"Chichester 008F","E01031495","80-84 years","Male",27,28,31,25,25,136
"Chichester 008F","E01031495","85+ years","Male",30,40,36,43,48,197
"Chichester 008F","E01031495","0-4 years","Female",30,34,37,32,30,163
"Chichester 008F","E01031495","5-9 years","Female",37,39,43,42,34,195
"Chichester 008F","E01031495","10-14 years","Female",35,27,30,33,28,153
"Chichester 008F","E01031495","15-19 years","Female",38,42,34,42,57,213
"Chichester 008F","E01031495","20-24 years","Female",51,52,66,53,59,281
"Chichester 008F","E01031495","25-29 years","Female",31,38,28,27,24,148
"Chichester 008F","E01031495","30-34 years","Female",47,41,43,37,42,210
"Chichester 008F","E01031495","35-39 years","Female",43,43,39,37,27,189
"Chichester 008F","E01031495","40-44 years","Female",45,36,39,39,44,203
"Chichester 008F","E01031495","45-49 years","Female",46,49,40,46,42,223
"Chichester 008F","E01031495","50-54 years","Female",70,64,62,58,52,306
"Chichester 008F","E01031495","55-59 years","Female",37,39,49,53,59,237
"Chichester 008F","E01031495","60-64 years","Female",52,53,49,52,48,254
"Chichester 008F","E01031495","65-69 years","Female",51,52,52,49,56,260
"Chichester 008F","E01031495","70-74 years","Female",51,59,65,63,58,296
"Chichester 008F","E01031495","75-79 years","Female",33,32,38,45,47,195
"Chichester 008F","E01031495","80-84 years","Female",58,49,46,40,36,229
"Chichester 008F","E01031495","85+ years","Female",67,74,77,84,92,394
"Chichester 009A","E01031475","0-4 years","Male",44,43,39,47,44,217
"Chichester 009A","E01031475","5-9 years","Male",57,55,62,54,56,284
"Chichester 009A","E01031475","10-14 years","Male",42,51,65,69,59,286
"Chichester 009A","E01031475","15-19 years","Male",47,49,39,42,46,223
"Chichester 009A","E01031475","20-24 years","Male",20,19,20,16,24,99
"Chichester 009A","E01031475","25-29 years","Male",21,20,21,27,25,114
"Chichester 009A","E01031475","30-34 years","Male",31,37,38,34,31,171
"Chichester 009A","E01031475","35-39 years","Male",28,31,41,39,46,185
"Chichester 009A","E01031475","40-44 years","Male",38,43,32,41,36,190
"Chichester 009A","E01031475","45-49 years","Male",73,70,68,62,53,326
"Chichester 009A","E01031475","50-54 years","Male",74,81,85,82,88,410
"Chichester 009A","E01031475","55-59 years","Male",45,48,51,65,74,283
"Chichester 009A","E01031475","60-64 years","Male",52,55,65,57,61,290
"Chichester 009A","E01031475","65-69 years","Male",59,57,59,62,58,295
"Chichester 009A","E01031475","70-74 years","Male",60,68,68,65,66,327
"Chichester 009A","E01031475","75-79 years","Male",42,47,51,64,63,267
"Chichester 009A","E01031475","80-84 years","Male",25,34,36,37,47,179
"Chichester 009A","E01031475","85+ years","Male",21,17,19,18,14,89
"Chichester 009A","E01031475","0-4 years","Female",43,54,53,57,56,263
"Chichester 009A","E01031475","5-9 years","Female",31,42,42,36,41,192
"Chichester 009A","E01031475","10-14 years","Female",57,59,59,71,66,312
"Chichester 009A","E01031475","15-19 years","Female",36,31,36,40,41,184
"Chichester 009A","E01031475","20-24 years","Female",25,26,25,29,28,133
"Chichester 009A","E01031475","25-29 years","Female",23,31,32,35,40,161
"Chichester 009A","E01031475","30-34 years","Female",33,43,50,36,34,196
"Chichester 009A","E01031475","35-39 years","Female",35,39,41,42,53,210
"Chichester 009A","E01031475","40-44 years","Female",57,49,45,51,42,244
"Chichester 009A","E01031475","45-49 years","Female",58,80,81,77,73,369
"Chichester 009A","E01031475","50-54 years","Female",70,57,60,63,63,313
"Chichester 009A","E01031475","55-59 years","Female",59,68,71,70,71,339
"Chichester 009A","E01031475","60-64 years","Female",64,82,78,79,90,393
"Chichester 009A","E01031475","65-69 years","Female",52,48,55,60,63,278
"Chichester 009A","E01031475","70-74 years","Female",51,51,63,68,59,292
"Chichester 009A","E01031475","75-79 years","Female",44,53,47,51,52,247
"Chichester 009A","E01031475","80-84 years","Female",30,22,27,24,32,135
"Chichester 009A","E01031475","85+ years","Female",77,78,71,72,65,363
"Chichester 009B","E01031476","0-4 years","Male",31,31,19,23,27,131
"Chichester 009B","E01031476","5-9 years","Male",43,41,42,36,38,200
"Chichester 009B","E01031476","10-14 years","Male",54,53,43,51,42,243
"Chichester 009B","E01031476","15-19 years","Male",39,44,41,36,40,200
"Chichester 009B","E01031476","20-24 years","Male",20,25,22,21,22,110
"Chichester 009B","E01031476","25-29 years","Male",18,14,14,16,13,75
"Chichester 009B","E01031476","30-34 years","Male",10,9,9,9,7,44
"Chichester 009B","E01031476","35-39 years","Male",34,34,32,22,24,146
"Chichester 009B","E01031476","40-44 years","Male",43,49,44,43,38,217
"Chichester 009B","E01031476","45-49 years","Male",57,48,44,49,47,245
"Chichester 009B","E01031476","50-54 years","Male",54,57,59,61,56,287
"Chichester 009B","E01031476","55-59 years","Male",52,51,43,43,50,239
"Chichester 009B","E01031476","60-64 years","Male",45,55,65,68,57,290
"Chichester 009B","E01031476","65-69 years","Male",68,61,53,48,52,282
"Chichester 009B","E01031476","70-74 years","Male",66,77,75,74,63,355
"Chichester 009B","E01031476","75-79 years","Male",50,54,52,62,73,291
"Chichester 009B","E01031476","80-84 years","Male",43,39,39,35,32,188
"Chichester 009B","E01031476","85+ years","Male",20,27,36,41,44,168
"Chichester 009B","E01031476","0-4 years","Female",31,33,23,26,23,136
"Chichester 009B","E01031476","5-9 years","Female",35,34,31,29,31,160
"Chichester 009B","E01031476","10-14 years","Female",30,27,27,29,25,138
"Chichester 009B","E01031476","15-19 years","Female",33,29,32,28,30,152
"Chichester 009B","E01031476","20-24 years","Female",18,19,20,24,23,104
"Chichester 009B","E01031476","25-29 years","Female",14,19,17,21,19,90
"Chichester 009B","E01031476","30-34 years","Female",22,19,19,16,14,90
"Chichester 009B","E01031476","35-39 years","Female",30,33,25,29,26,143
"Chichester 009B","E01031476","40-44 years","Female",49,44,38,32,38,201
"Chichester 009B","E01031476","45-49 years","Female",61,61,60,67,64,313
"Chichester 009B","E01031476","50-54 years","Female",50,44,43,50,50,237
"Chichester 009B","E01031476","55-59 years","Female",63,69,59,50,53,294
"Chichester 009B","E01031476","60-64 years","Female",57,59,74,82,76,348
"Chichester 009B","E01031476","65-69 years","Female",86,81,71,64,66,368
"Chichester 009B","E01031476","70-74 years","Female",66,80,86,90,90,412
"Chichester 009B","E01031476","75-79 years","Female",60,62,62,59,59,302
"Chichester 009B","E01031476","80-84 years","Female",43,43,46,43,48,223
"Chichester 009B","E01031476","85+ years","Female",37,37,42,43,32,191
"Chichester 009C","E01031532","0-4 years","Male",77,79,85,74,62,377
"Chichester 009C","E01031532","5-9 years","Male",65,68,67,76,76,352
"Chichester 009C","E01031532","10-14 years","Male",38,41,52,46,47,224
"Chichester 009C","E01031532","15-19 years","Male",60,54,47,66,65,292
"Chichester 009C","E01031532","20-24 years","Male",144,149,153,146,160,752
"Chichester 009C","E01031532","25-29 years","Male",136,135,162,158,137,728
"Chichester 009C","E01031532","30-34 years","Male",115,114,127,123,107,586
"Chichester 009C","E01031532","35-39 years","Male",77,86,85,91,109,448
"Chichester 009C","E01031532","40-44 years","Male",40,45,46,42,45,218
"Chichester 009C","E01031532","45-49 years","Male",40,42,32,26,23,163
"Chichester 009C","E01031532","50-54 years","Male",13,13,13,20,29,88
"Chichester 009C","E01031532","55-59 years","Male",30,27,28,24,19,128
"Chichester 009C","E01031532","60-64 years","Male",16,18,14,18,17,83
"Chichester 009C","E01031532","65-69 years","Male",24,18,20,19,22,103
"Chichester 009C","E01031532","70-74 years","Male",17,25,26,26,25,119
"Chichester 009C","E01031532","75-79 years","Male",14,16,16,22,29,97
"Chichester 009C","E01031532","80-84 years","Male",11,10,12,10,9,52
"Chichester 009C","E01031532","85+ years","Male",6,9,9,10,11,45
"Chichester 009C","E01031532","0-4 years","Female",81,78,83,75,70,387
"Chichester 009C","E01031532","5-9 years","Female",71,68,83,72,72,366
"Chichester 009C","E01031532","10-14 years","Female",48,54,58,48,53,261
"Chichester 009C","E01031532","15-19 years","Female",33,32,29,42,51,187
"Chichester 009C","E01031532","20-24 years","Female",46,53,45,44,45,233
"Chichester 009C","E01031532","25-29 years","Female",73,62,68,52,60,315
"Chichester 009C","E01031532","30-34 years","Female",87,92,88,86,80,433
"Chichester 009C","E01031532","35-39 years","Female",59,60,62,61,82,324
"Chichester 009C","E01031532","40-44 years","Female",30,35,35,32,38,170
"Chichester 009C","E01031532","45-49 years","Female",30,23,26,29,38,146
"Chichester 009C","E01031532","50-54 years","Female",23,27,18,21,24,113
"Chichester 009C","E01031532","55-59 years","Female",23,27,31,33,26,140
"Chichester 009C","E01031532","60-64 years","Female",21,20,22,20,25,108
"Chichester 009C","E01031532","65-69 years","Female",23,23,18,20,19,103
"Chichester 009C","E01031532","70-74 years","Female",22,24,28,27,29,130
"Chichester 009C","E01031532","75-79 years","Female",10,17,19,19,23,88
"Chichester 009C","E01031532","80-84 years","Female",16,16,13,14,11,70
"Chichester 009C","E01031532","85+ years","Female",8,9,11,9,11,48
"Chichester 009D","E01031534","0-4 years","Male",29,44,42,45,42,202
"Chichester 009D","E01031534","5-9 years","Male",35,39,29,33,41,177
"Chichester 009D","E01031534","10-14 years","Male",23,20,20,22,27,112
"Chichester 009D","E01031534","15-19 years","Male",32,31,32,24,21,140
"Chichester 009D","E01031534","20-24 years","Male",40,34,32,27,29,162
"Chichester 009D","E01031534","25-29 years","Male",21,22,23,27,27,120
"Chichester 009D","E01031534","30-34 years","Male",26,28,24,22,21,121
"Chichester 009D","E01031534","35-39 years","Male",28,23,26,30,21,128
"Chichester 009D","E01031534","40-44 years","Male",35,33,28,34,29,159
"Chichester 009D","E01031534","45-49 years","Male",53,47,49,43,48,240
"Chichester 009D","E01031534","50-54 years","Male",57,62,60,62,54,295
"Chichester 009D","E01031534","55-59 years","Male",93,93,94,89,83,452
"Chichester 009D","E01031534","60-64 years","Male",65,85,89,95,95,429
"Chichester 009D","E01031534","65-69 years","Male",81,75,73,71,72,372
"Chichester 009D","E01031534","70-74 years","Male",72,78,65,78,89,382
"Chichester 009D","E01031534","75-79 years","Male",51,55,64,64,67,301
"Chichester 009D","E01031534","80-84 years","Male",35,34,42,40,37,188
"Chichester 009D","E01031534","85+ years","Male",33,35,38,41,38,185
"Chichester 009D","E01031534","0-4 years","Female",32,32,28,34,38,164
"Chichester 009D","E01031534","5-9 years","Female",24,26,29,24,27,130
"Chichester 009D","E01031534","10-14 years","Female",28,23,27,35,35,148
"Chichester 009D","E01031534","15-19 years","Female",38,38,34,43,34,187
"Chichester 009D","E01031534","20-24 years","Female",27,28,29,31,35,150
"Chichester 009D","E01031534","25-29 years","Female",23,30,40,30,26,149
"Chichester 009D","E01031534","30-34 years","Female",30,27,22,22,20,121
"Chichester 009D","E01031534","35-39 years","Female",54,51,55,52,53,265
"Chichester 009D","E01031534","40-44 years","Female",44,40,37,34,30,185
"Chichester 009D","E01031534","45-49 years","Female",49,48,56,59,61,273
"Chichester 009D","E01031534","50-54 years","Female",71,77,71,71,75,365
"Chichester 009D","E01031534","55-59 years","Female",69,68,67,76,66,346
"Chichester 009D","E01031534","60-64 years","Female",63,71,80,74,84,372
"Chichester 009D","E01031534","65-69 years","Female",102,87,85,82,85,441
"Chichester 009D","E01031534","70-74 years","Female",75,83,86,91,87,422
"Chichester 009D","E01031534","75-79 years","Female",50,52,47,64,66,279
"Chichester 009D","E01031534","80-84 years","Female",48,54,55,47,51,255
"Chichester 009D","E01031534","85+ years","Female",60,65,60,65,69,319
"Chichester 009E","E01031535","0-4 years","Male",40,36,38,45,67,226
"Chichester 009E","E01031535","5-9 years","Male",44,50,50,52,55,251
"Chichester 009E","E01031535","10-14 years","Male",41,43,51,53,55,243
"Chichester 009E","E01031535","15-19 years","Male",46,39,39,38,46,208
"Chichester 009E","E01031535","20-24 years","Male",17,17,14,14,16,78
"Chichester 009E","E01031535","25-29 years","Male",16,16,19,21,26,98
"Chichester 009E","E01031535","30-34 years","Male",36,27,31,26,33,153
"Chichester 009E","E01031535","35-39 years","Male",27,28,30,28,36,149
"Chichester 009E","E01031535","40-44 years","Male",46,34,31,39,41,191
"Chichester 009E","E01031535","45-49 years","Male",45,49,47,48,46,235
"Chichester 009E","E01031535","50-54 years","Male",56,55,55,54,53,273
"Chichester 009E","E01031535","55-59 years","Male",57,52,61,63,65,298
"Chichester 009E","E01031535","60-64 years","Male",73,72,66,69,67,347
"Chichester 009E","E01031535","65-69 years","Male",49,62,66,71,88,336
"Chichester 009E","E01031535","70-74 years","Male",63,61,62,65,72,323
"Chichester 009E","E01031535","75-79 years","Male",38,44,48,51,47,228
"Chichester 009E","E01031535","80-84 years","Male",33,38,36,31,32,170
"Chichester 009E","E01031535","85+ years","Male",27,31,35,33,38,164
"Chichester 009E","E01031535","0-4 years","Female",50,47,46,52,58,253
"Chichester 009E","E01031535","5-9 years","Female",50,51,51,53,66,271
"Chichester 009E","E01031535","10-14 years","Female",40,42,39,42,50,213
"Chichester 009E","E01031535","15-19 years","Female",35,32,34,37,43,181
"Chichester 009E","E01031535","20-24 years","Female",19,19,24,24,34,120
"Chichester 009E","E01031535","25-29 years","Female",32,31,33,34,40,170
"Chichester 009E","E01031535","30-34 years","Female",45,38,36,36,45,200
"Chichester 009E","E01031535","35-39 years","Female",47,42,44,50,58,241
"Chichester 009E","E01031535","40-44 years","Female",35,48,48,53,56,240
"Chichester 009E","E01031535","45-49 years","Female",48,44,48,50,49,239
"Chichester 009E","E01031535","50-54 years","Female",65,60,60,56,63,304
"Chichester 009E","E01031535","55-59 years","Female",73,64,66,73,76,352
"Chichester 009E","E01031535","60-64 years","Female",66,73,76,87,78,380
"Chichester 009E","E01031535","65-69 years","Female",90,91,83,73,81,418
"Chichester 009E","E01031535","70-74 years","Female",51,63,73,79,83,349
"Chichester 009E","E01031535","75-79 years","Female",49,42,41,45,50,227
"Chichester 009E","E01031535","80-84 years","Female",36,31,38,34,41,180
"Chichester 009E","E01031535","85+ years","Female",75,70,68,63,56,332
"Chichester 010A","E01031480","0-4 years","Male",51,46,42,46,31,216
"Chichester 010A","E01031480","5-9 years","Male",42,42,44,41,52,221
"Chichester 010A","E01031480","10-14 years","Male",32,33,33,38,35,171
"Chichester 010A","E01031480","15-19 years","Male",33,35,31,22,27,148
"Chichester 010A","E01031480","20-24 years","Male",37,32,26,37,36,168
"Chichester 010A","E01031480","25-29 years","Male",71,69,62,65,65,332
"Chichester 010A","E01031480","30-34 years","Male",52,47,54,55,57,265
"Chichester 010A","E01031480","35-39 years","Male",54,52,42,36,34,218
"Chichester 010A","E01031480","40-44 years","Male",48,54,56,54,59,271
"Chichester 010A","E01031480","45-49 years","Male",51,50,55,57,58,271
"Chichester 010A","E01031480","50-54 years","Male",42,37,36,38,39,192
"Chichester 010A","E01031480","55-59 years","Male",37,37,43,42,46,205
"Chichester 010A","E01031480","60-64 years","Male",27,32,30,36,37,162
"Chichester 010A","E01031480","65-69 years","Male",29,26,31,29,30,145
"Chichester 010A","E01031480","70-74 years","Male",21,20,22,19,22,104
"Chichester 010A","E01031480","75-79 years","Male",8,9,8,12,11,48
"Chichester 010A","E01031480","80-84 years","Male",12,13,9,6,9,49
"Chichester 010A","E01031480","85+ years","Male",3,4,6,11,11,35
"Chichester 010A","E01031480","0-4 years","Female",51,53,46,40,42,232
"Chichester 010A","E01031480","5-9 years","Female",24,31,36,43,42,176
"Chichester 010A","E01031480","10-14 years","Female",30,31,29,36,36,162
"Chichester 010A","E01031480","15-19 years","Female",22,27,23,21,26,119
"Chichester 010A","E01031480","20-24 years","Female",63,59,56,52,34,264
"Chichester 010A","E01031480","25-29 years","Female",76,73,73,76,77,375
"Chichester 010A","E01031480","30-34 years","Female",57,65,60,57,57,296
"Chichester 010A","E01031480","35-39 years","Female",40,38,40,43,43,204
"Chichester 010A","E01031480","40-44 years","Female",55,57,49,53,52,266
"Chichester 010A","E01031480","45-49 years","Female",44,45,47,53,52,241
"Chichester 010A","E01031480","50-54 years","Female",50,47,46,36,38,217
"Chichester 010A","E01031480","55-59 years","Female",58,59,54,55,52,278
"Chichester 010A","E01031480","60-64 years","Female",42,39,48,56,61,246
"Chichester 010A","E01031480","65-69 years","Female",30,41,38,43,42,194
"Chichester 010A","E01031480","70-74 years","Female",20,21,25,22,28,116
"Chichester 010A","E01031480","75-79 years","Female",21,21,24,21,21,108
"Chichester 010A","E01031480","80-84 years","Female",7,9,7,11,9,43
"Chichester 010A","E01031480","85+ years","Female",13,13,12,9,12,59
"Chichester 010B","E01031481","0-4 years","Male",47,40,38,47,52,224
"Chichester 010B","E01031481","5-9 years","Male",20,24,31,25,30,130
"Chichester 010B","E01031481","10-14 years","Male",26,25,20,21,18,110
"Chichester 010B","E01031481","15-19 years","Male",36,39,36,37,41,189
"Chichester 010B","E01031481","20-24 years","Male",49,48,55,63,58,273
"Chichester 010B","E01031481","25-29 years","Male",85,81,82,78,77,403
"Chichester 010B","E01031481","30-34 years","Male",44,46,39,40,44,213
"Chichester 010B","E01031481","35-39 years","Male",61,56,57,57,56,287
"Chichester 010B","E01031481","40-44 years","Male",47,44,45,53,53,242
"Chichester 010B","E01031481","45-49 years","Male",49,44,46,44,38,221
"Chichester 010B","E01031481","50-54 years","Male",44,52,54,58,61,269
"Chichester 010B","E01031481","55-59 years","Male",57,57,61,61,64,300
"Chichester 010B","E01031481","60-64 years","Male",30,37,37,45,53,202
"Chichester 010B","E01031481","65-69 years","Male",41,36,39,40,42,198
"Chichester 010B","E01031481","70-74 years","Male",43,43,42,46,34,208
"Chichester 010B","E01031481","75-79 years","Male",17,23,18,23,29,110
"Chichester 010B","E01031481","80-84 years","Male",26,28,35,31,34,154
"Chichester 010B","E01031481","85+ years","Male",6,5,3,5,7,26
"Chichester 010B","E01031481","0-4 years","Female",44,41,42,41,40,208
"Chichester 010B","E01031481","5-9 years","Female",22,22,25,24,24,117
"Chichester 010B","E01031481","10-14 years","Female",18,20,21,20,22,101
"Chichester 010B","E01031481","15-19 years","Female",41,39,33,26,35,174
"Chichester 010B","E01031481","20-24 years","Female",65,55,59,71,59,309
"Chichester 010B","E01031481","25-29 years","Female",59,52,51,57,52,271
"Chichester 010B","E01031481","30-34 years","Female",44,43,38,41,40,206
"Chichester 010B","E01031481","35-39 years","Female",51,61,67,61,63,303
"Chichester 010B","E01031481","40-44 years","Female",36,39,48,39,50,212
"Chichester 010B","E01031481","45-49 years","Female",51,45,48,45,39,228
"Chichester 010B","E01031481","50-54 years","Female",38,44,53,54,59,248
"Chichester 010B","E01031481","55-59 years","Female",48,50,53,50,43,244
"Chichester 010B","E01031481","60-64 years","Female",38,38,46,44,44,210
"Chichester 010B","E01031481","65-69 years","Female",50,42,44,41,38,215
"Chichester 010B","E01031481","70-74 years","Female",50,57,52,50,48,257
"Chichester 010B","E01031481","75-79 years","Female",36,40,38,42,45,201
"Chichester 010B","E01031481","80-84 years","Female",25,22,19,24,31,121
"Chichester 010B","E01031481","85+ years","Female",16,16,20,23,22,97
"Chichester 010C","E01031484","0-4 years","Male",39,38,24,30,39,170
"Chichester 010C","E01031484","5-9 years","Male",63,61,56,49,51,280
"Chichester 010C","E01031484","10-14 years","Male",31,36,34,39,41,181
"Chichester 010C","E01031484","15-19 years","Male",37,38,32,30,41,178
"Chichester 010C","E01031484","20-24 years","Male",115,105,98,75,79,472
"Chichester 010C","E01031484","25-29 years","Male",98,98,86,103,87,472
"Chichester 010C","E01031484","30-34 years","Male",50,54,47,60,70,281
"Chichester 010C","E01031484","35-39 years","Male",61,60,62,55,44,282
"Chichester 010C","E01031484","40-44 years","Male",68,65,59,55,63,310
"Chichester 010C","E01031484","45-49 years","Male",51,49,51,57,60,268
"Chichester 010C","E01031484","50-54 years","Male",70,78,74,82,79,383
"Chichester 010C","E01031484","55-59 years","Male",29,34,36,37,44,180
"Chichester 010C","E01031484","60-64 years","Male",68,56,62,47,45,278
"Chichester 010C","E01031484","65-69 years","Male",47,43,49,61,60,260
"Chichester 010C","E01031484","70-74 years","Male",43,45,44,45,47,224
"Chichester 010C","E01031484","75-79 years","Male",44,44,44,47,48,227
"Chichester 010C","E01031484","80-84 years","Male",40,42,41,35,31,189
"Chichester 010C","E01031484","85+ years","Male",35,34,32,33,35,169
"Chichester 010C","E01031484","0-4 years","Female",47,42,35,34,38,196
"Chichester 010C","E01031484","5-9 years","Female",43,45,42,34,35,199
"Chichester 010C","E01031484","10-14 years","Female",26,26,26,26,28,132
"Chichester 010C","E01031484","15-19 years","Female",41,43,40,36,40,200
"Chichester 010C","E01031484","20-24 years","Female",95,100,76,84,66,421
"Chichester 010C","E01031484","25-29 years","Female",77,78,82,70,67,374
"Chichester 010C","E01031484","30-34 years","Female",63,59,77,74,80,353
"Chichester 010C","E01031484","35-39 years","Female",75,83,53,53,53,317
"Chichester 010C","E01031484","40-44 years","Female",39,46,50,52,55,242
"Chichester 010C","E01031484","45-49 years","Female",52,56,52,44,44,248
"Chichester 010C","E01031484","50-54 years","Female",65,57,58,63,74,317
"Chichester 010C","E01031484","55-59 years","Female",57,64,58,55,54,288
"Chichester 010C","E01031484","60-64 years","Female",62,61,58,70,74,325
"Chichester 010C","E01031484","65-69 years","Female",61,57,53,49,46,266
"Chichester 010C","E01031484","70-74 years","Female",66,71,75,77,82,371
"Chichester 010C","E01031484","75-79 years","Female",45,46,45,54,52,242
"Chichester 010C","E01031484","80-84 years","Female",64,57,55,55,54,285
"Chichester 010C","E01031484","85+ years","Female",63,65,70,70,73,341
"Chichester 010D","E01031490","0-4 years","Male",41,25,36,35,39,176
"Chichester 010D","E01031490","5-9 years","Male",35,38,32,36,33,174
"Chichester 010D","E01031490","10-14 years","Male",28,26,24,25,27,130
"Chichester 010D","E01031490","15-19 years","Male",167,147,165,146,142,767
"Chichester 010D","E01031490","20-24 years","Male",166,199,248,270,271,1154
"Chichester 010D","E01031490","25-29 years","Male",83,87,102,113,127,512
"Chichester 010D","E01031490","30-34 years","Male",69,64,61,57,62,313
"Chichester 010D","E01031490","35-39 years","Male",49,50,53,47,51,250
"Chichester 010D","E01031490","40-44 years","Male",36,31,34,40,40,181
"Chichester 010D","E01031490","45-49 years","Male",65,63,57,51,43,279
"Chichester 010D","E01031490","50-54 years","Male",34,34,36,39,45,188
"Chichester 010D","E01031490","55-59 years","Male",45,55,52,49,52,253
"Chichester 010D","E01031490","60-64 years","Male",40,44,40,41,40,205
"Chichester 010D","E01031490","65-69 years","Male",62,47,49,48,47,253
"Chichester 010D","E01031490","70-74 years","Male",34,41,47,41,45,208
"Chichester 010D","E01031490","75-79 years","Male",51,51,54,67,58,281
"Chichester 010D","E01031490","80-84 years","Male",35,36,42,34,42,189
"Chichester 010D","E01031490","85+ years","Male",51,53,57,63,56,280
"Chichester 010D","E01031490","0-4 years","Female",21,24,26,22,20,113
"Chichester 010D","E01031490","5-9 years","Female",21,19,22,23,25,110
"Chichester 010D","E01031490","10-14 years","Female",12,11,16,23,20,82
"Chichester 010D","E01031490","15-19 years","Female",103,106,117,110,84,520
"Chichester 010D","E01031490","20-24 years","Female",171,197,227,242,266,1103
"Chichester 010D","E01031490","25-29 years","Female",68,67,70,83,92,380
"Chichester 010D","E01031490","30-34 years","Female",45,48,51,45,45,234
"Chichester 010D","E01031490","35-39 years","Female",52,45,49,49,48,243
"Chichester 010D","E01031490","40-44 years","Female",29,41,38,40,38,186
"Chichester 010D","E01031490","45-49 years","Female",39,47,57,51,50,244
"Chichester 010D","E01031490","50-54 years","Female",48,38,36,38,36,196
"Chichester 010D","E01031490","55-59 years","Female",66,75,64,66,58,329
"Chichester 010D","E01031490","60-64 years","Female",46,53,60,62,72,293
"Chichester 010D","E01031490","65-69 years","Female",85,75,75,59,54,348
"Chichester 010D","E01031490","70-74 years","Female",61,68,73,92,96,390
"Chichester 010D","E01031490","75-79 years","Female",85,84,87,96,90,442
"Chichester 010D","E01031490","80-84 years","Female",86,94,90,99,103,472
"Chichester 010D","E01031490","85+ years","Female",154,156,143,141,137,731
"Chichester 010E","E01031491","0-4 years","Male",50,39,47,43,40,219
"Chichester 010E","E01031491","5-9 years","Male",50,48,45,44,40,227
"Chichester 010E","E01031491","10-14 years","Male",38,38,38,31,33,178
"Chichester 010E","E01031491","15-19 years","Male",77,83,66,57,70,353
"Chichester 010E","E01031491","20-24 years","Male",82,69,67,55,49,322
"Chichester 010E","E01031491","25-29 years","Male",69,84,73,73,62,361
"Chichester 010E","E01031491","30-34 years","Male",61,71,82,82,84,380
"Chichester 010E","E01031491","35-39 years","Male",56,61,63,57,49,286
"Chichester 010E","E01031491","40-44 years","Male",56,59,53,66,62,296
"Chichester 010E","E01031491","45-49 years","Male",61,58,50,45,47,261
"Chichester 010E","E01031491","50-54 years","Male",65,64,55,52,48,284
"Chichester 010E","E01031491","55-59 years","Male",59,62,62,73,87,343
"Chichester 010E","E01031491","60-64 years","Male",53,54,59,66,61,293
"Chichester 010E","E01031491","65-69 years","Male",47,40,40,47,48,222
"Chichester 010E","E01031491","70-74 years","Male",49,54,58,49,56,266
"Chichester 010E","E01031491","75-79 years","Male",30,33,30,28,36,157
"Chichester 010E","E01031491","80-84 years","Male",32,36,28,35,35,166
"Chichester 010E","E01031491","85+ years","Male",19,25,32,32,31,139
"Chichester 010E","E01031491","0-4 years","Female",38,40,43,45,44,210
"Chichester 010E","E01031491","5-9 years","Female",44,41,41,38,41,205
"Chichester 010E","E01031491","10-14 years","Female",34,31,26,29,25,145
"Chichester 010E","E01031491","15-19 years","Female",42,37,32,36,38,185
"Chichester 010E","E01031491","20-24 years","Female",73,74,69,52,48,316
"Chichester 010E","E01031491","25-29 years","Female",71,82,81,72,69,375
"Chichester 010E","E01031491","30-34 years","Female",72,60,57,49,56,294
"Chichester 010E","E01031491","35-39 years","Female",67,66,68,76,64,341
"Chichester 010E","E01031491","40-44 years","Female",49,52,48,50,60,259
"Chichester 010E","E01031491","45-49 years","Female",69,67,62,57,54,309
"Chichester 010E","E01031491","50-54 years","Female",83,80,78,73,69,383
"Chichester 010E","E01031491","55-59 years","Female",75,76,65,62,65,343
"Chichester 010E","E01031491","60-64 years","Female",39,39,53,69,74,274
"Chichester 010E","E01031491","65-69 years","Female",62,48,43,39,31,223
"Chichester 010E","E01031491","70-74 years","Female",51,57,64,61,58,291
"Chichester 010E","E01031491","75-79 years","Female",44,42,46,50,55,237
"Chichester 010E","E01031491","80-84 years","Female",48,46,45,53,46,238
"Chichester 010E","E01031491","85+ years","Female",40,40,41,40,50,211
"Chichester 011A","E01031474","0-4 years","Male",28,40,45,46,48,207
"Chichester 011A","E01031474","5-9 years","Male",42,36,31,38,35,182
"Chichester 011A","E01031474","10-14 years","Male",20,20,23,21,26,110
"Chichester 011A","E01031474","15-19 years","Male",50,45,35,30,31,191
"Chichester 011A","E01031474","20-24 years","Male",32,31,36,42,43,184
"Chichester 011A","E01031474","25-29 years","Male",27,28,33,32,26,146
"Chichester 011A","E01031474","30-34 years","Male",33,32,33,36,37,171
"Chichester 011A","E01031474","35-39 years","Male",47,35,35,37,37,191
"Chichester 011A","E01031474","40-44 years","Male",37,45,44,39,37,202
"Chichester 011A","E01031474","45-49 years","Male",46,43,34,35,34,192
"Chichester 011A","E01031474","50-54 years","Male",53,50,52,50,51,256
"Chichester 011A","E01031474","55-59 years","Male",55,56,52,57,51,271
"Chichester 011A","E01031474","60-64 years","Male",46,49,52,49,49,245
"Chichester 011A","E01031474","65-69 years","Male",45,43,44,42,43,217
"Chichester 011A","E01031474","70-74 years","Male",44,42,45,42,49,222
"Chichester 011A","E01031474","75-79 years","Male",25,28,31,38,40,162
"Chichester 011A","E01031474","80-84 years","Male",15,10,15,11,12,63
"Chichester 011A","E01031474","85+ years","Male",22,25,21,25,25,118
"Chichester 011A","E01031474","0-4 years","Female",28,28,36,31,36,159
"Chichester 011A","E01031474","5-9 years","Female",32,38,49,50,50,219
"Chichester 011A","E01031474","10-14 years","Female",34,29,26,23,24,136
"Chichester 011A","E01031474","15-19 years","Female",46,45,44,45,42,222
"Chichester 011A","E01031474","20-24 years","Female",20,15,14,17,16,82
"Chichester 011A","E01031474","25-29 years","Female",35,38,36,32,29,170
"Chichester 011A","E01031474","30-34 years","Female",29,25,25,23,23,125
"Chichester 011A","E01031474","35-39 years","Female",40,40,40,37,39,196
"Chichester 011A","E01031474","40-44 years","Female",34,30,33,32,39,168
"Chichester 011A","E01031474","45-49 years","Female",61,61,46,38,27,233
"Chichester 011A","E01031474","50-54 years","Female",87,76,77,76,58,374
"Chichester 011A","E01031474","55-59 years","Female",50,53,58,69,73,303
"Chichester 011A","E01031474","60-64 years","Female",56,59,51,46,53,265
"Chichester 011A","E01031474","65-69 years","Female",62,59,58,55,54,288
"Chichester 011A","E01031474","70-74 years","Female",52,46,55,62,73,288
"Chichester 011A","E01031474","75-79 years","Female",32,26,31,35,32,156
"Chichester 011A","E01031474","80-84 years","Female",38,37,32,26,30,163
"Chichester 011A","E01031474","85+ years","Female",19,16,16,19,17,87
"Chichester 011B","E01031493","0-4 years","Male",47,38,41,35,46,207
"Chichester 011B","E01031493","5-9 years","Male",53,59,55,57,52,276
"Chichester 011B","E01031493","10-14 years","Male",55,56,57,56,64,288
"Chichester 011B","E01031493","15-19 years","Male",47,48,43,42,35,215
"Chichester 011B","E01031493","20-24 years","Male",74,69,66,65,52,326
"Chichester 011B","E01031493","25-29 years","Male",17,22,23,24,27,113
"Chichester 011B","E01031493","30-34 years","Male",28,27,23,20,21,119
"Chichester 011B","E01031493","35-39 years","Male",47,40,45,48,39,219
"Chichester 011B","E01031493","40-44 years","Male",45,39,37,39,55,215
"Chichester 011B","E01031493","45-49 years","Male",45,46,46,41,39,217
"Chichester 011B","E01031493","50-54 years","Male",69,79,66,63,57,334
"Chichester 011B","E01031493","55-59 years","Male",59,53,63,65,61,301
"Chichester 011B","E01031493","60-64 years","Male",54,58,64,61,59,296
"Chichester 011B","E01031493","65-69 years","Male",53,38,39,47,51,228
"Chichester 011B","E01031493","70-74 years","Male",48,65,64,63,56,296
"Chichester 011B","E01031493","75-79 years","Male",54,43,49,56,56,258
"Chichester 011B","E01031493","80-84 years","Male",41,48,49,49,41,228
"Chichester 011B","E01031493","85+ years","Male",27,22,23,26,34,132
"Chichester 011B","E01031493","0-4 years","Female",59,49,41,37,35,221
"Chichester 011B","E01031493","5-9 years","Female",32,46,50,58,57,243
"Chichester 011B","E01031493","10-14 years","Female",45,43,42,42,44,216
"Chichester 011B","E01031493","15-19 years","Female",39,42,37,55,53,226
"Chichester 011B","E01031493","20-24 years","Female",39,40,34,41,43,197
"Chichester 011B","E01031493","25-29 years","Female",42,41,41,31,33,188
"Chichester 011B","E01031493","30-34 years","Female",33,25,29,31,41,159
"Chichester 011B","E01031493","35-39 years","Female",33,29,33,31,27,153
"Chichester 011B","E01031493","40-44 years","Female",40,33,38,47,46,204
"Chichester 011B","E01031493","45-49 years","Female",57,58,44,46,49,254
"Chichester 011B","E01031493","50-54 years","Female",72,71,67,66,58,334
"Chichester 011B","E01031493","55-59 years","Female",40,46,59,69,74,288
"Chichester 011B","E01031493","60-64 years","Female",67,71,57,54,48,297
"Chichester 011B","E01031493","65-69 years","Female",72,63,59,58,67,319
"Chichester 011B","E01031493","70-74 years","Female",65,62,74,73,67,341
"Chichester 011B","E01031493","75-79 years","Female",65,68,67,73,70,343
"Chichester 011B","E01031493","80-84 years","Female",48,46,50,51,56,251
"Chichester 011B","E01031493","85+ years","Female",60,61,57,58,65,301
"Chichester 011C","E01031496","0-4 years","Male",99,98,83,82,61,423
"Chichester 011C","E01031496","5-9 years","Male",77,95,96,95,101,464
"Chichester 011C","E01031496","10-14 years","Male",60,72,80,91,91,394
"Chichester 011C","E01031496","15-19 years","Male",104,119,111,90,88,512
"Chichester 011C","E01031496","20-24 years","Male",143,171,192,199,184,889
"Chichester 011C","E01031496","25-29 years","Male",56,54,57,66,63,296
"Chichester 011C","E01031496","30-34 years","Male",58,59,62,63,65,307
"Chichester 011C","E01031496","35-39 years","Male",87,89,86,85,91,438
"Chichester 011C","E01031496","40-44 years","Male",90,80,84,87,88,429
"Chichester 011C","E01031496","45-49 years","Male",82,94,83,84,89,432
"Chichester 011C","E01031496","50-54 years","Male",92,93,90,92,92,459
"Chichester 011C","E01031496","55-59 years","Male",95,93,107,108,108,511
"Chichester 011C","E01031496","60-64 years","Male",70,85,90,97,94,436
"Chichester 011C","E01031496","65-69 years","Male",90,72,64,67,70,363
"Chichester 011C","E01031496","70-74 years","Male",49,61,75,80,84,349
"Chichester 011C","E01031496","75-79 years","Male",42,49,48,45,52,236
"Chichester 011C","E01031496","80-84 years","Male",23,27,24,25,25,124
"Chichester 011C","E01031496","85+ years","Male",40,41,35,37,33,186
"Chichester 011C","E01031496","0-4 years","Female",86,67,80,77,59,369
"Chichester 011C","E01031496","5-9 years","Female",79,92,82,85,85,423
"Chichester 011C","E01031496","10-14 years","Female",74,79,72,74,75,374
"Chichester 011C","E01031496","15-19 years","Female",134,150,159,143,141,727
"Chichester 011C","E01031496","20-24 years","Female",126,144,166,177,189,802
"Chichester 011C","E01031496","25-29 years","Female",59,64,68,60,69,320
"Chichester 011C","E01031496","30-34 years","Female",77,77,64,67,67,352
"Chichester 011C","E01031496","35-39 years","Female",87,87,77,91,83,425
"Chichester 011C","E01031496","40-44 years","Female",72,80,80,86,81,399
"Chichester 011C","E01031496","45-49 years","Female",107,111,105,106,104,533
"Chichester 011C","E01031496","50-54 years","Female",104,90,98,83,91,466
"Chichester 011C","E01031496","55-59 years","Female",90,113,115,121,132,571
"Chichester 011C","E01031496","60-64 years","Female",85,81,91,102,98,457
"Chichester 011C","E01031496","65-69 years","Female",88,90,82,86,87,433
"Chichester 011C","E01031496","70-74 years","Female",66,66,73,70,78,353
"Chichester 011C","E01031496","75-79 years","Female",67,70,70,70,69,346
"Chichester 011C","E01031496","80-84 years","Female",56,58,59,59,58,290
"Chichester 011C","E01031496","85+ years","Female",57,55,57,64,65,298
"Chichester 011D","E01031505","0-4 years","Male",72,71,68,62,57,330
"Chichester 011D","E01031505","5-9 years","Male",79,92,86,89,82,428
"Chichester 011D","E01031505","10-14 years","Male",69,78,82,76,90,395
"Chichester 011D","E01031505","15-19 years","Male",67,73,69,78,80,367
"Chichester 011D","E01031505","20-24 years","Male",39,37,41,39,39,195
"Chichester 011D","E01031505","25-29 years","Male",59,57,58,58,54,286
"Chichester 011D","E01031505","30-34 years","Male",42,45,44,43,45,219
"Chichester 011D","E01031505","35-39 years","Male",68,71,74,64,53,330
"Chichester 011D","E01031505","40-44 years","Male",88,88,86,86,81,429
"Chichester 011D","E01031505","45-49 years","Male",101,104,91,96,88,480
"Chichester 011D","E01031505","50-54 years","Male",90,98,115,116,125,544
"Chichester 011D","E01031505","55-59 years","Male",75,84,92,99,96,446
"Chichester 011D","E01031505","60-64 years","Male",66,58,57,63,65,309
"Chichester 011D","E01031505","65-69 years","Male",81,88,94,83,81,427
"Chichester 011D","E01031505","70-74 years","Male",75,80,66,74,71,366
"Chichester 011D","E01031505","75-79 years","Male",47,46,61,63,68,285
"Chichester 011D","E01031505","80-84 years","Male",52,50,50,47,44,243
"Chichester 011D","E01031505","85+ years","Male",40,34,40,45,36,195
"Chichester 011D","E01031505","0-4 years","Female",50,53,61,47,41,252
"Chichester 011D","E01031505","5-9 years","Female",85,90,85,88,86,434
"Chichester 011D","E01031505","10-14 years","Female",71,80,87,86,88,412
"Chichester 011D","E01031505","15-19 years","Female",50,57,54,55,55,271
"Chichester 011D","E01031505","20-24 years","Female",47,49,48,48,45,237
"Chichester 011D","E01031505","25-29 years","Female",51,49,45,38,46,229
"Chichester 011D","E01031505","30-34 years","Female",53,59,59,55,46,272
"Chichester 011D","E01031505","35-39 years","Female",73,86,83,76,76,394
"Chichester 011D","E01031505","40-44 years","Female",97,102,90,82,80,451
"Chichester 011D","E01031505","45-49 years","Female",83,81,88,99,94,445
"Chichester 011D","E01031505","50-54 years","Female",88,95,95,92,92,462
"Chichester 011D","E01031505","55-59 years","Female",93,91,108,118,118,528
"Chichester 011D","E01031505","60-64 years","Female",88,86,77,85,79,415
"Chichester 011D","E01031505","65-69 years","Female",87,91,89,84,83,434
"Chichester 011D","E01031505","70-74 years","Female",67,72,75,77,82,373
"Chichester 011D","E01031505","75-79 years","Female",74,79,79,79,69,380
"Chichester 011D","E01031505","80-84 years","Female",68,68,56,55,55,302
"Chichester 011D","E01031505","85+ years","Female",60,50,59,69,67,305
"Chichester 012A","E01031489","0-4 years","Male",32,37,30,26,37,162
"Chichester 012A","E01031489","5-9 years","Male",39,43,45,47,40,214
"Chichester 012A","E01031489","10-14 years","Male",35,34,28,30,37,164
"Chichester 012A","E01031489","15-19 years","Male",58,50,45,43,37,233
"Chichester 012A","E01031489","20-24 years","Male",80,70,66,57,56,329
"Chichester 012A","E01031489","25-29 years","Male",29,32,26,27,27,141
"Chichester 012A","E01031489","30-34 years","Male",39,35,35,35,36,180
"Chichester 012A","E01031489","35-39 years","Male",42,36,34,37,36,185
"Chichester 012A","E01031489","40-44 years","Male",36,37,32,28,30,163
"Chichester 012A","E01031489","45-49 years","Male",54,50,45,41,42,232
"Chichester 012A","E01031489","50-54 years","Male",61,62,66,61,58,308
"Chichester 012A","E01031489","55-59 years","Male",46,45,47,56,51,245
"Chichester 012A","E01031489","60-64 years","Male",41,46,43,40,45,215
"Chichester 012A","E01031489","65-69 years","Male",49,42,49,55,51,246
"Chichester 012A","E01031489","70-74 years","Male",38,43,56,49,55,241
"Chichester 012A","E01031489","75-79 years","Male",22,23,19,31,37,132
"Chichester 012A","E01031489","80-84 years","Male",21,17,14,15,16,83
"Chichester 012A","E01031489","85+ years","Male",22,25,20,20,20,107
"Chichester 012A","E01031489","0-4 years","Female",31,34,40,35,30,170
"Chichester 012A","E01031489","5-9 years","Female",44,51,33,40,49,217
"Chichester 012A","E01031489","10-14 years","Female",23,22,29,30,31,135
"Chichester 012A","E01031489","15-19 years","Female",43,45,42,32,23,185
"Chichester 012A","E01031489","20-24 years","Female",62,62,53,45,46,268
"Chichester 012A","E01031489","25-29 years","Female",36,44,41,37,36,194
"Chichester 012A","E01031489","30-34 years","Female",39,39,38,37,30,183
"Chichester 012A","E01031489","35-39 years","Female",28,35,37,44,49,193
"Chichester 012A","E01031489","40-44 years","Female",58,43,37,35,36,209
"Chichester 012A","E01031489","45-49 years","Female",55,63,57,64,64,303
"Chichester 012A","E01031489","50-54 years","Female",61,58,61,56,45,281
"Chichester 012A","E01031489","55-59 years","Female",54,57,56,63,65,295
"Chichester 012A","E01031489","60-64 years","Female",49,48,53,50,58,258
"Chichester 012A","E01031489","65-69 years","Female",47,52,50,49,48,246
"Chichester 012A","E01031489","70-74 years","Female",51,59,62,65,68,305
"Chichester 012A","E01031489","75-79 years","Female",29,29,27,30,34,149
"Chichester 012A","E01031489","80-84 years","Female",26,26,25,21,23,121
"Chichester 012A","E01031489","85+ years","Female",44,36,32,37,34,183
"Chichester 012B","E01031492","0-4 years","Male",57,51,53,49,41,251
"Chichester 012B","E01031492","5-9 years","Male",53,55,63,60,57,288
"Chichester 012B","E01031492","10-14 years","Male",39,45,44,39,39,206
"Chichester 012B","E01031492","15-19 years","Male",66,50,47,44,48,255
"Chichester 012B","E01031492","20-24 years","Male",92,100,94,85,80,451
"Chichester 012B","E01031492","25-29 years","Male",42,44,46,48,43,223
"Chichester 012B","E01031492","30-34 years","Male",56,51,48,48,50,253
"Chichester 012B","E01031492","35-39 years","Male",27,33,29,37,40,166
"Chichester 012B","E01031492","40-44 years","Male",37,40,39,33,38,187
"Chichester 012B","E01031492","45-49 years","Male",49,44,42,43,35,213
"Chichester 012B","E01031492","50-54 years","Male",54,58,57,47,44,260
"Chichester 012B","E01031492","55-59 years","Male",41,50,62,67,72,292
"Chichester 012B","E01031492","60-64 years","Male",23,23,26,26,27,125
"Chichester 012B","E01031492","65-69 years","Male",39,37,33,28,30,167
"Chichester 012B","E01031492","70-74 years","Male",30,30,29,32,29,150
"Chichester 012B","E01031492","75-79 years","Male",29,32,37,33,38,169
"Chichester 012B","E01031492","80-84 years","Male",18,22,17,23,28,108
"Chichester 012B","E01031492","85+ years","Male",13,13,13,13,11,63
"Chichester 012B","E01031492","0-4 years","Female",49,40,37,34,30,190
"Chichester 012B","E01031492","5-9 years","Female",38,45,40,39,39,201
"Chichester 012B","E01031492","10-14 years","Female",43,41,44,47,45,220
"Chichester 012B","E01031492","15-19 years","Female",78,55,57,54,42,286
"Chichester 012B","E01031492","20-24 years","Female",85,87,85,79,87,423
"Chichester 012B","E01031492","25-29 years","Female",45,49,48,53,46,241
"Chichester 012B","E01031492","30-34 years","Female",56,55,53,54,55,273
"Chichester 012B","E01031492","35-39 years","Female",42,51,55,55,58,261
"Chichester 012B","E01031492","40-44 years","Female",51,49,40,34,33,207
"Chichester 012B","E01031492","45-49 years","Female",69,62,64,60,51,306
"Chichester 012B","E01031492","50-54 years","Female",51,55,58,54,58,276
"Chichester 012B","E01031492","55-59 years","Female",52,57,57,65,70,301
"Chichester 012B","E01031492","60-64 years","Female",34,37,47,51,53,222
"Chichester 012B","E01031492","65-69 years","Female",47,36,32,35,37,187
"Chichester 012B","E01031492","70-74 years","Female",38,44,50,50,51,233
"Chichester 012B","E01031492","75-79 years","Female",32,32,34,39,34,171
"Chichester 012B","E01031492","80-84 years","Female",30,31,28,25,29,143
"Chichester 012B","E01031492","85+ years","Female",38,33,35,32,40,178
"Chichester 012C","E01031513","0-4 years","Male",61,53,57,69,74,314
"Chichester 012C","E01031513","5-9 years","Male",78,84,68,81,89,400
"Chichester 012C","E01031513","10-14 years","Male",113,115,138,150,152,668
"Chichester 012C","E01031513","15-19 years","Male",70,68,65,67,78,348
"Chichester 012C","E01031513","20-24 years","Male",69,73,68,63,60,333
"Chichester 012C","E01031513","25-29 years","Male",136,130,126,142,118,652
"Chichester 012C","E01031513","30-34 years","Male",85,94,118,121,129,547
"Chichester 012C","E01031513","35-39 years","Male",72,79,88,88,99,426
"Chichester 012C","E01031513","40-44 years","Male",75,84,89,97,99,444
"Chichester 012C","E01031513","45-49 years","Male",94,94,87,94,100,469
"Chichester 012C","E01031513","50-54 years","Male",96,96,98,97,105,492
"Chichester 012C","E01031513","55-59 years","Male",82,90,91,95,107,465
"Chichester 012C","E01031513","60-64 years","Male",91,81,83,93,92,440
"Chichester 012C","E01031513","65-69 years","Male",84,94,90,90,94,452
"Chichester 012C","E01031513","70-74 years","Male",78,95,97,95,90,455
"Chichester 012C","E01031513","75-79 years","Male",48,49,44,58,63,262
"Chichester 012C","E01031513","80-84 years","Male",31,34,46,40,44,195
"Chichester 012C","E01031513","85+ years","Male",23,24,27,31,28,133
"Chichester 012C","E01031513","0-4 years","Female",76,70,66,83,77,372
"Chichester 012C","E01031513","5-9 years","Female",73,71,78,87,99,408
"Chichester 012C","E01031513","10-14 years","Female",88,96,109,128,132,553
"Chichester 012C","E01031513","15-19 years","Female",65,61,58,56,60,300
"Chichester 012C","E01031513","20-24 years","Female",53,53,63,68,56,293
"Chichester 012C","E01031513","25-29 years","Female",82,90,83,85,88,428
"Chichester 012C","E01031513","30-34 years","Female",69,78,88,102,105,442
"Chichester 012C","E01031513","35-39 years","Female",89,105,92,95,114,495
"Chichester 012C","E01031513","40-44 years","Female",83,79,102,117,123,504
"Chichester 012C","E01031513","45-49 years","Female",85,87,84,94,107,457
"Chichester 012C","E01031513","50-54 years","Female",98,102,105,103,100,508
"Chichester 012C","E01031513","55-59 years","Female",108,103,107,114,123,555
"Chichester 012C","E01031513","60-64 years","Female",92,95,96,103,96,482
"Chichester 012C","E01031513","65-69 years","Female",88,98,94,106,109,495
"Chichester 012C","E01031513","70-74 years","Female",79,86,80,76,92,413
"Chichester 012C","E01031513","75-79 years","Female",47,50,56,69,60,282
"Chichester 012C","E01031513","80-84 years","Female",43,48,48,42,45,226
"Chichester 012C","E01031513","85+ years","Female",45,47,51,48,53,244
"Chichester 012D","E01031530","0-4 years","Male",48,45,49,41,39,222
"Chichester 012D","E01031530","5-9 years","Male",53,54,53,55,58,273
"Chichester 012D","E01031530","10-14 years","Male",32,39,32,37,43,183
"Chichester 012D","E01031530","15-19 years","Male",58,49,40,41,46,234
"Chichester 012D","E01031530","20-24 years","Male",19,21,27,24,22,113
"Chichester 012D","E01031530","25-29 years","Male",22,24,22,23,19,110
"Chichester 012D","E01031530","30-34 years","Male",31,32,38,36,32,169
"Chichester 012D","E01031530","35-39 years","Male",28,25,26,32,36,147
"Chichester 012D","E01031530","40-44 years","Male",37,35,34,29,27,162
"Chichester 012D","E01031530","45-49 years","Male",41,38,40,37,32,188
"Chichester 012D","E01031530","50-54 years","Male",56,59,53,59,55,282
"Chichester 012D","E01031530","55-59 years","Male",64,61,53,48,61,287
"Chichester 012D","E01031530","60-64 years","Male",51,56,62,66,67,302
"Chichester 012D","E01031530","65-69 years","Male",36,37,39,30,35,177
"Chichester 012D","E01031530","70-74 years","Male",28,32,35,45,38,178
"Chichester 012D","E01031530","75-79 years","Male",24,27,25,21,23,120
"Chichester 012D","E01031530","80-84 years","Male",17,19,17,13,14,80
"Chichester 012D","E01031530","85+ years","Male",8,11,13,17,17,66
"Chichester 012D","E01031530","0-4 years","Female",26,24,31,25,23,129
"Chichester 012D","E01031530","5-9 years","Female",30,33,29,26,26,144
"Chichester 012D","E01031530","10-14 years","Female",27,25,25,23,25,125
"Chichester 012D","E01031530","15-19 years","Female",36,39,40,33,30,178
"Chichester 012D","E01031530","20-24 years","Female",27,22,22,19,16,106
"Chichester 012D","E01031530","25-29 years","Female",40,32,35,34,35,176
"Chichester 012D","E01031530","30-34 years","Female",46,39,36,37,39,197
"Chichester 012D","E01031530","35-39 years","Female",34,39,44,38,38,193
"Chichester 012D","E01031530","40-44 years","Female",45,35,38,37,39,194
"Chichester 012D","E01031530","45-49 years","Female",38,45,42,47,50,222
"Chichester 012D","E01031530","50-54 years","Female",58,65,64,56,47,290
"Chichester 012D","E01031530","55-59 years","Female",50,52,48,50,42,242
"Chichester 012D","E01031530","60-64 years","Female",45,44,48,55,69,261
"Chichester 012D","E01031530","65-69 years","Female",62,52,45,45,40,244
"Chichester 012D","E01031530","70-74 years","Female",36,42,47,50,52,227
"Chichester 012D","E01031530","75-79 years","Female",35,38,38,32,29,172
"Chichester 012D","E01031530","80-84 years","Female",15,22,21,21,23,102
"Chichester 012D","E01031530","85+ years","Female",25,16,13,13,13,80
"Chichester 012E","E01031538","0-4 years","Male",64,65,68,66,61,324
"Chichester 012E","E01031538","5-9 years","Male",58,73,76,82,81,370
"Chichester 012E","E01031538","10-14 years","Male",43,46,51,60,55,255
"Chichester 012E","E01031538","15-19 years","Male",47,45,36,30,33,191
"Chichester 012E","E01031538","20-24 years","Male",50,51,48,44,37,230
"Chichester 012E","E01031538","25-29 years","Male",47,52,51,51,47,248
"Chichester 012E","E01031538","30-34 years","Male",63,59,53,50,53,278
"Chichester 012E","E01031538","35-39 years","Male",42,45,46,58,57,248
"Chichester 012E","E01031538","40-44 years","Male",33,34,29,30,32,158
"Chichester 012E","E01031538","45-49 years","Male",46,40,34,36,32,188
"Chichester 012E","E01031538","50-54 years","Male",58,56,63,51,49,277
"Chichester 012E","E01031538","55-59 years","Male",37,44,49,55,52,237
"Chichester 012E","E01031538","60-64 years","Male",30,28,27,30,24,139
"Chichester 012E","E01031538","65-69 years","Male",52,49,36,38,42,217
"Chichester 012E","E01031538","70-74 years","Male",36,33,41,39,39,188
"Chichester 012E","E01031538","75-79 years","Male",20,25,27,32,33,137
"Chichester 012E","E01031538","80-84 years","Male",17,13,15,9,11,65
"Chichester 012E","E01031538","85+ years","Male",18,17,16,18,22,91
"Chichester 012E","E01031538","0-4 years","Female",48,48,48,48,42,234
"Chichester 012E","E01031538","5-9 years","Female",53,57,58,59,58,285
"Chichester 012E","E01031538","10-14 years","Female",46,52,53,59,66,276
"Chichester 012E","E01031538","15-19 years","Female",40,37,34,40,39,190
"Chichester 012E","E01031538","20-24 years","Female",56,52,54,51,47,260
"Chichester 012E","E01031538","25-29 years","Female",49,54,45,43,41,232
"Chichester 012E","E01031538","30-34 years","Female",52,54,66,64,57,293
"Chichester 012E","E01031538","35-39 years","Female",56,57,57,60,58,288
"Chichester 012E","E01031538","40-44 years","Female",56,45,46,57,52,256
"Chichester 012E","E01031538","45-49 years","Female",52,50,46,40,42,230
"Chichester 012E","E01031538","50-54 years","Female",62,60,55,56,50,283
"Chichester 012E","E01031538","55-59 years","Female",58,65,70,68,68,329
"Chichester 012E","E01031538","60-64 years","Female",54,52,52,51,48,257
"Chichester 012E","E01031538","65-69 years","Female",49,42,49,53,47,240
"Chichester 012E","E01031538","70-74 years","Female",22,29,30,34,36,151
"Chichester 012E","E01031538","75-79 years","Female",23,21,20,18,17,99
"Chichester 012E","E01031538","80-84 years","Female",19,19,16,12,16,82
"Chichester 012E","E01031538","85+ years","Female",16,17,19,24,31,107
"Chichester 012F","E01031539","0-4 years","Male",28,30,52,65,64,239
"Chichester 012F","E01031539","5-9 years","Male",29,38,43,47,41,198
"Chichester 012F","E01031539","10-14 years","Male",36,37,44,53,59,229
"Chichester 012F","E01031539","15-19 years","Male",22,22,26,27,26,123
"Chichester 012F","E01031539","20-24 years","Male",36,35,41,38,36,186
"Chichester 012F","E01031539","25-29 years","Male",36,47,56,63,56,258
"Chichester 012F","E01031539","30-34 years","Male",49,56,63,70,78,316
"Chichester 012F","E01031539","35-39 years","Male",41,44,61,71,75,292
"Chichester 012F","E01031539","40-44 years","Male",57,54,48,51,53,263
"Chichester 012F","E01031539","45-49 years","Male",35,44,53,60,66,258
"Chichester 012F","E01031539","50-54 years","Male",36,42,45,47,41,211
"Chichester 012F","E01031539","55-59 years","Male",32,38,39,40,41,190
"Chichester 012F","E01031539","60-64 years","Male",30,27,38,37,41,173
"Chichester 012F","E01031539","65-69 years","Male",32,36,32,30,28,158
"Chichester 012F","E01031539","70-74 years","Male",11,10,9,12,16,58
"Chichester 012F","E01031539","75-79 years","Male",22,20,17,22,21,102
"Chichester 012F","E01031539","80-84 years","Male",2,3,5,5,6,21
"Chichester 012F","E01031539","85+ years","Male",3,1,1,2,1,8
"Chichester 012F","E01031539","0-4 years","Female",42,47,56,71,80,296
"Chichester 012F","E01031539","5-9 years","Female",37,53,64,66,68,288
"Chichester 012F","E01031539","10-14 years","Female",22,25,34,39,46,166
"Chichester 012F","E01031539","15-19 years","Female",30,28,31,38,40,167
"Chichester 012F","E01031539","20-24 years","Female",21,24,26,24,19,114
"Chichester 012F","E01031539","25-29 years","Female",43,54,73,80,68,318
"Chichester 012F","E01031539","30-34 years","Female",34,43,62,65,78,282
"Chichester 012F","E01031539","35-39 years","Female",48,48,56,68,68,288
"Chichester 012F","E01031539","40-44 years","Female",48,47,58,64,65,282
"Chichester 012F","E01031539","45-49 years","Female",35,43,50,55,57,240
"Chichester 012F","E01031539","50-54 years","Female",43,37,38,41,43,202
"Chichester 012F","E01031539","55-59 years","Female",36,42,45,46,48,217
"Chichester 012F","E01031539","60-64 years","Female",34,34,33,37,34,172
"Chichester 012F","E01031539","65-69 years","Female",34,35,34,33,37,173
"Chichester 012F","E01031539","70-74 years","Female",20,21,24,28,27,120
"Chichester 012F","E01031539","75-79 years","Female",12,14,14,18,23,81
"Chichester 012F","E01031539","80-84 years","Female",9,10,11,9,13,52
"Chichester 012F","E01031539","85+ years","Female",9,14,15,21,20,79
"Chichester 013A","E01031499","0-4 years","Male",53,49,44,42,43,231
"Chichester 013A","E01031499","5-9 years","Male",39,35,31,34,34,173
"Chichester 013A","E01031499","10-14 years","Male",36,40,40,41,36,193
"Chichester 013A","E01031499","15-19 years","Male",45,36,40,40,38,199
"Chichester 013A","E01031499","20-24 years","Male",42,41,36,34,31,184
"Chichester 013A","E01031499","25-29 years","Male",47,52,53,50,45,247
"Chichester 013A","E01031499","30-34 years","Male",36,34,32,32,36,170
"Chichester 013A","E01031499","35-39 years","Male",34,35,37,37,32,175
"Chichester 013A","E01031499","40-44 years","Male",56,45,41,43,44,229
"Chichester 013A","E01031499","45-49 years","Male",56,49,53,51,48,257
"Chichester 013A","E01031499","50-54 years","Male",48,55,52,50,48,253
"Chichester 013A","E01031499","55-59 years","Male",55,56,63,68,66,308
"Chichester 013A","E01031499","60-64 years","Male",59,54,48,54,57,272
"Chichester 013A","E01031499","65-69 years","Male",63,61,57,51,57,289
"Chichester 013A","E01031499","70-74 years","Male",60,58,58,57,50,283
"Chichester 013A","E01031499","75-79 years","Male",31,37,43,43,46,200
"Chichester 013A","E01031499","80-84 years","Male",25,29,28,34,32,148
"Chichester 013A","E01031499","85+ years","Male",18,17,11,24,23,93
"Chichester 013A","E01031499","0-4 years","Female",47,47,45,35,35,209
"Chichester 013A","E01031499","5-9 years","Female",37,38,32,39,40,186
"Chichester 013A","E01031499","10-14 years","Female",34,36,42,46,45,203
"Chichester 013A","E01031499","15-19 years","Female",52,51,51,40,43,237
"Chichester 013A","E01031499","20-24 years","Female",38,35,26,34,35,168
"Chichester 013A","E01031499","25-29 years","Female",38,37,38,41,37,191
"Chichester 013A","E01031499","30-34 years","Female",44,48,47,41,40,220
"Chichester 013A","E01031499","35-39 years","Female",61,53,52,53,49,268
"Chichester 013A","E01031499","40-44 years","Female",53,51,53,47,50,254
"Chichester 013A","E01031499","45-49 years","Female",65,63,65,64,56,313
"Chichester 013A","E01031499","50-54 years","Female",62,64,55,65,67,313
"Chichester 013A","E01031499","55-59 years","Female",65,65,65,64,59,318
"Chichester 013A","E01031499","60-64 years","Female",58,63,77,67,73,338
"Chichester 013A","E01031499","65-69 years","Female",74,53,50,47,60,284
"Chichester 013A","E01031499","70-74 years","Female",54,66,67,76,70,333
"Chichester 013A","E01031499","75-79 years","Female",38,42,38,45,58,221
"Chichester 013A","E01031499","80-84 years","Female",29,30,30,26,22,137
"Chichester 013A","E01031499","85+ years","Female",51,46,47,41,43,228
"Chichester 013B","E01031500","0-4 years","Male",66,47,57,63,69,302
"Chichester 013B","E01031500","5-9 years","Male",88,103,97,83,94,465
"Chichester 013B","E01031500","10-14 years","Male",49,56,63,70,76,314
"Chichester 013B","E01031500","15-19 years","Male",42,42,46,43,40,213
"Chichester 013B","E01031500","20-24 years","Male",48,42,42,31,39,202
"Chichester 013B","E01031500","25-29 years","Male",47,39,39,39,35,199
"Chichester 013B","E01031500","30-34 years","Male",36,33,37,43,46,195
"Chichester 013B","E01031500","35-39 years","Male",51,51,51,58,52,263
"Chichester 013B","E01031500","40-44 years","Male",48,43,48,48,59,246
"Chichester 013B","E01031500","45-49 years","Male",63,71,66,57,67,324
"Chichester 013B","E01031500","50-54 years","Male",71,74,77,78,72,372
"Chichester 013B","E01031500","55-59 years","Male",71,69,78,83,85,386
"Chichester 013B","E01031500","60-64 years","Male",101,102,94,104,100,501
"Chichester 013B","E01031500","65-69 years","Male",79,61,67,65,77,349
"Chichester 013B","E01031500","70-74 years","Male",87,111,109,116,117,540
"Chichester 013B","E01031500","75-79 years","Male",51,50,65,71,71,308
"Chichester 013B","E01031500","80-84 years","Male",48,43,45,44,45,225
"Chichester 013B","E01031500","85+ years","Male",33,46,50,50,45,224
"Chichester 013B","E01031500","0-4 years","Female",67,62,52,69,72,322
"Chichester 013B","E01031500","5-9 years","Female",68,66,63,75,89,361
"Chichester 013B","E01031500","10-14 years","Female",40,49,64,61,59,273
"Chichester 013B","E01031500","15-19 years","Female",35,32,28,36,34,165
"Chichester 013B","E01031500","20-24 years","Female",44,40,40,36,39,199
"Chichester 013B","E01031500","25-29 years","Female",55,53,44,48,51,251
"Chichester 013B","E01031500","30-34 years","Female",42,38,40,50,57,227
"Chichester 013B","E01031500","35-39 years","Female",55,62,62,57,56,292
"Chichester 013B","E01031500","40-44 years","Female",67,66,61,61,62,317
"Chichester 013B","E01031500","45-49 years","Female",64,72,71,69,74,350
"Chichester 013B","E01031500","50-54 years","Female",81,70,79,77,74,381
"Chichester 013B","E01031500","55-59 years","Female",92,82,86,94,100,454
"Chichester 013B","E01031500","60-64 years","Female",68,87,92,100,107,454
"Chichester 013B","E01031500","65-69 years","Female",101,81,74,71,74,401
"Chichester 013B","E01031500","70-74 years","Female",98,111,113,110,112,544
"Chichester 013B","E01031500","75-79 years","Female",72,79,85,91,101,428
"Chichester 013B","E01031500","80-84 years","Female",54,51,55,63,69,292
"Chichester 013B","E01031500","85+ years","Female",93,94,100,101,93,481
"Chichester 013C","E01031501","0-4 years","Male",28,28,18,22,17,113
"Chichester 013C","E01031501","5-9 years","Male",29,24,27,25,30,135
"Chichester 013C","E01031501","10-14 years","Male",35,39,39,37,33,183
"Chichester 013C","E01031501","15-19 years","Male",36,28,24,26,26,140
"Chichester 013C","E01031501","20-24 years","Male",30,27,27,26,22,132
"Chichester 013C","E01031501","25-29 years","Male",19,19,20,16,14,88
"Chichester 013C","E01031501","30-34 years","Male",29,26,23,23,24,125
"Chichester 013C","E01031501","35-39 years","Male",25,24,21,24,20,114
"Chichester 013C","E01031501","40-44 years","Male",27,27,27,24,21,126
"Chichester 013C","E01031501","45-49 years","Male",48,49,41,41,44,223
"Chichester 013C","E01031501","50-54 years","Male",41,41,40,45,45,212
"Chichester 013C","E01031501","55-59 years","Male",46,54,57,51,47,255
"Chichester 013C","E01031501","60-64 years","Male",54,56,45,41,49,245
"Chichester 013C","E01031501","65-69 years","Male",47,43,49,44,46,229
"Chichester 013C","E01031501","70-74 years","Male",44,46,43,45,46,224
"Chichester 013C","E01031501","75-79 years","Male",47,50,51,57,53,258
"Chichester 013C","E01031501","80-84 years","Male",42,42,44,42,39,209
"Chichester 013C","E01031501","85+ years","Male",27,29,23,31,39,149
"Chichester 013C","E01031501","0-4 years","Female",21,25,25,20,19,110
"Chichester 013C","E01031501","5-9 years","Female",21,18,19,19,27,104
"Chichester 013C","E01031501","10-14 years","Female",21,19,19,24,24,107
"Chichester 013C","E01031501","15-19 years","Female",26,29,30,27,25,137
"Chichester 013C","E01031501","20-24 years","Female",16,16,14,15,21,82
"Chichester 013C","E01031501","25-29 years","Female",31,30,28,23,20,132
"Chichester 013C","E01031501","30-34 years","Female",25,21,23,23,20,112
"Chichester 013C","E01031501","35-39 years","Female",27,33,25,29,24,138
"Chichester 013C","E01031501","40-44 years","Female",38,40,31,36,42,187
"Chichester 013C","E01031501","45-49 years","Female",36,27,29,28,29,149
"Chichester 013C","E01031501","50-54 years","Female",53,49,51,48,47,248
"Chichester 013C","E01031501","55-59 years","Female",52,51,51,48,47,249
"Chichester 013C","E01031501","60-64 years","Female",49,57,57,47,65,275
"Chichester 013C","E01031501","65-69 years","Female",60,54,49,60,48,271
"Chichester 013C","E01031501","70-74 years","Female",56,61,66,77,84,344
"Chichester 013C","E01031501","75-79 years","Female",58,50,52,51,48,259
"Chichester 013C","E01031501","80-84 years","Female",46,48,52,63,65,274
"Chichester 013C","E01031501","85+ years","Female",77,74,77,75,81,384
"Chichester 013D","E01031529","0-4 years","Male",30,32,29,27,22,140
"Chichester 013D","E01031529","5-9 years","Male",30,32,29,29,32,152
"Chichester 013D","E01031529","10-14 years","Male",32,33,40,35,29,169
"Chichester 013D","E01031529","15-19 years","Male",32,33,31,31,31,158
"Chichester 013D","E01031529","20-24 years","Male",23,20,20,20,17,100
"Chichester 013D","E01031529","25-29 years","Male",23,21,23,24,20,111
"Chichester 013D","E01031529","30-34 years","Male",25,20,18,18,19,100
"Chichester 013D","E01031529","35-39 years","Male",16,20,19,20,19,94
"Chichester 013D","E01031529","40-44 years","Male",31,26,32,23,22,134
"Chichester 013D","E01031529","45-49 years","Male",49,51,49,54,45,248
"Chichester 013D","E01031529","50-54 years","Male",59,66,69,67,66,327
"Chichester 013D","E01031529","55-59 years","Male",52,56,57,54,46,265
"Chichester 013D","E01031529","60-64 years","Male",55,52,56,62,63,288
"Chichester 013D","E01031529","65-69 years","Male",40,46,52,46,52,236
"Chichester 013D","E01031529","70-74 years","Male",43,39,37,39,42,200
"Chichester 013D","E01031529","75-79 years","Male",37,42,41,38,40,198
"Chichester 013D","E01031529","80-84 years","Male",20,20,25,34,36,135
"Chichester 013D","E01031529","85+ years","Male",23,26,28,26,27,130
"Chichester 013D","E01031529","0-4 years","Female",18,19,17,15,13,82
"Chichester 013D","E01031529","5-9 years","Female",45,46,52,40,40,223
"Chichester 013D","E01031529","10-14 years","Female",25,31,27,31,31,145
"Chichester 013D","E01031529","15-19 years","Female",26,26,28,26,25,131
"Chichester 013D","E01031529","20-24 years","Female",20,25,20,18,16,99
"Chichester 013D","E01031529","25-29 years","Female",18,17,14,13,18,80
"Chichester 013D","E01031529","30-34 years","Female",15,21,26,26,21,109
"Chichester 013D","E01031529","35-39 years","Female",31,24,28,28,27,138
"Chichester 013D","E01031529","40-44 years","Female",38,40,33,32,35,178
"Chichester 013D","E01031529","45-49 years","Female",43,40,40,32,33,188
"Chichester 013D","E01031529","50-54 years","Female",44,40,47,54,56,241
"Chichester 013D","E01031529","55-59 years","Female",53,56,60,57,52,278
"Chichester 013D","E01031529","60-64 years","Female",43,46,45,49,49,232
"Chichester 013D","E01031529","65-69 years","Female",54,44,43,49,52,242
"Chichester 013D","E01031529","70-74 years","Female",39,44,49,51,53,236
"Chichester 013D","E01031529","75-79 years","Female",43,40,42,35,37,197
"Chichester 013D","E01031529","80-84 years","Female",24,25,30,32,31,142
"Chichester 013D","E01031529","85+ years","Female",12,11,16,21,24,84
"Chichester 013E","E01031540","0-4 years","Male",30,29,23,21,24,127
"Chichester 013E","E01031540","5-9 years","Male",24,22,25,21,17,109
"Chichester 013E","E01031540","10-14 years","Male",29,40,32,37,35,173
"Chichester 013E","E01031540","15-19 years","Male",19,21,23,21,16,100
"Chichester 013E","E01031540","20-24 years","Male",21,18,16,17,18,90
"Chichester 013E","E01031540","25-29 years","Male",18,13,15,17,11,74
"Chichester 013E","E01031540","30-34 years","Male",16,16,13,13,13,71
"Chichester 013E","E01031540","35-39 years","Male",27,28,28,23,21,127
"Chichester 013E","E01031540","40-44 years","Male",38,41,39,38,38,194
"Chichester 013E","E01031540","45-49 years","Male",25,19,23,24,26,117
"Chichester 013E","E01031540","50-54 years","Male",40,42,39,43,39,203
"Chichester 013E","E01031540","55-59 years","Male",37,38,38,37,36,186
"Chichester 013E","E01031540","60-64 years","Male",61,61,61,60,63,306
"Chichester 013E","E01031540","65-69 years","Male",52,48,51,51,54,256
"Chichester 013E","E01031540","70-74 years","Male",66,64,60,58,49,297
"Chichester 013E","E01031540","75-79 years","Male",46,47,50,49,60,252
"Chichester 013E","E01031540","80-84 years","Male",42,48,49,45,38,222
"Chichester 013E","E01031540","85+ years","Male",36,35,31,32,27,161
"Chichester 013E","E01031540","0-4 years","Female",38,27,28,29,28,150
"Chichester 013E","E01031540","5-9 years","Female",23,21,17,18,17,96
"Chichester 013E","E01031540","10-14 years","Female",14,17,16,20,22,89
"Chichester 013E","E01031540","15-19 years","Female",35,37,34,27,28,161
"Chichester 013E","E01031540","20-24 years","Female",21,12,16,15,18,82
"Chichester 013E","E01031540","25-29 years","Female",15,17,19,19,17,87
"Chichester 013E","E01031540","30-34 years","Female",24,24,20,13,19,100
"Chichester 013E","E01031540","35-39 years","Female",22,21,27,28,24,122
"Chichester 013E","E01031540","40-44 years","Female",35,37,32,29,32,165
"Chichester 013E","E01031540","45-49 years","Female",43,43,35,44,39,204
"Chichester 013E","E01031540","50-54 years","Female",49,52,56,51,50,258
"Chichester 013E","E01031540","55-59 years","Female",32,30,38,37,45,182
"Chichester 013E","E01031540","60-64 years","Female",46,49,53,57,48,253
"Chichester 013E","E01031540","65-69 years","Female",78,63,57,55,55,308
"Chichester 013E","E01031540","70-74 years","Female",67,72,66,69,66,340
"Chichester 013E","E01031540","75-79 years","Female",56,59,59,63,79,316
"Chichester 013E","E01031540","80-84 years","Female",51,42,43,46,35,217
"Chichester 013E","E01031540","85+ years","Female",64,65,63,53,51,296
"Chichester 013F","E01031541","0-4 years","Male",24,24,29,29,26,132
"Chichester 013F","E01031541","5-9 years","Male",22,24,22,29,34,131
"Chichester 013F","E01031541","10-14 years","Male",29,26,22,21,18,116
"Chichester 013F","E01031541","15-19 years","Male",23,22,17,18,13,93
"Chichester 013F","E01031541","20-24 years","Male",28,24,22,29,28,131
"Chichester 013F","E01031541","25-29 years","Male",29,26,23,25,24,127
"Chichester 013F","E01031541","30-34 years","Male",15,12,12,12,11,62
"Chichester 013F","E01031541","35-39 years","Male",26,16,17,22,23,104
"Chichester 013F","E01031541","40-44 years","Male",22,26,29,23,24,124
"Chichester 013F","E01031541","45-49 years","Male",33,31,26,27,25,142
"Chichester 013F","E01031541","50-54 years","Male",62,56,54,47,47,266
"Chichester 013F","E01031541","55-59 years","Male",43,41,41,42,44,211
"Chichester 013F","E01031541","60-64 years","Male",36,43,49,49,52,229
"Chichester 013F","E01031541","65-69 years","Male",55,45,44,47,41,232
"Chichester 013F","E01031541","70-74 years","Male",66,62,57,53,59,297
"Chichester 013F","E01031541","75-79 years","Male",37,43,45,48,52,225
"Chichester 013F","E01031541","80-84 years","Male",39,34,38,34,31,176
"Chichester 013F","E01031541","85+ years","Male",59,57,47,46,48,257
"Chichester 013F","E01031541","0-4 years","Female",19,24,26,21,19,109
"Chichester 013F","E01031541","5-9 years","Female",13,17,15,16,19,80
"Chichester 013F","E01031541","10-14 years","Female",27,23,29,24,26,129
"Chichester 013F","E01031541","15-19 years","Female",27,22,14,14,14,91
"Chichester 013F","E01031541","20-24 years","Female",22,23,16,19,24,104
"Chichester 013F","E01031541","25-29 years","Female",21,24,26,23,17,111
"Chichester 013F","E01031541","30-34 years","Female",16,16,15,14,14,75
"Chichester 013F","E01031541","35-39 years","Female",34,35,32,35,32,168
"Chichester 013F","E01031541","40-44 years","Female",27,28,25,24,27,131
"Chichester 013F","E01031541","45-49 years","Female",34,34,30,32,36,166
"Chichester 013F","E01031541","50-54 years","Female",52,49,46,48,41,236
"Chichester 013F","E01031541","55-59 years","Female",50,49,47,49,50,245
"Chichester 013F","E01031541","60-64 years","Female",53,40,38,36,43,210
"Chichester 013F","E01031541","65-69 years","Female",74,80,72,67,60,353
"Chichester 013F","E01031541","70-74 years","Female",107,90,89,88,86,460
"Chichester 013F","E01031541","75-79 years","Female",60,67,78,82,83,370
"Chichester 013F","E01031541","80-84 years","Female",53,57,44,45,44,243
"Chichester 013F","E01031541","85+ years","Female",63,64,73,67,66,333
"Chichester 013G","E01031542","0-4 years","Male",43,44,52,56,44,239
"Chichester 013G","E01031542","5-9 years","Male",50,57,61,56,65,289
"Chichester 013G","E01031542","10-14 years","Male",52,53,50,56,47,258
"Chichester 013G","E01031542","15-19 years","Male",43,44,37,40,36,200
"Chichester 013G","E01031542","20-24 years","Male",42,41,40,36,29,188
"Chichester 013G","E01031542","25-29 years","Male",15,17,17,15,17,81
"Chichester 013G","E01031542","30-34 years","Male",32,25,26,29,30,142
"Chichester 013G","E01031542","35-39 years","Male",32,34,33,31,23,153
"Chichester 013G","E01031542","40-44 years","Male",41,40,41,38,33,193
"Chichester 013G","E01031542","45-49 years","Male",93,82,85,67,57,384
"Chichester 013G","E01031542","50-54 years","Male",57,59,63,78,79,336
"Chichester 013G","E01031542","55-59 years","Male",85,81,81,77,93,417
"Chichester 013G","E01031542","60-64 years","Male",63,64,68,64,67,326
"Chichester 013G","E01031542","65-69 years","Male",84,75,74,75,73,381
"Chichester 013G","E01031542","70-74 years","Male",97,113,124,112,100,546
"Chichester 013G","E01031542","75-79 years","Male",62,57,66,73,76,334
"Chichester 013G","E01031542","80-84 years","Male",39,43,44,46,47,219
"Chichester 013G","E01031542","85+ years","Male",39,35,40,36,37,187
"Chichester 013G","E01031542","0-4 years","Female",32,36,39,32,30,169
"Chichester 013G","E01031542","5-9 years","Female",46,43,46,40,43,218
"Chichester 013G","E01031542","10-14 years","Female",72,71,65,68,65,341
"Chichester 013G","E01031542","15-19 years","Female",27,36,36,39,38,176
"Chichester 013G","E01031542","20-24 years","Female",27,23,22,19,23,114
"Chichester 013G","E01031542","25-29 years","Female",22,25,33,33,39,152
"Chichester 013G","E01031542","30-34 years","Female",34,32,37,32,28,163
"Chichester 013G","E01031542","35-39 years","Female",50,50,45,45,45,235
"Chichester 013G","E01031542","40-44 years","Female",43,49,56,48,48,244
"Chichester 013G","E01031542","45-49 years","Female",68,68,68,68,64,336
"Chichester 013G","E01031542","50-54 years","Female",89,79,74,77,73,392
"Chichester 013G","E01031542","55-59 years","Female",65,70,70,68,73,346
"Chichester 013G","E01031542","60-64 years","Female",79,84,85,85,90,423
"Chichester 013G","E01031542","65-69 years","Female",94,94,105,102,93,488
"Chichester 013G","E01031542","70-74 years","Female",81,93,86,87,93,440
"Chichester 013G","E01031542","75-79 years","Female",48,44,47,53,57,249
"Chichester 013G","E01031542","80-84 years","Female",39,42,47,44,43,215
"Chichester 013G","E01031542","85+ years","Female",30,30,33,37,35,165
"Chichester 014A","E01031522","0-4 years","Male",54,41,39,35,36,205
"Chichester 014A","E01031522","5-9 years","Male",82,84,68,63,50,347
"Chichester 014A","E01031522","10-14 years","Male",43,42,45,50,55,235
"Chichester 014A","E01031522","15-19 years","Male",50,60,47,51,51,259
"Chichester 014A","E01031522","20-24 years","Male",51,45,41,43,43,223
"Chichester 014A","E01031522","25-29 years","Male",44,46,46,37,42,215
"Chichester 014A","E01031522","30-34 years","Male",35,36,28,30,29,158
"Chichester 014A","E01031522","35-39 years","Male",39,38,36,37,37,187
"Chichester 014A","E01031522","40-44 years","Male",43,40,41,32,36,192
"Chichester 014A","E01031522","45-49 years","Male",64,56,58,68,58,304
"Chichester 014A","E01031522","50-54 years","Male",63,64,60,62,67,316
"Chichester 014A","E01031522","55-59 years","Male",65,65,73,86,80,369
"Chichester 014A","E01031522","60-64 years","Male",61,68,61,56,52,298
"Chichester 014A","E01031522","65-69 years","Male",76,74,73,75,72,370
"Chichester 014A","E01031522","70-74 years","Male",77,82,89,88,88,424
"Chichester 014A","E01031522","75-79 years","Male",38,38,44,51,55,226
"Chichester 014A","E01031522","80-84 years","Male",28,28,23,25,30,134
"Chichester 014A","E01031522","85+ years","Male",25,26,27,23,22,123
"Chichester 014A","E01031522","0-4 years","Female",52,57,47,47,50,253
"Chichester 014A","E01031522","5-9 years","Female",53,53,46,48,47,247
"Chichester 014A","E01031522","10-14 years","Female",43,41,50,48,43,225
"Chichester 014A","E01031522","15-19 years","Female",49,48,41,42,41,221
"Chichester 014A","E01031522","20-24 years","Female",52,49,45,52,48,246
"Chichester 014A","E01031522","25-29 years","Female",33,38,36,30,33,170
"Chichester 014A","E01031522","30-34 years","Female",38,30,29,24,25,146
"Chichester 014A","E01031522","35-39 years","Female",57,54,55,50,50,266
"Chichester 014A","E01031522","40-44 years","Female",64,59,51,46,41,261
"Chichester 014A","E01031522","45-49 years","Female",66,60,56,50,48,280
"Chichester 014A","E01031522","50-54 years","Female",73,71,75,67,69,355
"Chichester 014A","E01031522","55-59 years","Female",75,84,75,80,86,400
"Chichester 014A","E01031522","60-64 years","Female",68,73,90,81,71,383
"Chichester 014A","E01031522","65-69 years","Female",94,94,85,93,84,450
"Chichester 014A","E01031522","70-74 years","Female",55,67,74,73,81,350
"Chichester 014A","E01031522","75-79 years","Female",40,45,45,49,42,221
"Chichester 014A","E01031522","80-84 years","Female",50,48,51,51,55,255
"Chichester 014A","E01031522","85+ years","Female",64,53,61,60,62,300
"Chichester 014B","E01031523","0-4 years","Male",28,33,28,29,29,147
"Chichester 014B","E01031523","5-9 years","Male",40,38,45,40,33,196
"Chichester 014B","E01031523","10-14 years","Male",47,44,39,44,51,225
"Chichester 014B","E01031523","15-19 years","Male",55,48,43,47,44,237
"Chichester 014B","E01031523","20-24 years","Male",50,52,48,40,38,228
"Chichester 014B","E01031523","25-29 years","Male",20,21,28,28,30,127
"Chichester 014B","E01031523","30-34 years","Male",27,23,24,22,23,119
"Chichester 014B","E01031523","35-39 years","Male",35,35,29,38,31,168
"Chichester 014B","E01031523","40-44 years","Male",44,40,45,36,44,209
"Chichester 014B","E01031523","45-49 years","Male",44,41,38,49,43,215
"Chichester 014B","E01031523","50-54 years","Male",57,58,54,51,44,264
"Chichester 014B","E01031523","55-59 years","Male",56,57,61,57,62,293
"Chichester 014B","E01031523","60-64 years","Male",44,42,45,51,55,237
"Chichester 014B","E01031523","65-69 years","Male",61,54,49,47,51,262
"Chichester 014B","E01031523","70-74 years","Male",79,79,78,77,65,378
"Chichester 014B","E01031523","75-79 years","Male",60,57,60,50,50,277
"Chichester 014B","E01031523","80-84 years","Male",30,34,37,35,41,177
"Chichester 014B","E01031523","85+ years","Male",25,19,21,26,27,118
"Chichester 014B","E01031523","0-4 years","Female",36,35,29,24,15,139
"Chichester 014B","E01031523","5-9 years","Female",31,32,27,34,33,157
"Chichester 014B","E01031523","10-14 years","Female",36,33,39,41,44,193
"Chichester 014B","E01031523","15-19 years","Female",54,41,36,44,38,213
"Chichester 014B","E01031523","20-24 years","Female",25,26,26,26,25,128
"Chichester 014B","E01031523","25-29 years","Female",31,30,31,31,24,147
"Chichester 014B","E01031523","30-34 years","Female",27,27,21,20,19,114
"Chichester 014B","E01031523","35-39 years","Female",26,23,28,31,30,138
"Chichester 014B","E01031523","40-44 years","Female",53,48,44,45,41,231
"Chichester 014B","E01031523","45-49 years","Female",46,43,43,42,42,216
"Chichester 014B","E01031523","50-54 years","Female",61,62,64,74,81,342
"Chichester 014B","E01031523","55-59 years","Female",57,56,51,50,48,262
"Chichester 014B","E01031523","60-64 years","Female",56,60,66,60,63,305
"Chichester 014B","E01031523","65-69 years","Female",91,82,70,76,64,383
"Chichester 014B","E01031523","70-74 years","Female",68,68,77,78,86,377
"Chichester 014B","E01031523","75-79 years","Female",56,61,64,62,58,301
"Chichester 014B","E01031523","80-84 years","Female",51,47,46,49,57,250
"Chichester 014B","E01031523","85+ years","Female",48,50,52,54,48,252
"Chichester 014C","E01031524","0-4 years","Male",21,17,27,24,24,113
"Chichester 014C","E01031524","5-9 years","Male",22,25,35,31,32,145
"Chichester 014C","E01031524","10-14 years","Male",25,21,28,36,30,140
"Chichester 014C","E01031524","15-19 years","Male",25,30,32,20,25,132
"Chichester 014C","E01031524","20-24 years","Male",24,27,29,31,24,135
"Chichester 014C","E01031524","25-29 years","Male",34,33,37,40,42,186
"Chichester 014C","E01031524","30-34 years","Male",24,31,31,31,35,152
"Chichester 014C","E01031524","35-39 years","Male",15,15,23,22,23,98
"Chichester 014C","E01031524","40-44 years","Male",18,17,18,25,29,107
"Chichester 014C","E01031524","45-49 years","Male",43,40,44,32,27,186
"Chichester 014C","E01031524","50-54 years","Male",44,53,55,66,59,277
"Chichester 014C","E01031524","55-59 years","Male",56,62,66,57,57,298
"Chichester 014C","E01031524","60-64 years","Male",49,56,48,58,61,272
"Chichester 014C","E01031524","65-69 years","Male",75,67,82,83,78,385
"Chichester 014C","E01031524","70-74 years","Male",75,91,91,89,85,431
"Chichester 014C","E01031524","75-79 years","Male",61,59,60,60,66,306
"Chichester 014C","E01031524","80-84 years","Male",47,49,44,46,49,235
"Chichester 014C","E01031524","85+ years","Male",30,37,34,35,42,178
"Chichester 014C","E01031524","0-4 years","Female",37,46,66,69,71,289
"Chichester 014C","E01031524","5-9 years","Female",12,13,15,19,22,81
"Chichester 014C","E01031524","10-14 years","Female",22,27,30,33,29,141
"Chichester 014C","E01031524","15-19 years","Female",17,15,16,20,24,92
"Chichester 014C","E01031524","20-24 years","Female",19,20,19,19,20,97
"Chichester 014C","E01031524","25-29 years","Female",17,23,34,31,31,136
"Chichester 014C","E01031524","30-34 years","Female",17,16,23,30,22,108
"Chichester 014C","E01031524","35-39 years","Female",16,19,17,17,21,90
"Chichester 014C","E01031524","40-44 years","Female",34,26,40,34,34,168
"Chichester 014C","E01031524","45-49 years","Female",31,38,36,35,32,172
"Chichester 014C","E01031524","50-54 years","Female",44,47,49,56,59,255
"Chichester 014C","E01031524","55-59 years","Female",67,76,77,81,69,370
"Chichester 014C","E01031524","60-64 years","Female",67,69,71,72,74,353
"Chichester 014C","E01031524","65-69 years","Female",102,99,94,86,81,462
"Chichester 014C","E01031524","70-74 years","Female",90,94,102,111,121,518
"Chichester 014C","E01031524","75-79 years","Female",74,77,70,72,70,363
"Chichester 014C","E01031524","80-84 years","Female",51,64,67,66,63,311
"Chichester 014C","E01031524","85+ years","Female",49,45,49,51,54,248
"Chichester 014D","E01031525","0-4 years","Male",30,29,28,29,25,141
"Chichester 014D","E01031525","5-9 years","Male",22,31,34,29,28,144
"Chichester 014D","E01031525","10-14 years","Male",36,32,31,32,33,164
"Chichester 014D","E01031525","15-19 years","Male",24,30,34,37,43,168
"Chichester 014D","E01031525","20-24 years","Male",23,20,21,15,18,97
"Chichester 014D","E01031525","25-29 years","Male",25,25,24,22,16,112
"Chichester 014D","E01031525","30-34 years","Male",29,26,29,30,32,146
"Chichester 014D","E01031525","35-39 years","Male",29,32,36,30,27,154
"Chichester 014D","E01031525","40-44 years","Male",19,23,20,24,23,109
"Chichester 014D","E01031525","45-49 years","Male",33,28,30,33,33,157
"Chichester 014D","E01031525","50-54 years","Male",43,47,41,39,33,203
"Chichester 014D","E01031525","55-59 years","Male",42,39,40,45,52,218
"Chichester 014D","E01031525","60-64 years","Male",35,44,51,51,55,236
"Chichester 014D","E01031525","65-69 years","Male",70,58,45,43,46,262
"Chichester 014D","E01031525","70-74 years","Male",64,70,77,81,78,370
"Chichester 014D","E01031525","75-79 years","Male",31,28,35,39,40,173
"Chichester 014D","E01031525","80-84 years","Male",29,37,32,32,36,166
"Chichester 014D","E01031525","85+ years","Male",14,18,25,23,23,103
"Chichester 014D","E01031525","0-4 years","Female",14,16,13,12,10,65
"Chichester 014D","E01031525","5-9 years","Female",28,32,32,27,27,146
"Chichester 014D","E01031525","10-14 years","Female",41,45,42,50,51,229
"Chichester 014D","E01031525","15-19 years","Female",23,23,31,33,38,148
"Chichester 014D","E01031525","20-24 years","Female",42,34,28,25,24,153
"Chichester 014D","E01031525","25-29 years","Female",18,21,21,15,15,90
"Chichester 014D","E01031525","30-34 years","Female",20,28,35,34,34,151
"Chichester 014D","E01031525","35-39 years","Female",27,27,29,28,28,139
"Chichester 014D","E01031525","40-44 years","Female",36,36,34,30,23,159
"Chichester 014D","E01031525","45-49 years","Female",40,39,40,40,50,209
"Chichester 014D","E01031525","50-54 years","Female",56,54,56,49,40,255
"Chichester 014D","E01031525","55-59 years","Female",45,49,52,55,56,257
"Chichester 014D","E01031525","60-64 years","Female",60,53,48,55,57,273
"Chichester 014D","E01031525","65-69 years","Female",89,79,86,84,80,418
"Chichester 014D","E01031525","70-74 years","Female",66,83,86,86,82,403
"Chichester 014D","E01031525","75-79 years","Female",48,41,44,37,49,219
"Chichester 014D","E01031525","80-84 years","Female",31,38,46,50,46,211
"Chichester 014D","E01031525","85+ years","Female",36,37,35,37,28,173
"Chichester 014E","E01031526","0-4 years","Male",15,16,20,23,17,91
"Chichester 014E","E01031526","5-9 years","Male",35,37,31,37,37,177
"Chichester 014E","E01031526","10-14 years","Male",21,23,26,21,22,113
"Chichester 014E","E01031526","15-19 years","Male",38,35,24,27,22,146
"Chichester 014E","E01031526","20-24 years","Male",19,18,22,17,19,95
"Chichester 014E","E01031526","25-29 years","Male",11,15,18,18,15,77
"Chichester 014E","E01031526","30-34 years","Male",10,9,6,3,1,29
"Chichester 014E","E01031526","35-39 years","Male",19,18,20,15,19,91
"Chichester 014E","E01031526","40-44 years","Male",20,17,19,19,15,90
"Chichester 014E","E01031526","45-49 years","Male",37,34,34,31,33,169
"Chichester 014E","E01031526","50-54 years","Male",42,39,34,36,39,190
"Chichester 014E","E01031526","55-59 years","Male",48,54,57,54,51,264
"Chichester 014E","E01031526","60-64 years","Male",56,45,48,45,53,247
"Chichester 014E","E01031526","65-69 years","Male",57,56,58,61,62,294
"Chichester 014E","E01031526","70-74 years","Male",55,58,60,61,60,294
"Chichester 014E","E01031526","75-79 years","Male",41,43,40,41,39,204
"Chichester 014E","E01031526","80-84 years","Male",33,28,34,31,29,155
"Chichester 014E","E01031526","85+ years","Male",33,40,41,50,45,209
"Chichester 014E","E01031526","0-4 years","Female",17,17,13,13,14,74
"Chichester 014E","E01031526","5-9 years","Female",25,24,28,30,24,131
"Chichester 014E","E01031526","10-14 years","Female",30,26,23,20,24,123
"Chichester 014E","E01031526","15-19 years","Female",25,31,34,35,34,159
"Chichester 014E","E01031526","20-24 years","Female",25,21,17,23,17,103
"Chichester 014E","E01031526","25-29 years","Female",18,19,16,12,15,80
"Chichester 014E","E01031526","30-34 years","Female",23,30,33,29,28,143
"Chichester 014E","E01031526","35-39 years","Female",29,21,22,20,17,109
"Chichester 014E","E01031526","40-44 years","Female",33,35,27,23,28,146
"Chichester 014E","E01031526","45-49 years","Female",29,25,24,22,21,121
"Chichester 014E","E01031526","50-54 years","Female",32,36,40,41,38,187
"Chichester 014E","E01031526","55-59 years","Female",48,41,39,47,45,220
"Chichester 014E","E01031526","60-64 years","Female",61,61,60,48,46,276
"Chichester 014E","E01031526","65-69 years","Female",66,62,62,58,63,311
"Chichester 014E","E01031526","70-74 years","Female",67,77,74,89,76,383
"Chichester 014E","E01031526","75-79 years","Female",44,46,53,46,55,244
"Chichester 014E","E01031526","80-84 years","Female",37,33,35,38,43,186
"Chichester 014E","E01031526","85+ years","Female",80,67,52,48,48,295
"Chichester 014F","E01031527","0-4 years","Male",21,20,22,14,15,92
"Chichester 014F","E01031527","5-9 years","Male",23,27,26,29,24,129
"Chichester 014F","E01031527","10-14 years","Male",26,22,22,25,22,117
"Chichester 014F","E01031527","15-19 years","Male",35,35,31,29,28,158
"Chichester 014F","E01031527","20-24 years","Male",36,28,28,31,25,148
"Chichester 014F","E01031527","25-29 years","Male",32,40,42,35,37,186
"Chichester 014F","E01031527","30-34 years","Male",22,21,19,19,20,101
"Chichester 014F","E01031527","35-39 years","Male",24,26,26,28,24,128
"Chichester 014F","E01031527","40-44 years","Male",21,20,21,18,19,99
"Chichester 014F","E01031527","45-49 years","Male",34,38,34,29,29,164
"Chichester 014F","E01031527","50-54 years","Male",58,54,48,42,37,239
"Chichester 014F","E01031527","55-59 years","Male",55,56,66,70,61,308
"Chichester 014F","E01031527","60-64 years","Male",66,72,68,73,91,370
"Chichester 014F","E01031527","65-69 years","Male",59,65,56,65,63,308
"Chichester 014F","E01031527","70-74 years","Male",74,81,89,78,74,396
"Chichester 014F","E01031527","75-79 years","Male",51,39,40,43,47,220
"Chichester 014F","E01031527","80-84 years","Male",47,46,43,41,38,215
"Chichester 014F","E01031527","85+ years","Male",30,36,38,41,47,192
"Chichester 014F","E01031527","0-4 years","Female",24,18,20,23,25,110
"Chichester 014F","E01031527","5-9 years","Female",27,30,28,27,25,137
"Chichester 014F","E01031527","10-14 years","Female",26,27,29,24,21,127
"Chichester 014F","E01031527","15-19 years","Female",32,28,29,31,33,153
"Chichester 014F","E01031527","20-24 years","Female",24,20,18,18,15,95
"Chichester 014F","E01031527","25-29 years","Female",25,30,28,25,28,136
"Chichester 014F","E01031527","30-34 years","Female",21,19,18,25,26,109
"Chichester 014F","E01031527","35-39 years","Female",27,24,28,22,24,125
"Chichester 014F","E01031527","40-44 years","Female",31,33,29,28,24,145
"Chichester 014F","E01031527","45-49 years","Female",61,55,48,44,39,247
"Chichester 014F","E01031527","50-54 years","Female",63,68,66,65,66,328
"Chichester 014F","E01031527","55-59 years","Female",70,63,59,69,69,330
"Chichester 014F","E01031527","60-64 years","Female",78,81,88,76,73,396
"Chichester 014F","E01031527","65-69 years","Female",63,63,65,71,82,344
"Chichester 014F","E01031527","70-74 years","Female",101,91,91,89,90,462
"Chichester 014F","E01031527","75-79 years","Female",65,80,79,74,68,366
"Chichester 014F","E01031527","80-84 years","Female",49,39,44,48,48,228
"Chichester 014F","E01031527","85+ years","Female",38,52,51,50,59,250
"Chichester 014G","E01031528","0-4 years","Male",22,29,20,23,27,121
"Chichester 014G","E01031528","5-9 years","Male",29,28,24,26,21,128
"Chichester 014G","E01031528","10-14 years","Male",33,33,26,22,23,137
"Chichester 014G","E01031528","15-19 years","Male",31,31,29,24,30,145
"Chichester 014G","E01031528","20-24 years","Male",31,29,31,29,28,148
"Chichester 014G","E01031528","25-29 years","Male",42,41,44,40,30,197
"Chichester 014G","E01031528","30-34 years","Male",24,24,21,24,30,123
"Chichester 014G","E01031528","35-39 years","Male",19,20,26,25,22,112
"Chichester 014G","E01031528","40-44 years","Male",42,44,34,29,35,184
"Chichester 014G","E01031528","45-49 years","Male",47,39,40,34,31,191
"Chichester 014G","E01031528","50-54 years","Male",51,57,59,58,56,281
"Chichester 014G","E01031528","55-59 years","Male",54,59,61,64,66,304
"Chichester 014G","E01031528","60-64 years","Male",58,53,53,49,52,265
"Chichester 014G","E01031528","65-69 years","Male",67,67,66,64,66,330
"Chichester 014G","E01031528","70-74 years","Male",41,47,56,66,59,269
"Chichester 014G","E01031528","75-79 years","Male",36,33,32,32,32,165
"Chichester 014G","E01031528","80-84 years","Male",38,35,32,36,37,178
"Chichester 014G","E01031528","85+ years","Male",25,28,31,28,28,140
"Chichester 014G","E01031528","0-4 years","Female",27,21,17,19,24,108
"Chichester 014G","E01031528","5-9 years","Female",30,24,22,27,21,124
"Chichester 014G","E01031528","10-14 years","Female",41,37,33,35,34,180
"Chichester 014G","E01031528","15-19 years","Female",26,26,25,23,23,123
"Chichester 014G","E01031528","20-24 years","Female",21,20,18,20,16,95
"Chichester 014G","E01031528","25-29 years","Female",18,20,17,21,19,95
"Chichester 014G","E01031528","30-34 years","Female",42,39,32,29,30,172
"Chichester 014G","E01031528","35-39 years","Female",14,13,16,17,21,81
"Chichester 014G","E01031528","40-44 years","Female",66,57,50,39,31,243
"Chichester 014G","E01031528","45-49 years","Female",36,45,44,46,49,220
"Chichester 014G","E01031528","50-54 years","Female",56,49,46,45,37,233
"Chichester 014G","E01031528","55-59 years","Female",64,77,73,77,72,363
"Chichester 014G","E01031528","60-64 years","Female",56,60,66,68,68,318
"Chichester 014G","E01031528","65-69 years","Female",52,51,59,54,60,276
"Chichester 014G","E01031528","70-74 years","Female",70,76,72,86,77,381
"Chichester 014G","E01031528","75-79 years","Female",44,39,47,46,65,241
"Chichester 014G","E01031528","80-84 years","Female",33,33,36,35,36,173
"Chichester 014G","E01031528","85+ years","Female",72,71,68,70,62,343
"Crawley 001A","E01031573","0-4 years","Male",73,75,72,73,71,364
"Crawley 001A","E01031573","5-9 years","Male",84,84,90,86,79,423
"Crawley 001A","E01031573","10-14 years","Male",71,84,90,81,88,414
"Crawley 001A","E01031573","15-19 years","Male",50,51,45,55,63,264
"Crawley 001A","E01031573","20-24 years","Male",39,36,33,35,35,178
"Crawley 001A","E01031573","25-29 years","Male",69,74,66,58,52,319
"Crawley 001A","E01031573","30-34 years","Male",64,66,65,72,76,343
"Crawley 001A","E01031573","35-39 years","Male",71,69,65,60,51,316
"Crawley 001A","E01031573","40-44 years","Male",74,78,80,90,103,425
"Crawley 001A","E01031573","45-49 years","Male",59,57,60,57,55,288
"Crawley 001A","E01031573","50-54 years","Male",59,61,58,55,58,291
"Crawley 001A","E01031573","55-59 years","Male",44,46,46,47,53,236
"Crawley 001A","E01031573","60-64 years","Male",36,40,46,52,52,226
"Crawley 001A","E01031573","65-69 years","Male",22,22,32,30,30,136
"Crawley 001A","E01031573","70-74 years","Male",18,18,21,20,25,102
"Crawley 001A","E01031573","75-79 years","Male",11,10,11,12,13,57
"Crawley 001A","E01031573","80-84 years","Male",15,12,11,10,7,55
"Crawley 001A","E01031573","85+ years","Male",18,15,14,14,12,73
"Crawley 001A","E01031573","0-4 years","Female",68,55,51,46,36,256
"Crawley 001A","E01031573","5-9 years","Female",76,87,97,85,83,428
"Crawley 001A","E01031573","10-14 years","Female",53,52,58,72,83,318
"Crawley 001A","E01031573","15-19 years","Female",40,40,48,44,47,219
"Crawley 001A","E01031573","20-24 years","Female",43,36,33,32,33,177
"Crawley 001A","E01031573","25-29 years","Female",72,68,71,64,63,338
"Crawley 001A","E01031573","30-34 years","Female",78,79,79,73,63,372
"Crawley 001A","E01031573","35-39 years","Female",81,80,93,94,95,443
"Crawley 001A","E01031573","40-44 years","Female",60,66,60,62,65,313
"Crawley 001A","E01031573","45-49 years","Female",54,52,53,53,55,267
"Crawley 001A","E01031573","50-54 years","Female",38,38,41,43,49,209
"Crawley 001A","E01031573","55-59 years","Female",52,55,50,49,48,254
"Crawley 001A","E01031573","60-64 years","Female",48,35,44,46,48,221
"Crawley 001A","E01031573","65-69 years","Female",26,33,33,35,35,162
"Crawley 001A","E01031573","70-74 years","Female",23,25,21,23,24,116
"Crawley 001A","E01031573","75-79 years","Female",13,12,14,15,13,67
"Crawley 001A","E01031573","80-84 years","Female",13,13,11,6,9,52
"Crawley 001A","E01031573","85+ years","Female",22,25,22,18,17,104
"Crawley 001B","E01031574","0-4 years","Male",74,69,55,66,64,328
"Crawley 001B","E01031574","5-9 years","Male",90,88,83,80,77,418
"Crawley 001B","E01031574","10-14 years","Male",88,93,86,94,92,453
"Crawley 001B","E01031574","15-19 years","Male",68,58,67,69,73,335
"Crawley 001B","E01031574","20-24 years","Male",36,35,37,39,38,185
"Crawley 001B","E01031574","25-29 years","Male",40,39,41,36,38,194
"Crawley 001B","E01031574","30-34 years","Male",67,68,52,53,49,289
"Crawley 001B","E01031574","35-39 years","Male",93,99,108,98,86,484
"Crawley 001B","E01031574","40-44 years","Male",82,82,81,81,81,407
"Crawley 001B","E01031574","45-49 years","Male",86,77,83,76,73,395
"Crawley 001B","E01031574","50-54 years","Male",46,54,62,65,71,298
"Crawley 001B","E01031574","55-59 years","Male",44,45,35,33,44,201
"Crawley 001B","E01031574","60-64 years","Male",37,39,45,44,38,203
"Crawley 001B","E01031574","65-69 years","Male",29,32,35,39,43,178
"Crawley 001B","E01031574","70-74 years","Male",19,21,20,21,20,101
"Crawley 001B","E01031574","75-79 years","Male",15,12,15,13,11,66
"Crawley 001B","E01031574","80-84 years","Male",18,14,13,15,12,72
"Crawley 001B","E01031574","85+ years","Male",15,14,13,12,17,71
"Crawley 001B","E01031574","0-4 years","Female",52,52,52,67,65,288
"Crawley 001B","E01031574","5-9 years","Female",58,56,53,47,47,261
"Crawley 001B","E01031574","10-14 years","Female",78,78,74,81,87,398
"Crawley 001B","E01031574","15-19 years","Female",57,62,67,68,67,321
"Crawley 001B","E01031574","20-24 years","Female",41,36,34,37,33,181
"Crawley 001B","E01031574","25-29 years","Female",45,47,47,49,47,235
"Crawley 001B","E01031574","30-34 years","Female",91,76,63,55,50,335
"Crawley 001B","E01031574","35-39 years","Female",76,81,83,86,90,416
"Crawley 001B","E01031574","40-44 years","Female",86,77,82,79,70,394
"Crawley 001B","E01031574","45-49 years","Female",88,85,76,81,75,405
"Crawley 001B","E01031574","50-54 years","Female",54,52,57,60,65,288
"Crawley 001B","E01031574","55-59 years","Female",54,56,64,59,51,284
"Crawley 001B","E01031574","60-64 years","Female",24,29,31,39,42,165
"Crawley 001B","E01031574","65-69 years","Female",30,26,17,13,13,99
"Crawley 001B","E01031574","70-74 years","Female",22,24,28,31,30,135
"Crawley 001B","E01031574","75-79 years","Female",21,21,21,17,18,98
"Crawley 001B","E01031574","80-84 years","Female",25,22,20,18,19,104
"Crawley 001B","E01031574","85+ years","Female",19,20,23,21,22,105
"Crawley 001C","E01031575","0-4 years","Male",74,72,74,70,62,352
"Crawley 001C","E01031575","5-9 years","Male",62,63,58,63,68,314
"Crawley 001C","E01031575","10-14 years","Male",54,58,57,52,55,276
"Crawley 001C","E01031575","15-19 years","Male",46,49,49,41,44,229
"Crawley 001C","E01031575","20-24 years","Male",85,76,80,89,72,402
"Crawley 001C","E01031575","25-29 years","Male",91,85,81,69,70,396
"Crawley 001C","E01031575","30-34 years","Male",130,138,131,128,117,644
"Crawley 001C","E01031575","35-39 years","Male",110,117,122,117,123,589
"Crawley 001C","E01031575","40-44 years","Male",84,86,93,91,92,446
"Crawley 001C","E01031575","45-49 years","Male",53,56,65,59,57,290
"Crawley 001C","E01031575","50-54 years","Male",66,59,56,60,63,304
"Crawley 001C","E01031575","55-59 years","Male",49,54,61,63,64,291
"Crawley 001C","E01031575","60-64 years","Male",49,46,46,49,54,244
"Crawley 001C","E01031575","65-69 years","Male",34,31,25,33,33,156
"Crawley 001C","E01031575","70-74 years","Male",13,18,19,17,18,85
"Crawley 001C","E01031575","75-79 years","Male",11,12,16,20,21,80
"Crawley 001C","E01031575","80-84 years","Male",5,3,4,2,1,15
"Crawley 001C","E01031575","85+ years","Male",14,11,10,8,9,52
"Crawley 001C","E01031575","0-4 years","Female",65,53,56,53,44,271
"Crawley 001C","E01031575","5-9 years","Female",51,58,63,59,58,289
"Crawley 001C","E01031575","10-14 years","Female",53,57,47,47,49,253
"Crawley 001C","E01031575","15-19 years","Female",36,36,42,43,44,201
"Crawley 001C","E01031575","20-24 years","Female",48,43,49,48,46,234
"Crawley 001C","E01031575","25-29 years","Female",80,73,69,63,53,338
"Crawley 001C","E01031575","30-34 years","Female",76,79,81,72,78,386
"Crawley 001C","E01031575","35-39 years","Female",71,86,67,65,66,355
"Crawley 001C","E01031575","40-44 years","Female",57,46,59,59,68,289
"Crawley 001C","E01031575","45-49 years","Female",46,57,56,48,50,257
"Crawley 001C","E01031575","50-54 years","Female",53,54,61,53,50,271
"Crawley 001C","E01031575","55-59 years","Female",52,49,53,50,55,259
"Crawley 001C","E01031575","60-64 years","Female",41,39,44,55,42,221
"Crawley 001C","E01031575","65-69 years","Female",32,35,32,29,39,167
"Crawley 001C","E01031575","70-74 years","Female",24,25,20,27,30,126
"Crawley 001C","E01031575","75-79 years","Female",17,17,22,18,17,91
"Crawley 001C","E01031575","80-84 years","Female",12,11,11,10,8,52
"Crawley 001C","E01031575","85+ years","Female",25,26,26,24,25,126
"Crawley 001D","E01031576","0-4 years","Male",78,75,81,62,62,358
"Crawley 001D","E01031576","5-9 years","Male",81,86,84,92,97,440
"Crawley 001D","E01031576","10-14 years","Male",58,59,58,54,58,287
"Crawley 001D","E01031576","15-19 years","Male",74,58,65,74,76,347
"Crawley 001D","E01031576","20-24 years","Male",37,43,44,45,46,215
"Crawley 001D","E01031576","25-29 years","Male",64,62,63,54,50,293
"Crawley 001D","E01031576","30-34 years","Male",80,75,73,69,75,372
"Crawley 001D","E01031576","35-39 years","Male",58,55,67,77,71,328
"Crawley 001D","E01031576","40-44 years","Male",48,49,46,45,42,230
"Crawley 001D","E01031576","45-49 years","Male",62,69,71,70,77,349
"Crawley 001D","E01031576","50-54 years","Male",57,54,64,60,61,296
"Crawley 001D","E01031576","55-59 years","Male",57,57,62,63,68,307
"Crawley 001D","E01031576","60-64 years","Male",40,41,40,43,40,204
"Crawley 001D","E01031576","65-69 years","Male",36,34,36,37,38,181
"Crawley 001D","E01031576","70-74 years","Male",18,19,18,22,23,100
"Crawley 001D","E01031576","75-79 years","Male",11,11,15,14,17,68
"Crawley 001D","E01031576","80-84 years","Male",19,19,14,11,11,74
"Crawley 001D","E01031576","85+ years","Male",10,14,17,15,11,67
"Crawley 001D","E01031576","0-4 years","Female",63,61,59,50,59,292
"Crawley 001D","E01031576","5-9 years","Female",68,67,73,81,75,364
"Crawley 001D","E01031576","10-14 years","Female",64,56,57,50,53,280
"Crawley 001D","E01031576","15-19 years","Female",72,71,74,69,60,346
"Crawley 001D","E01031576","20-24 years","Female",36,41,47,44,46,214
"Crawley 001D","E01031576","25-29 years","Female",57,53,65,58,49,282
"Crawley 001D","E01031576","30-34 years","Female",91,91,87,79,74,422
"Crawley 001D","E01031576","35-39 years","Female",58,66,58,61,63,306
"Crawley 001D","E01031576","40-44 years","Female",45,41,46,45,46,223
"Crawley 001D","E01031576","45-49 years","Female",37,36,42,53,57,225
"Crawley 001D","E01031576","50-54 years","Female",42,46,46,41,39,214
"Crawley 001D","E01031576","55-59 years","Female",40,34,36,38,34,182
"Crawley 001D","E01031576","60-64 years","Female",40,38,37,35,39,189
"Crawley 001D","E01031576","65-69 years","Female",41,39,37,33,37,187
"Crawley 001D","E01031576","70-74 years","Female",19,25,23,29,32,128
"Crawley 001D","E01031576","75-79 years","Female",26,25,23,26,22,122
"Crawley 001D","E01031576","80-84 years","Female",13,11,13,11,11,59
"Crawley 001D","E01031576","85+ years","Female",24,22,19,21,17,103
"Crawley 001E","E01031577","0-4 years","Male",58,60,61,64,47,290
"Crawley 001E","E01031577","5-9 years","Male",65,57,55,56,53,286
"Crawley 001E","E01031577","10-14 years","Male",43,39,42,54,61,239
"Crawley 001E","E01031577","15-19 years","Male",39,43,36,35,32,185
"Crawley 001E","E01031577","20-24 years","Male",44,51,53,47,47,242
"Crawley 001E","E01031577","25-29 years","Male",54,56,55,51,41,257
"Crawley 001E","E01031577","30-34 years","Male",54,46,49,49,45,243
"Crawley 001E","E01031577","35-39 years","Male",72,83,82,88,80,405
"Crawley 001E","E01031577","40-44 years","Male",54,62,56,66,73,311
"Crawley 001E","E01031577","45-49 years","Male",39,40,51,48,41,219
"Crawley 001E","E01031577","50-54 years","Male",34,32,29,29,30,154
"Crawley 001E","E01031577","55-59 years","Male",59,61,55,57,51,283
"Crawley 001E","E01031577","60-64 years","Male",32,28,32,37,41,170
"Crawley 001E","E01031577","65-69 years","Male",22,27,29,28,33,139
"Crawley 001E","E01031577","70-74 years","Male",20,19,19,20,19,97
"Crawley 001E","E01031577","75-79 years","Male",22,20,21,18,17,98
"Crawley 001E","E01031577","80-84 years","Male",8,9,12,16,14,59
"Crawley 001E","E01031577","85+ years","Male",14,12,13,13,10,62
"Crawley 001E","E01031577","0-4 years","Female",46,44,46,57,63,256
"Crawley 001E","E01031577","5-9 years","Female",51,54,51,53,42,251
"Crawley 001E","E01031577","10-14 years","Female",30,33,33,32,37,165
"Crawley 001E","E01031577","15-19 years","Female",22,17,20,25,33,117
"Crawley 001E","E01031577","20-24 years","Female",21,21,25,19,15,101
"Crawley 001E","E01031577","25-29 years","Female",41,44,40,52,51,228
"Crawley 001E","E01031577","30-34 years","Female",80,64,63,60,56,323
"Crawley 001E","E01031577","35-39 years","Female",56,66,66,79,75,342
"Crawley 001E","E01031577","40-44 years","Female",37,34,36,43,52,202
"Crawley 001E","E01031577","45-49 years","Female",49,53,48,49,38,237
"Crawley 001E","E01031577","50-54 years","Female",38,41,43,47,48,217
"Crawley 001E","E01031577","55-59 years","Female",49,44,43,40,38,214
"Crawley 001E","E01031577","60-64 years","Female",30,40,41,46,56,213
"Crawley 001E","E01031577","65-69 years","Female",25,21,15,17,19,97
"Crawley 001E","E01031577","70-74 years","Female",29,33,37,38,33,170
"Crawley 001E","E01031577","75-79 years","Female",20,23,19,17,15,94
"Crawley 001E","E01031577","80-84 years","Female",15,17,13,16,19,80
"Crawley 001E","E01031577","85+ years","Female",5,3,2,5,5,20
"Crawley 002A","E01031586","0-4 years","Male",89,91,86,82,87,435
"Crawley 002A","E01031586","5-9 years","Male",97,103,98,83,81,462
"Crawley 002A","E01031586","10-14 years","Male",79,71,83,78,77,388
"Crawley 002A","E01031586","15-19 years","Male",30,37,33,39,45,184
"Crawley 002A","E01031586","20-24 years","Male",41,36,41,37,37,192
"Crawley 002A","E01031586","25-29 years","Male",69,80,78,73,67,367
"Crawley 002A","E01031586","30-34 years","Male",77,69,71,65,71,353
"Crawley 002A","E01031586","35-39 years","Male",108,114,105,91,76,494
"Crawley 002A","E01031586","40-44 years","Male",71,68,79,79,77,374
"Crawley 002A","E01031586","45-49 years","Male",52,62,57,67,72,310
"Crawley 002A","E01031586","50-54 years","Male",53,45,49,52,43,242
"Crawley 002A","E01031586","55-59 years","Male",43,51,49,49,56,248
"Crawley 002A","E01031586","60-64 years","Male",29,30,32,30,35,156
"Crawley 002A","E01031586","65-69 years","Male",48,46,41,35,39,209
"Crawley 002A","E01031586","70-74 years","Male",22,26,27,26,30,131
"Crawley 002A","E01031586","75-79 years","Male",11,10,13,9,8,51
"Crawley 002A","E01031586","80-84 years","Male",17,17,15,12,13,74
"Crawley 002A","E01031586","85+ years","Male",2,2,2,3,5,14
"Crawley 002A","E01031586","0-4 years","Female",91,79,77,71,78,396
"Crawley 002A","E01031586","5-9 years","Female",77,80,75,67,70,369
"Crawley 002A","E01031586","10-14 years","Female",43,47,48,57,56,251
"Crawley 002A","E01031586","15-19 years","Female",37,37,39,37,39,189
"Crawley 002A","E01031586","20-24 years","Female",49,43,44,38,42,216
"Crawley 002A","E01031586","25-29 years","Female",62,56,58,50,54,280
"Crawley 002A","E01031586","30-34 years","Female",99,80,80,76,76,411
"Crawley 002A","E01031586","35-39 years","Female",100,104,96,83,75,458
"Crawley 002A","E01031586","40-44 years","Female",58,64,79,78,86,365
"Crawley 002A","E01031586","45-49 years","Female",39,40,35,35,43,192
"Crawley 002A","E01031586","50-54 years","Female",40,41,43,46,46,216
"Crawley 002A","E01031586","55-59 years","Female",53,52,48,46,45,244
"Crawley 002A","E01031586","60-64 years","Female",41,43,47,39,42,212
"Crawley 002A","E01031586","65-69 years","Female",40,43,37,41,39,200
"Crawley 002A","E01031586","70-74 years","Female",21,27,31,31,36,146
"Crawley 002A","E01031586","75-79 years","Female",14,17,14,16,12,73
"Crawley 002A","E01031586","80-84 years","Female",15,19,18,14,14,80
"Crawley 002A","E01031586","85+ years","Female",21,15,18,22,20,96
"Crawley 002B","E01031587","0-4 years","Male",55,73,87,127,164,506
"Crawley 002B","E01031587","5-9 years","Male",62,88,116,146,159,571
"Crawley 002B","E01031587","10-14 years","Male",50,59,69,82,119,379
"Crawley 002B","E01031587","15-19 years","Male",46,41,39,47,53,226
"Crawley 002B","E01031587","20-24 years","Male",53,53,43,47,55,251
"Crawley 002B","E01031587","25-29 years","Male",86,90,90,101,111,478
"Crawley 002B","E01031587","30-34 years","Male",59,71,95,119,128,472
"Crawley 002B","E01031587","35-39 years","Male",54,62,60,84,108,368
"Crawley 002B","E01031587","40-44 years","Male",53,60,78,86,98,375
"Crawley 002B","E01031587","45-49 years","Male",70,80,78,90,97,415
"Crawley 002B","E01031587","50-54 years","Male",66,62,69,73,81,351
"Crawley 002B","E01031587","55-59 years","Male",58,69,59,58,64,308
"Crawley 002B","E01031587","60-64 years","Male",59,55,65,83,78,340
"Crawley 002B","E01031587","65-69 years","Male",59,54,57,55,65,290
"Crawley 002B","E01031587","70-74 years","Male",36,47,43,53,54,233
"Crawley 002B","E01031587","75-79 years","Male",27,27,28,23,23,128
"Crawley 002B","E01031587","80-84 years","Male",22,25,27,26,25,125
"Crawley 002B","E01031587","85+ years","Male",10,12,17,19,21,79
"Crawley 002B","E01031587","0-4 years","Female",43,64,79,107,139,432
"Crawley 002B","E01031587","5-9 years","Female",56,66,66,83,130,401
"Crawley 002B","E01031587","10-14 years","Female",43,57,77,86,104,367
"Crawley 002B","E01031587","15-19 years","Female",40,47,47,57,77,268
"Crawley 002B","E01031587","20-24 years","Female",38,40,43,55,68,244
"Crawley 002B","E01031587","25-29 years","Female",50,54,72,88,100,364
"Crawley 002B","E01031587","30-34 years","Female",56,79,90,131,160,516
"Crawley 002B","E01031587","35-39 years","Female",72,86,94,110,131,493
"Crawley 002B","E01031587","40-44 years","Female",57,65,76,91,124,413
"Crawley 002B","E01031587","45-49 years","Female",66,75,77,86,90,394
"Crawley 002B","E01031587","50-54 years","Female",69,63,69,70,75,346
"Crawley 002B","E01031587","55-59 years","Female",64,71,66,75,73,349
"Crawley 002B","E01031587","60-64 years","Female",52,52,58,63,71,296
"Crawley 002B","E01031587","65-69 years","Female",55,57,51,44,39,246
"Crawley 002B","E01031587","70-74 years","Female",37,40,45,51,52,225
"Crawley 002B","E01031587","75-79 years","Female",32,24,35,36,38,165
"Crawley 002B","E01031587","80-84 years","Female",25,33,29,31,29,147
"Crawley 002B","E01031587","85+ years","Female",14,13,21,28,29,105
"Crawley 002C","E01031588","0-4 years","Male",37,40,56,54,46,233
"Crawley 002C","E01031588","5-9 years","Male",51,48,49,43,44,235
"Crawley 002C","E01031588","10-14 years","Male",54,56,48,54,52,264
"Crawley 002C","E01031588","15-19 years","Male",53,50,52,42,50,247
"Crawley 002C","E01031588","20-24 years","Male",47,39,47,43,41,217
"Crawley 002C","E01031588","25-29 years","Male",33,36,29,27,26,151
"Crawley 002C","E01031588","30-34 years","Male",38,29,44,41,39,191
"Crawley 002C","E01031588","35-39 years","Male",49,45,43,42,37,216
"Crawley 002C","E01031588","40-44 years","Male",62,55,48,42,42,249
"Crawley 002C","E01031588","45-49 years","Male",70,78,82,82,70,382
"Crawley 002C","E01031588","50-54 years","Male",54,62,65,73,76,330
"Crawley 002C","E01031588","55-59 years","Male",57,59,60,52,53,281
"Crawley 002C","E01031588","60-64 years","Male",38,39,43,43,43,206
"Crawley 002C","E01031588","65-69 years","Male",38,32,31,36,36,173
"Crawley 002C","E01031588","70-74 years","Male",49,54,50,53,48,254
"Crawley 002C","E01031588","75-79 years","Male",21,26,32,31,35,145
"Crawley 002C","E01031588","80-84 years","Male",14,14,15,17,19,79
"Crawley 002C","E01031588","85+ years","Male",20,19,18,17,13,87
"Crawley 002C","E01031588","0-4 years","Female",34,30,29,32,27,152
"Crawley 002C","E01031588","5-9 years","Female",56,54,46,44,40,240
"Crawley 002C","E01031588","10-14 years","Female",61,57,64,49,59,290
"Crawley 002C","E01031588","15-19 years","Female",40,43,45,50,52,230
"Crawley 002C","E01031588","20-24 years","Female",31,29,26,29,26,141
"Crawley 002C","E01031588","25-29 years","Female",40,41,39,30,33,183
"Crawley 002C","E01031588","30-34 years","Female",42,36,41,47,39,205
"Crawley 002C","E01031588","35-39 years","Female",55,53,48,44,48,248
"Crawley 002C","E01031588","40-44 years","Female",63,65,68,66,66,328
"Crawley 002C","E01031588","45-49 years","Female",57,52,50,47,53,259
"Crawley 002C","E01031588","50-54 years","Female",42,46,49,49,47,233
"Crawley 002C","E01031588","55-59 years","Female",46,51,50,50,48,245
"Crawley 002C","E01031588","60-64 years","Female",34,35,47,47,50,213
"Crawley 002C","E01031588","65-69 years","Female",50,40,37,40,44,211
"Crawley 002C","E01031588","70-74 years","Female",25,33,35,33,36,162
"Crawley 002C","E01031588","75-79 years","Female",37,26,27,28,29,147
"Crawley 002C","E01031588","80-84 years","Female",24,30,23,24,24,125
"Crawley 002C","E01031588","85+ years","Female",34,30,27,28,28,147
"Crawley 002D","E01031590","0-4 years","Male",52,48,52,43,35,230
"Crawley 002D","E01031590","5-9 years","Male",56,61,58,59,55,289
"Crawley 002D","E01031590","10-14 years","Male",31,34,36,41,41,183
"Crawley 002D","E01031590","15-19 years","Male",33,32,35,33,39,172
"Crawley 002D","E01031590","20-24 years","Male",37,31,28,26,22,144
"Crawley 002D","E01031590","25-29 years","Male",39,43,43,38,39,202
"Crawley 002D","E01031590","30-34 years","Male",38,36,42,42,39,197
"Crawley 002D","E01031590","35-39 years","Male",64,60,54,56,49,283
"Crawley 002D","E01031590","40-44 years","Male",79,76,76,66,62,359
"Crawley 002D","E01031590","45-49 years","Male",53,58,59,66,68,304
"Crawley 002D","E01031590","50-54 years","Male",47,45,49,47,45,233
"Crawley 002D","E01031590","55-59 years","Male",60,53,51,49,48,261
"Crawley 002D","E01031590","60-64 years","Male",50,53,51,51,50,255
"Crawley 002D","E01031590","65-69 years","Male",34,37,37,40,45,193
"Crawley 002D","E01031590","70-74 years","Male",30,36,44,45,46,201
"Crawley 002D","E01031590","75-79 years","Male",27,25,23,25,22,122
"Crawley 002D","E01031590","80-84 years","Male",16,14,16,19,21,86
"Crawley 002D","E01031590","85+ years","Male",11,12,12,13,14,62
"Crawley 002D","E01031590","0-4 years","Female",40,54,54,44,30,222
"Crawley 002D","E01031590","5-9 years","Female",50,52,52,59,56,269
"Crawley 002D","E01031590","10-14 years","Female",30,42,38,42,40,192
"Crawley 002D","E01031590","15-19 years","Female",34,32,31,33,29,159
"Crawley 002D","E01031590","20-24 years","Female",42,38,44,43,44,211
"Crawley 002D","E01031590","25-29 years","Female",45,42,41,38,36,202
"Crawley 002D","E01031590","30-34 years","Female",54,53,50,45,45,247
"Crawley 002D","E01031590","35-39 years","Female",59,57,61,59,57,293
"Crawley 002D","E01031590","40-44 years","Female",63,67,65,64,58,317
"Crawley 002D","E01031590","45-49 years","Female",59,53,56,59,64,291
"Crawley 002D","E01031590","50-54 years","Female",58,57,58,54,45,272
"Crawley 002D","E01031590","55-59 years","Female",74,74,66,56,60,330
"Crawley 002D","E01031590","60-64 years","Female",43,46,45,58,65,257
"Crawley 002D","E01031590","65-69 years","Female",59,55,48,47,40,249
"Crawley 002D","E01031590","70-74 years","Female",36,45,56,54,51,242
"Crawley 002D","E01031590","75-79 years","Female",22,23,25,27,35,132
"Crawley 002D","E01031590","80-84 years","Female",14,14,15,18,13,74
"Crawley 002D","E01031590","85+ years","Female",11,18,13,12,13,67
"Crawley 002E","E01031593","0-4 years","Male",58,43,41,43,42,227
"Crawley 002E","E01031593","5-9 years","Male",25,33,35,40,39,172
"Crawley 002E","E01031593","10-14 years","Male",44,48,47,43,48,230
"Crawley 002E","E01031593","15-19 years","Male",29,28,34,32,27,150
"Crawley 002E","E01031593","20-24 years","Male",31,28,25,24,26,134
"Crawley 002E","E01031593","25-29 years","Male",45,40,45,43,37,210
"Crawley 002E","E01031593","30-34 years","Male",49,48,45,42,32,216
"Crawley 002E","E01031593","35-39 years","Male",56,58,59,61,61,295
"Crawley 002E","E01031593","40-44 years","Male",55,51,44,49,51,250
"Crawley 002E","E01031593","45-49 years","Male",49,59,59,55,55,277
"Crawley 002E","E01031593","50-54 years","Male",69,72,71,68,56,336
"Crawley 002E","E01031593","55-59 years","Male",65,63,59,56,62,305
"Crawley 002E","E01031593","60-64 years","Male",51,51,58,58,55,273
"Crawley 002E","E01031593","65-69 years","Male",37,36,38,46,47,204
"Crawley 002E","E01031593","70-74 years","Male",26,31,33,29,25,144
"Crawley 002E","E01031593","75-79 years","Male",9,11,14,15,16,65
"Crawley 002E","E01031593","80-84 years","Male",16,13,11,9,7,56
"Crawley 002E","E01031593","85+ years","Male",11,12,20,19,14,76
"Crawley 002E","E01031593","0-4 years","Female",42,41,47,42,36,208
"Crawley 002E","E01031593","5-9 years","Female",49,42,42,46,41,220
"Crawley 002E","E01031593","10-14 years","Female",22,26,30,30,33,141
"Crawley 002E","E01031593","15-19 years","Female",32,28,26,25,21,132
"Crawley 002E","E01031593","20-24 years","Female",40,38,38,33,30,179
"Crawley 002E","E01031593","25-29 years","Female",55,54,53,59,61,282
"Crawley 002E","E01031593","30-34 years","Female",41,36,42,36,36,191
"Crawley 002E","E01031593","35-39 years","Female",57,57,50,47,39,250
"Crawley 002E","E01031593","40-44 years","Female",62,61,59,63,56,301
"Crawley 002E","E01031593","45-49 years","Female",65,57,63,60,65,310
"Crawley 002E","E01031593","50-54 years","Female",54,63,62,63,58,300
"Crawley 002E","E01031593","55-59 years","Female",60,56,59,58,62,295
"Crawley 002E","E01031593","60-64 years","Female",46,43,43,45,50,227
"Crawley 002E","E01031593","65-69 years","Female",41,36,36,36,35,184
"Crawley 002E","E01031593","70-74 years","Female",24,31,32,35,37,159
"Crawley 002E","E01031593","75-79 years","Female",19,15,15,19,15,83
"Crawley 002E","E01031593","80-84 years","Female",28,28,28,23,25,132
"Crawley 002E","E01031593","85+ years","Female",11,9,8,13,13,54
"Crawley 003A","E01031570","0-4 years","Male",53,45,51,46,47,242
"Crawley 003A","E01031570","5-9 years","Male",52,54,49,58,52,265
"Crawley 003A","E01031570","10-14 years","Male",37,40,42,43,54,216
"Crawley 003A","E01031570","15-19 years","Male",32,36,35,35,31,169
"Crawley 003A","E01031570","20-24 years","Male",43,45,38,33,30,189
"Crawley 003A","E01031570","25-29 years","Male",42,47,46,46,49,230
"Crawley 003A","E01031570","30-34 years","Male",40,43,46,49,41,219
"Crawley 003A","E01031570","35-39 years","Male",47,43,46,44,42,222
"Crawley 003A","E01031570","40-44 years","Male",41,46,38,34,38,197
"Crawley 003A","E01031570","45-49 years","Male",49,45,52,52,47,245
"Crawley 003A","E01031570","50-54 years","Male",62,56,58,51,52,279
"Crawley 003A","E01031570","55-59 years","Male",51,43,42,43,48,227
"Crawley 003A","E01031570","60-64 years","Male",47,43,46,46,43,225
"Crawley 003A","E01031570","65-69 years","Male",22,25,24,28,32,131
"Crawley 003A","E01031570","70-74 years","Male",19,21,22,24,23,109
"Crawley 003A","E01031570","75-79 years","Male",17,16,17,19,19,88
"Crawley 003A","E01031570","80-84 years","Male",9,9,8,11,10,47
"Crawley 003A","E01031570","85+ years","Male",20,21,21,21,23,106
"Crawley 003A","E01031570","0-4 years","Female",49,43,52,59,58,261
"Crawley 003A","E01031570","5-9 years","Female",35,39,37,37,41,189
"Crawley 003A","E01031570","10-14 years","Female",48,51,53,51,49,252
"Crawley 003A","E01031570","15-19 years","Female",29,30,33,34,35,161
"Crawley 003A","E01031570","20-24 years","Female",37,35,34,32,30,168
"Crawley 003A","E01031570","25-29 years","Female",50,48,51,44,51,244
"Crawley 003A","E01031570","30-34 years","Female",49,42,42,52,43,228
"Crawley 003A","E01031570","35-39 years","Female",37,42,52,50,45,226
"Crawley 003A","E01031570","40-44 years","Female",57,53,41,50,49,250
"Crawley 003A","E01031570","45-49 years","Female",56,59,66,54,53,288
"Crawley 003A","E01031570","50-54 years","Female",46,41,40,42,46,215
"Crawley 003A","E01031570","55-59 years","Female",39,38,39,41,39,196
"Crawley 003A","E01031570","60-64 years","Female",36,38,41,44,40,199
"Crawley 003A","E01031570","65-69 years","Female",36,33,31,28,35,163
"Crawley 003A","E01031570","70-74 years","Female",27,23,31,32,29,142
"Crawley 003A","E01031570","75-79 years","Female",9,12,13,16,24,74
"Crawley 003A","E01031570","80-84 years","Female",24,20,17,16,9,86
"Crawley 003A","E01031570","85+ years","Female",51,47,43,41,44,226
"Crawley 003B","E01031571","0-4 years","Male",84,76,66,63,63,352
"Crawley 003B","E01031571","5-9 years","Male",67,71,77,83,80,378
"Crawley 003B","E01031571","10-14 years","Male",47,53,59,54,63,276
"Crawley 003B","E01031571","15-19 years","Male",53,58,47,57,58,273
"Crawley 003B","E01031571","20-24 years","Male",59,62,64,62,48,295
"Crawley 003B","E01031571","25-29 years","Male",35,37,45,40,39,196
"Crawley 003B","E01031571","30-34 years","Male",63,56,59,59,59,296
"Crawley 003B","E01031571","35-39 years","Male",73,84,92,83,80,412
"Crawley 003B","E01031571","40-44 years","Male",55,54,50,55,57,271
"Crawley 003B","E01031571","45-49 years","Male",58,57,53,50,49,267
"Crawley 003B","E01031571","50-54 years","Male",47,54,55,63,60,279
"Crawley 003B","E01031571","55-59 years","Male",47,40,38,43,44,212
"Crawley 003B","E01031571","60-64 years","Male",37,41,40,41,41,200
"Crawley 003B","E01031571","65-69 years","Male",25,23,25,23,24,120
"Crawley 003B","E01031571","70-74 years","Male",28,40,39,36,37,180
"Crawley 003B","E01031571","75-79 years","Male",21,12,10,12,13,68
"Crawley 003B","E01031571","80-84 years","Male",10,13,10,12,10,55
"Crawley 003B","E01031571","85+ years","Male",21,22,22,26,21,112
"Crawley 003B","E01031571","0-4 years","Female",57,53,56,46,47,259
"Crawley 003B","E01031571","5-9 years","Female",63,75,73,71,67,349
"Crawley 003B","E01031571","10-14 years","Female",66,61,65,68,70,330
"Crawley 003B","E01031571","15-19 years","Female",51,56,54,45,51,257
"Crawley 003B","E01031571","20-24 years","Female",48,43,42,44,40,217
"Crawley 003B","E01031571","25-29 years","Female",52,51,54,47,37,241
"Crawley 003B","E01031571","30-34 years","Female",58,59,57,57,62,293
"Crawley 003B","E01031571","35-39 years","Female",88,92,94,82,78,434
"Crawley 003B","E01031571","40-44 years","Female",57,63,68,65,73,326
"Crawley 003B","E01031571","45-49 years","Female",60,58,67,60,67,312
"Crawley 003B","E01031571","50-54 years","Female",52,55,55,52,48,262
"Crawley 003B","E01031571","55-59 years","Female",44,42,41,47,45,219
"Crawley 003B","E01031571","60-64 years","Female",35,40,42,47,50,214
"Crawley 003B","E01031571","65-69 years","Female",29,26,27,31,38,151
"Crawley 003B","E01031571","70-74 years","Female",28,34,33,29,23,147
"Crawley 003B","E01031571","75-79 years","Female",25,28,25,23,27,128
"Crawley 003B","E01031571","80-84 years","Female",35,23,26,25,23,132
"Crawley 003B","E01031571","85+ years","Female",29,31,24,26,31,141
"Crawley 003C","E01031572","0-4 years","Male",72,63,81,78,77,371
"Crawley 003C","E01031572","5-9 years","Male",51,59,68,81,88,347
"Crawley 003C","E01031572","10-14 years","Male",43,38,40,51,55,227
"Crawley 003C","E01031572","15-19 years","Male",36,40,41,35,29,181
"Crawley 003C","E01031572","20-24 years","Male",45,46,49,55,66,261
"Crawley 003C","E01031572","25-29 years","Male",46,46,56,59,56,263
"Crawley 003C","E01031572","30-34 years","Male",67,76,76,85,88,392
"Crawley 003C","E01031572","35-39 years","Male",63,63,78,85,90,379
"Crawley 003C","E01031572","40-44 years","Male",50,52,55,71,78,306
"Crawley 003C","E01031572","45-49 years","Male",58,54,63,65,57,297
"Crawley 003C","E01031572","50-54 years","Male",37,45,54,54,57,247
"Crawley 003C","E01031572","55-59 years","Male",62,64,57,57,51,291
"Crawley 003C","E01031572","60-64 years","Male",38,28,35,40,43,184
"Crawley 003C","E01031572","65-69 years","Male",27,26,28,29,32,142
"Crawley 003C","E01031572","70-74 years","Male",23,30,26,27,30,136
"Crawley 003C","E01031572","75-79 years","Male",13,15,18,15,21,82
"Crawley 003C","E01031572","80-84 years","Male",23,19,16,14,12,84
"Crawley 003C","E01031572","85+ years","Male",37,34,34,30,31,166
"Crawley 003C","E01031572","0-4 years","Female",57,49,53,64,71,294
"Crawley 003C","E01031572","5-9 years","Female",49,56,63,64,71,303
"Crawley 003C","E01031572","10-14 years","Female",32,37,40,49,48,206
"Crawley 003C","E01031572","15-19 years","Female",35,34,47,46,46,208
"Crawley 003C","E01031572","20-24 years","Female",29,31,33,32,30,155
"Crawley 003C","E01031572","25-29 years","Female",61,57,69,73,83,343
"Crawley 003C","E01031572","30-34 years","Female",57,60,70,76,70,333
"Crawley 003C","E01031572","35-39 years","Female",50,51,55,65,69,290
"Crawley 003C","E01031572","40-44 years","Female",55,62,58,55,57,287
"Crawley 003C","E01031572","45-49 years","Female",50,53,50,61,69,283
"Crawley 003C","E01031572","50-54 years","Female",45,43,47,47,39,221
"Crawley 003C","E01031572","55-59 years","Female",51,50,55,62,67,285
"Crawley 003C","E01031572","60-64 years","Female",38,38,41,40,47,204
"Crawley 003C","E01031572","65-69 years","Female",29,30,32,35,32,158
"Crawley 003C","E01031572","70-74 years","Female",38,37,37,32,36,180
"Crawley 003C","E01031572","75-79 years","Female",36,26,30,35,35,162
"Crawley 003C","E01031572","80-84 years","Female",38,43,40,38,37,196
"Crawley 003C","E01031572","85+ years","Female",85,88,93,90,84,440
"Crawley 003D","E01031609","0-4 years","Male",53,52,55,57,45,262
"Crawley 003D","E01031609","5-9 years","Male",43,48,46,47,53,237
"Crawley 003D","E01031609","10-14 years","Male",55,53,55,54,52,269
"Crawley 003D","E01031609","15-19 years","Male",59,60,61,57,54,291
"Crawley 003D","E01031609","20-24 years","Male",46,53,50,49,42,240
"Crawley 003D","E01031609","25-29 years","Male",60,53,61,54,56,284
"Crawley 003D","E01031609","30-34 years","Male",59,59,58,50,56,282
"Crawley 003D","E01031609","35-39 years","Male",68,71,65,66,61,331
"Crawley 003D","E01031609","40-44 years","Male",50,44,40,38,45,217
"Crawley 003D","E01031609","45-49 years","Male",55,51,51,58,51,266
"Crawley 003D","E01031609","50-54 years","Male",46,45,45,45,51,232
"Crawley 003D","E01031609","55-59 years","Male",51,47,42,47,41,228
"Crawley 003D","E01031609","60-64 years","Male",47,58,56,59,61,281
"Crawley 003D","E01031609","65-69 years","Male",41,38,35,32,39,185
"Crawley 003D","E01031609","70-74 years","Male",27,34,31,32,30,154
"Crawley 003D","E01031609","75-79 years","Male",13,12,21,23,25,94
"Crawley 003D","E01031609","80-84 years","Male",12,8,9,10,8,47
"Crawley 003D","E01031609","85+ years","Male",11,13,9,7,7,47
"Crawley 003D","E01031609","0-4 years","Female",55,53,49,46,42,245
"Crawley 003D","E01031609","5-9 years","Female",48,40,41,42,36,207
"Crawley 003D","E01031609","10-14 years","Female",41,40,39,34,44,198
"Crawley 003D","E01031609","15-19 years","Female",48,41,46,41,37,213
"Crawley 003D","E01031609","20-24 years","Female",51,45,40,38,36,210
"Crawley 003D","E01031609","25-29 years","Female",45,37,43,42,43,210
"Crawley 003D","E01031609","30-34 years","Female",56,50,59,61,49,275
"Crawley 003D","E01031609","35-39 years","Female",53,55,54,58,49,269
"Crawley 003D","E01031609","40-44 years","Female",60,54,50,50,51,265
"Crawley 003D","E01031609","45-49 years","Female",65,71,69,63,62,330
"Crawley 003D","E01031609","50-54 years","Female",69,64,60,62,59,314
"Crawley 003D","E01031609","55-59 years","Female",38,41,44,50,53,226
"Crawley 003D","E01031609","60-64 years","Female",49,46,50,46,52,243
"Crawley 003D","E01031609","65-69 years","Female",47,45,47,40,40,219
"Crawley 003D","E01031609","70-74 years","Female",33,49,53,49,52,236
"Crawley 003D","E01031609","75-79 years","Female",22,21,18,21,20,102
"Crawley 003D","E01031609","80-84 years","Female",10,9,12,14,16,61
"Crawley 003D","E01031609","85+ years","Female",31,31,29,22,19,132
"Crawley 003E","E01031610","0-4 years","Male",64,68,73,69,66,340
"Crawley 003E","E01031610","5-9 years","Male",73,79,70,79,81,382
"Crawley 003E","E01031610","10-14 years","Male",37,39,40,48,48,212
"Crawley 003E","E01031610","15-19 years","Male",55,53,50,48,47,253
"Crawley 003E","E01031610","20-24 years","Male",63,53,56,49,46,267
"Crawley 003E","E01031610","25-29 years","Male",77,78,67,69,68,359
"Crawley 003E","E01031610","30-34 years","Male",78,76,66,67,62,349
"Crawley 003E","E01031610","35-39 years","Male",83,84,88,87,82,424
"Crawley 003E","E01031610","40-44 years","Male",63,70,77,84,88,382
"Crawley 003E","E01031610","45-49 years","Male",69,76,69,65,75,354
"Crawley 003E","E01031610","50-54 years","Male",49,56,56,55,47,263
"Crawley 003E","E01031610","55-59 years","Male",39,35,32,38,57,201
"Crawley 003E","E01031610","60-64 years","Male",38,45,45,43,38,209
"Crawley 003E","E01031610","65-69 years","Male",33,31,34,33,33,164
"Crawley 003E","E01031610","70-74 years","Male",28,26,27,29,30,140
"Crawley 003E","E01031610","75-79 years","Male",26,24,23,20,20,113
"Crawley 003E","E01031610","80-84 years","Male",15,25,25,29,32,126
"Crawley 003E","E01031610","85+ years","Male",33,31,21,26,24,135
"Crawley 003E","E01031610","0-4 years","Female",63,66,62,56,50,297
"Crawley 003E","E01031610","5-9 years","Female",67,77,77,87,88,396
"Crawley 003E","E01031610","10-14 years","Female",52,46,57,62,77,294
"Crawley 003E","E01031610","15-19 years","Female",34,36,36,36,33,175
"Crawley 003E","E01031610","20-24 years","Female",40,36,34,31,39,180
"Crawley 003E","E01031610","25-29 years","Female",92,79,80,61,45,357
"Crawley 003E","E01031610","30-34 years","Female",111,102,98,106,100,517
"Crawley 003E","E01031610","35-39 years","Female",80,105,101,103,115,504
"Crawley 003E","E01031610","40-44 years","Female",59,54,51,58,54,276
"Crawley 003E","E01031610","45-49 years","Female",61,48,66,73,74,322
"Crawley 003E","E01031610","50-54 years","Female",41,51,53,54,56,255
"Crawley 003E","E01031610","55-59 years","Female",40,39,30,28,37,174
"Crawley 003E","E01031610","60-64 years","Female",41,50,51,50,45,237
"Crawley 003E","E01031610","65-69 years","Female",42,38,37,29,33,179
"Crawley 003E","E01031610","70-74 years","Female",29,34,37,45,39,184
"Crawley 003E","E01031610","75-79 years","Female",33,27,23,24,25,132
"Crawley 003E","E01031610","80-84 years","Female",21,25,28,25,26,125
"Crawley 003E","E01031610","85+ years","Female",43,43,41,44,47,218
"Crawley 004A","E01031583","0-4 years","Male",100,100,98,109,104,511
"Crawley 004A","E01031583","5-9 years","Male",67,65,58,66,55,311
"Crawley 004A","E01031583","10-14 years","Male",52,61,65,58,72,308
"Crawley 004A","E01031583","15-19 years","Male",31,28,35,42,50,186
"Crawley 004A","E01031583","20-24 years","Male",64,54,48,42,44,252
"Crawley 004A","E01031583","25-29 years","Male",143,139,137,132,110,661
"Crawley 004A","E01031583","30-34 years","Male",133,142,133,154,143,705
"Crawley 004A","E01031583","35-39 years","Male",89,102,101,104,99,495
"Crawley 004A","E01031583","40-44 years","Male",97,96,95,101,91,480
"Crawley 004A","E01031583","45-49 years","Male",81,78,83,92,101,435
"Crawley 004A","E01031583","50-54 years","Male",61,70,66,69,70,336
"Crawley 004A","E01031583","55-59 years","Male",68,70,77,78,76,369
"Crawley 004A","E01031583","60-64 years","Male",41,42,42,47,46,218
"Crawley 004A","E01031583","65-69 years","Male",21,20,15,16,24,96
"Crawley 004A","E01031583","70-74 years","Male",17,16,21,20,17,91
"Crawley 004A","E01031583","75-79 years","Male",14,13,14,14,17,72
"Crawley 004A","E01031583","80-84 years","Male",8,10,8,10,10,46
"Crawley 004A","E01031583","85+ years","Male",17,14,15,18,13,77
"Crawley 004A","E01031583","0-4 years","Female",88,90,103,102,82,465
"Crawley 004A","E01031583","5-9 years","Female",64,68,73,84,85,374
"Crawley 004A","E01031583","10-14 years","Female",38,44,55,46,64,247
"Crawley 004A","E01031583","15-19 years","Female",33,29,29,26,22,139
"Crawley 004A","E01031583","20-24 years","Female",68,66,65,63,61,323
"Crawley 004A","E01031583","25-29 years","Female",118,130,131,120,104,603
"Crawley 004A","E01031583","30-34 years","Female",138,135,135,138,113,659
"Crawley 004A","E01031583","35-39 years","Female",92,108,111,106,120,537
"Crawley 004A","E01031583","40-44 years","Female",58,56,66,75,81,336
"Crawley 004A","E01031583","45-49 years","Female",58,66,73,73,70,340
"Crawley 004A","E01031583","50-54 years","Female",53,60,58,65,72,308
"Crawley 004A","E01031583","55-59 years","Female",74,69,58,65,59,325
"Crawley 004A","E01031583","60-64 years","Female",50,52,66,58,56,282
"Crawley 004A","E01031583","65-69 years","Female",26,25,28,34,42,155
"Crawley 004A","E01031583","70-74 years","Female",11,9,12,15,16,63
"Crawley 004A","E01031583","75-79 years","Female",8,11,13,12,8,52
"Crawley 004A","E01031583","80-84 years","Female",16,21,19,13,13,82
"Crawley 004A","E01031583","85+ years","Female",17,15,15,18,20,85
"Crawley 004B","E01031584","0-4 years","Male",63,53,62,55,51,284
"Crawley 004B","E01031584","5-9 years","Male",79,75,85,92,88,419
"Crawley 004B","E01031584","10-14 years","Male",57,60,66,67,68,318
"Crawley 004B","E01031584","15-19 years","Male",48,44,47,47,52,238
"Crawley 004B","E01031584","20-24 years","Male",39,37,38,35,39,188
"Crawley 004B","E01031584","25-29 years","Male",66,61,56,59,53,295
"Crawley 004B","E01031584","30-34 years","Male",49,46,45,45,43,228
"Crawley 004B","E01031584","35-39 years","Male",70,68,73,70,81,362
"Crawley 004B","E01031584","40-44 years","Male",57,62,60,65,57,301
"Crawley 004B","E01031584","45-49 years","Male",63,55,53,52,48,271
"Crawley 004B","E01031584","50-54 years","Male",72,77,71,71,70,361
"Crawley 004B","E01031584","55-59 years","Male",36,39,45,49,44,213
"Crawley 004B","E01031584","60-64 years","Male",45,43,35,37,39,199
"Crawley 004B","E01031584","65-69 years","Male",47,47,50,45,40,229
"Crawley 004B","E01031584","70-74 years","Male",27,28,33,35,41,164
"Crawley 004B","E01031584","75-79 years","Male",13,16,19,18,21,87
"Crawley 004B","E01031584","80-84 years","Male",18,13,13,8,9,61
"Crawley 004B","E01031584","85+ years","Male",25,23,24,23,19,114
"Crawley 004B","E01031584","0-4 years","Female",71,64,62,63,67,327
"Crawley 004B","E01031584","5-9 years","Female",72,70,77,76,74,369
"Crawley 004B","E01031584","10-14 years","Female",48,55,56,66,71,296
"Crawley 004B","E01031584","15-19 years","Female",33,29,35,36,35,168
"Crawley 004B","E01031584","20-24 years","Female",58,49,46,37,44,234
"Crawley 004B","E01031584","25-29 years","Female",63,71,59,67,56,316
"Crawley 004B","E01031584","30-34 years","Female",101,98,111,92,84,486
"Crawley 004B","E01031584","35-39 years","Female",65,70,74,80,78,367
"Crawley 004B","E01031584","40-44 years","Female",41,37,43,52,67,240
"Crawley 004B","E01031584","45-49 years","Female",60,52,47,45,42,246
"Crawley 004B","E01031584","50-54 years","Female",50,49,49,48,52,248
"Crawley 004B","E01031584","55-59 years","Female",59,60,55,55,45,274
"Crawley 004B","E01031584","60-64 years","Female",40,41,49,46,50,226
"Crawley 004B","E01031584","65-69 years","Female",42,36,37,41,41,197
"Crawley 004B","E01031584","70-74 years","Female",21,34,36,37,40,168
"Crawley 004B","E01031584","75-79 years","Female",21,14,14,21,24,94
"Crawley 004B","E01031584","80-84 years","Female",13,17,18,15,13,76
"Crawley 004B","E01031584","85+ years","Female",36,38,32,30,28,164
"Crawley 004C","E01031585","0-4 years","Male",66,75,73,73,82,369
"Crawley 004C","E01031585","5-9 years","Male",44,52,60,61,67,284
"Crawley 004C","E01031585","10-14 years","Male",42,36,36,34,39,187
"Crawley 004C","E01031585","15-19 years","Male",50,45,42,47,54,238
"Crawley 004C","E01031585","20-24 years","Male",56,66,61,48,44,275
"Crawley 004C","E01031585","25-29 years","Male",81,82,89,88,86,426
"Crawley 004C","E01031585","30-34 years","Male",100,102,106,114,122,544
"Crawley 004C","E01031585","35-39 years","Male",68,82,97,102,102,451
"Crawley 004C","E01031585","40-44 years","Male",57,65,64,81,95,362
"Crawley 004C","E01031585","45-49 years","Male",52,49,57,62,67,287
"Crawley 004C","E01031585","50-54 years","Male",41,45,44,50,60,240
"Crawley 004C","E01031585","55-59 years","Male",58,58,50,47,42,255
"Crawley 004C","E01031585","60-64 years","Male",31,38,47,49,54,219
"Crawley 004C","E01031585","65-69 years","Male",38,30,28,29,28,153
"Crawley 004C","E01031585","70-74 years","Male",25,34,38,38,37,172
"Crawley 004C","E01031585","75-79 years","Male",28,28,25,29,27,137
"Crawley 004C","E01031585","80-84 years","Male",14,17,18,19,16,84
"Crawley 004C","E01031585","85+ years","Male",21,18,19,20,20,98
"Crawley 004C","E01031585","0-4 years","Female",79,82,82,73,86,402
"Crawley 004C","E01031585","5-9 years","Female",37,42,45,48,59,231
"Crawley 004C","E01031585","10-14 years","Female",26,29,38,46,47,186
"Crawley 004C","E01031585","15-19 years","Female",32,25,24,30,38,149
"Crawley 004C","E01031585","20-24 years","Female",48,57,39,43,47,234
"Crawley 004C","E01031585","25-29 years","Female",84,83,97,106,121,491
"Crawley 004C","E01031585","30-34 years","Female",84,104,107,119,134,548
"Crawley 004C","E01031585","35-39 years","Female",57,63,60,69,82,331
"Crawley 004C","E01031585","40-44 years","Female",49,58,63,66,67,303
"Crawley 004C","E01031585","45-49 years","Female",49,50,53,65,68,285
"Crawley 004C","E01031585","50-54 years","Female",50,53,63,56,55,277
"Crawley 004C","E01031585","55-59 years","Female",56,58,60,49,51,274
"Crawley 004C","E01031585","60-64 years","Female",34,32,37,41,38,182
"Crawley 004C","E01031585","65-69 years","Female",53,59,54,55,51,272
"Crawley 004C","E01031585","70-74 years","Female",33,28,37,47,50,195
"Crawley 004C","E01031585","75-79 years","Female",28,28,26,21,18,121
"Crawley 004C","E01031585","80-84 years","Female",30,28,28,29,27,142
"Crawley 004C","E01031585","85+ years","Female",41,41,40,37,37,196
"Crawley 004D","E01031601","0-4 years","Male",63,63,60,56,48,290
"Crawley 004D","E01031601","5-9 years","Male",36,47,46,51,50,230
"Crawley 004D","E01031601","10-14 years","Male",34,37,37,37,31,176
"Crawley 004D","E01031601","15-19 years","Male",42,47,47,48,49,233
"Crawley 004D","E01031601","20-24 years","Male",37,44,47,48,45,221
"Crawley 004D","E01031601","25-29 years","Male",31,31,29,23,19,133
"Crawley 004D","E01031601","30-34 years","Male",41,37,36,34,33,181
"Crawley 004D","E01031601","35-39 years","Male",34,33,36,39,34,176
"Crawley 004D","E01031601","40-44 years","Male",40,43,32,30,40,185
"Crawley 004D","E01031601","45-49 years","Male",57,66,67,62,48,300
"Crawley 004D","E01031601","50-54 years","Male",44,39,41,41,47,212
"Crawley 004D","E01031601","55-59 years","Male",39,38,37,44,42,200
"Crawley 004D","E01031601","60-64 years","Male",43,40,40,39,38,200
"Crawley 004D","E01031601","65-69 years","Male",34,37,31,35,37,174
"Crawley 004D","E01031601","70-74 years","Male",21,22,19,22,22,106
"Crawley 004D","E01031601","75-79 years","Male",20,24,29,23,24,120
"Crawley 004D","E01031601","80-84 years","Male",13,14,15,17,18,77
"Crawley 004D","E01031601","85+ years","Male",20,21,19,22,21,103
"Crawley 004D","E01031601","0-4 years","Female",37,38,33,32,32,172
"Crawley 004D","E01031601","5-9 years","Female",67,67,62,51,51,298
"Crawley 004D","E01031601","10-14 years","Female",37,49,57,61,58,262
"Crawley 004D","E01031601","15-19 years","Female",31,34,34,40,38,177
"Crawley 004D","E01031601","20-24 years","Female",26,24,26,20,23,119
"Crawley 004D","E01031601","25-29 years","Female",38,38,28,28,29,161
"Crawley 004D","E01031601","30-34 years","Female",51,44,50,49,35,229
"Crawley 004D","E01031601","35-39 years","Female",38,49,50,46,44,227
"Crawley 004D","E01031601","40-44 years","Female",50,50,45,49,46,240
"Crawley 004D","E01031601","45-49 years","Female",46,44,42,40,49,221
"Crawley 004D","E01031601","50-54 years","Female",44,44,48,47,38,221
"Crawley 004D","E01031601","55-59 years","Female",38,35,45,45,47,210
"Crawley 004D","E01031601","60-64 years","Female",37,41,35,37,36,186
"Crawley 004D","E01031601","65-69 years","Female",22,18,22,28,30,120
"Crawley 004D","E01031601","70-74 years","Female",33,37,30,27,27,154
"Crawley 004D","E01031601","75-79 years","Female",13,16,16,20,22,87
"Crawley 004D","E01031601","80-84 years","Female",27,21,18,16,16,98
"Crawley 004D","E01031601","85+ years","Female",29,37,43,44,39,192
"Crawley 004F","E01032835","0-4 years","Male",112,110,115,99,99,535
"Crawley 004F","E01032835","5-9 years","Male",98,119,118,109,90,534
"Crawley 004F","E01032835","10-14 years","Male",34,38,46,70,97,285
"Crawley 004F","E01032835","15-19 years","Male",10,14,15,20,21,80
"Crawley 004F","E01032835","20-24 years","Male",46,43,58,49,51,247
"Crawley 004F","E01032835","25-29 years","Male",150,116,115,102,106,589
"Crawley 004F","E01032835","30-34 years","Male",217,233,214,187,173,1024
"Crawley 004F","E01032835","35-39 years","Male",185,193,230,220,227,1055
"Crawley 004F","E01032835","40-44 years","Male",103,112,118,122,125,580
"Crawley 004F","E01032835","45-49 years","Male",40,41,46,48,49,224
"Crawley 004F","E01032835","50-54 years","Male",42,41,46,47,42,218
"Crawley 004F","E01032835","55-59 years","Male",26,35,43,43,55,202
"Crawley 004F","E01032835","60-64 years","Male",12,14,13,16,21,76
"Crawley 004F","E01032835","65-69 years","Male",11,7,7,9,15,49
"Crawley 004F","E01032835","70-74 years","Male",4,3,6,7,8,28
"Crawley 004F","E01032835","75-79 years","Male",2,4,2,2,2,12
"Crawley 004F","E01032835","80-84 years","Male",12,12,15,13,11,63
"Crawley 004F","E01032835","85+ years","Male",7,4,2,4,4,21
"Crawley 004F","E01032835","0-4 years","Female",93,89,94,76,79,431
"Crawley 004F","E01032835","5-9 years","Female",85,94,99,92,90,460
"Crawley 004F","E01032835","10-14 years","Female",21,24,26,35,43,149
"Crawley 004F","E01032835","15-19 years","Female",18,18,23,18,20,97
"Crawley 004F","E01032835","20-24 years","Female",77,73,70,73,65,358
"Crawley 004F","E01032835","25-29 years","Female",169,152,146,137,131,735
"Crawley 004F","E01032835","30-34 years","Female",189,190,192,162,167,900
"Crawley 004F","E01032835","35-39 years","Female",135,152,171,174,173,805
"Crawley 004F","E01032835","40-44 years","Female",58,59,79,84,101,381
"Crawley 004F","E01032835","45-49 years","Female",25,26,29,32,33,145
"Crawley 004F","E01032835","50-54 years","Female",18,22,18,23,21,102
"Crawley 004F","E01032835","55-59 years","Female",22,24,36,30,33,145
"Crawley 004F","E01032835","60-64 years","Female",12,12,10,14,18,66
"Crawley 004F","E01032835","65-69 years","Female",13,13,11,10,14,61
"Crawley 004F","E01032835","70-74 years","Female",5,5,6,8,8,32
"Crawley 004F","E01032835","75-79 years","Female",4,4,4,3,5,20
"Crawley 004F","E01032835","80-84 years","Female",10,10,9,15,14,58
"Crawley 004F","E01032835","85+ years","Female",17,15,15,15,12,74
"Crawley 004G","E01032836","0-4 years","Male",70,62,65,61,76,334
"Crawley 004G","E01032836","5-9 years","Male",38,39,36,46,50,209
"Crawley 004G","E01032836","10-14 years","Male",54,59,59,56,53,281
"Crawley 004G","E01032836","15-19 years","Male",42,38,43,40,39,202
"Crawley 004G","E01032836","20-24 years","Male",41,55,55,50,48,249
"Crawley 004G","E01032836","25-29 years","Male",115,104,93,94,89,495
"Crawley 004G","E01032836","30-34 years","Male",85,91,93,81,82,432
"Crawley 004G","E01032836","35-39 years","Male",59,69,69,72,77,346
"Crawley 004G","E01032836","40-44 years","Male",63,58,58,67,68,314
"Crawley 004G","E01032836","45-49 years","Male",51,56,58,53,46,264
"Crawley 004G","E01032836","50-54 years","Male",50,59,64,57,61,291
"Crawley 004G","E01032836","55-59 years","Male",41,42,37,44,49,213
"Crawley 004G","E01032836","60-64 years","Male",41,43,47,42,38,211
"Crawley 004G","E01032836","65-69 years","Male",36,33,28,30,40,167
"Crawley 004G","E01032836","70-74 years","Male",39,40,37,38,32,186
"Crawley 004G","E01032836","75-79 years","Male",24,24,23,26,27,124
"Crawley 004G","E01032836","80-84 years","Male",8,10,16,19,16,69
"Crawley 004G","E01032836","85+ years","Male",17,14,12,9,11,63
"Crawley 004G","E01032836","0-4 years","Female",65,59,53,58,88,323
"Crawley 004G","E01032836","5-9 years","Female",45,47,52,51,55,250
"Crawley 004G","E01032836","10-14 years","Female",45,42,39,44,49,219
"Crawley 004G","E01032836","15-19 years","Female",33,33,39,35,39,179
"Crawley 004G","E01032836","20-24 years","Female",58,57,52,56,63,286
"Crawley 004G","E01032836","25-29 years","Female",91,84,79,66,69,389
"Crawley 004G","E01032836","30-34 years","Female",80,83,82,85,97,427
"Crawley 004G","E01032836","35-39 years","Female",67,64,76,74,84,365
"Crawley 004G","E01032836","40-44 years","Female",52,47,48,44,48,239
"Crawley 004G","E01032836","45-49 years","Female",63,69,76,69,66,343
"Crawley 004G","E01032836","50-54 years","Female",56,66,62,58,60,302
"Crawley 004G","E01032836","55-59 years","Female",47,44,38,47,44,220
"Crawley 004G","E01032836","60-64 years","Female",36,37,41,46,43,203
"Crawley 004G","E01032836","65-69 years","Female",33,36,35,26,33,163
"Crawley 004G","E01032836","70-74 years","Female",33,40,44,47,41,205
"Crawley 004G","E01032836","75-79 years","Female",30,25,27,26,27,135
"Crawley 004G","E01032836","80-84 years","Female",23,24,30,30,28,135
"Crawley 004G","E01032836","85+ years","Female",44,47,41,43,43,218
"Crawley 005A","E01031589","0-4 years","Male",59,49,48,48,40,244
"Crawley 005A","E01031589","5-9 years","Male",68,69,65,56,65,323
"Crawley 005A","E01031589","10-14 years","Male",62,62,67,60,58,309
"Crawley 005A","E01031589","15-19 years","Male",58,59,49,49,49,264
"Crawley 005A","E01031589","20-24 years","Male",49,50,54,46,48,247
"Crawley 005A","E01031589","25-29 years","Male",45,48,39,43,44,219
"Crawley 005A","E01031589","30-34 years","Male",64,53,58,57,50,282
"Crawley 005A","E01031589","35-39 years","Male",77,75,72,80,78,382
"Crawley 005A","E01031589","40-44 years","Male",73,70,74,69,73,359
"Crawley 005A","E01031589","45-49 years","Male",54,58,51,48,50,261
"Crawley 005A","E01031589","50-54 years","Male",76,69,67,71,66,349
"Crawley 005A","E01031589","55-59 years","Male",52,67,73,79,84,355
"Crawley 005A","E01031589","60-64 years","Male",35,32,32,31,33,163
"Crawley 005A","E01031589","65-69 years","Male",49,48,43,41,39,220
"Crawley 005A","E01031589","70-74 years","Male",30,37,41,48,49,205
"Crawley 005A","E01031589","75-79 years","Male",25,24,20,21,33,123
"Crawley 005A","E01031589","80-84 years","Male",29,24,23,19,19,114
"Crawley 005A","E01031589","85+ years","Male",29,22,24,25,25,125
"Crawley 005A","E01031589","0-4 years","Female",52,51,47,49,50,249
"Crawley 005A","E01031589","5-9 years","Female",54,59,61,54,52,280
"Crawley 005A","E01031589","10-14 years","Female",44,43,44,58,57,246
"Crawley 005A","E01031589","15-19 years","Female",45,47,46,39,42,219
"Crawley 005A","E01031589","20-24 years","Female",40,32,21,25,18,136
"Crawley 005A","E01031589","25-29 years","Female",48,48,40,45,49,230
"Crawley 005A","E01031589","30-34 years","Female",61,58,48,45,38,250
"Crawley 005A","E01031589","35-39 years","Female",80,77,68,69,68,362
"Crawley 005A","E01031589","40-44 years","Female",56,66,68,70,72,332
"Crawley 005A","E01031589","45-49 years","Female",61,53,54,50,49,267
"Crawley 005A","E01031589","50-54 years","Female",62,60,65,59,67,313
"Crawley 005A","E01031589","55-59 years","Female",45,54,53,59,62,273
"Crawley 005A","E01031589","60-64 years","Female",51,52,54,41,47,245
"Crawley 005A","E01031589","65-69 years","Female",43,41,37,62,58,241
"Crawley 005A","E01031589","70-74 years","Female",37,35,40,35,35,182
"Crawley 005A","E01031589","75-79 years","Female",34,36,38,35,39,182
"Crawley 005A","E01031589","80-84 years","Female",29,22,25,20,26,122
"Crawley 005A","E01031589","85+ years","Female",34,37,41,44,42,198
"Crawley 005B","E01031591","0-4 years","Male",84,83,78,65,64,374
"Crawley 005B","E01031591","5-9 years","Male",72,73,76,78,81,380
"Crawley 005B","E01031591","10-14 years","Male",66,75,75,67,66,349
"Crawley 005B","E01031591","15-19 years","Male",66,56,55,59,62,298
"Crawley 005B","E01031591","20-24 years","Male",51,54,60,73,65,303
"Crawley 005B","E01031591","25-29 years","Male",74,65,70,76,79,364
"Crawley 005B","E01031591","30-34 years","Male",83,76,74,63,61,357
"Crawley 005B","E01031591","35-39 years","Male",101,93,89,84,93,460
"Crawley 005B","E01031591","40-44 years","Male",61,68,81,82,77,369
"Crawley 005B","E01031591","45-49 years","Male",81,72,68,77,77,375
"Crawley 005B","E01031591","50-54 years","Male",47,66,75,72,63,323
"Crawley 005B","E01031591","55-59 years","Male",39,34,37,35,35,180
"Crawley 005B","E01031591","60-64 years","Male",32,36,33,36,39,176
"Crawley 005B","E01031591","65-69 years","Male",23,20,26,31,25,125
"Crawley 005B","E01031591","70-74 years","Male",26,29,25,23,29,132
"Crawley 005B","E01031591","75-79 years","Male",22,21,21,18,20,102
"Crawley 005B","E01031591","80-84 years","Male",4,10,10,10,11,45
"Crawley 005B","E01031591","85+ years","Male",15,14,11,9,10,59
"Crawley 005B","E01031591","0-4 years","Female",60,66,61,64,54,305
"Crawley 005B","E01031591","5-9 years","Female",66,80,83,82,84,395
"Crawley 005B","E01031591","10-14 years","Female",50,58,60,59,62,289
"Crawley 005B","E01031591","15-19 years","Female",54,50,53,50,47,254
"Crawley 005B","E01031591","20-24 years","Female",38,40,44,48,46,216
"Crawley 005B","E01031591","25-29 years","Female",74,61,54,60,44,293
"Crawley 005B","E01031591","30-34 years","Female",102,103,98,83,86,472
"Crawley 005B","E01031591","35-39 years","Female",76,83,84,93,90,426
"Crawley 005B","E01031591","40-44 years","Female",74,75,76,70,81,376
"Crawley 005B","E01031591","45-49 years","Female",79,80,86,83,87,415
"Crawley 005B","E01031591","50-54 years","Female",51,46,51,51,60,259
"Crawley 005B","E01031591","55-59 years","Female",49,49,50,53,50,251
"Crawley 005B","E01031591","60-64 years","Female",26,30,26,28,34,144
"Crawley 005B","E01031591","65-69 years","Female",40,34,30,36,27,167
"Crawley 005B","E01031591","70-74 years","Female",16,24,28,25,27,120
"Crawley 005B","E01031591","75-79 years","Female",25,28,21,21,26,121
"Crawley 005B","E01031591","80-84 years","Female",17,14,24,24,25,104
"Crawley 005B","E01031591","85+ years","Female",24,22,14,15,15,90
"Crawley 005C","E01031594","0-4 years","Male",66,61,57,54,52,290
"Crawley 005C","E01031594","5-9 years","Male",53,63,68,65,69,318
"Crawley 005C","E01031594","10-14 years","Male",46,53,62,60,54,275
"Crawley 005C","E01031594","15-19 years","Male",46,50,52,54,59,261
"Crawley 005C","E01031594","20-24 years","Male",61,50,55,45,58,269
"Crawley 005C","E01031594","25-29 years","Male",25,32,24,31,31,143
"Crawley 005C","E01031594","30-34 years","Male",45,44,42,38,32,201
"Crawley 005C","E01031594","35-39 years","Male",67,59,56,55,57,294
"Crawley 005C","E01031594","40-44 years","Male",52,47,49,46,51,245
"Crawley 005C","E01031594","45-49 years","Male",42,39,41,46,48,216
"Crawley 005C","E01031594","50-54 years","Male",45,45,45,46,40,221
"Crawley 005C","E01031594","55-59 years","Male",31,35,31,33,36,166
"Crawley 005C","E01031594","60-64 years","Male",28,23,29,28,32,140
"Crawley 005C","E01031594","65-69 years","Male",36,39,38,32,27,172
"Crawley 005C","E01031594","70-74 years","Male",29,30,26,31,31,147
"Crawley 005C","E01031594","75-79 years","Male",18,22,20,17,18,95
"Crawley 005C","E01031594","80-84 years","Male",11,14,15,14,13,67
"Crawley 005C","E01031594","85+ years","Male",15,23,18,19,16,91
"Crawley 005C","E01031594","0-4 years","Female",49,47,46,37,39,218
"Crawley 005C","E01031594","5-9 years","Female",70,62,59,50,55,296
"Crawley 005C","E01031594","10-14 years","Female",39,41,46,50,51,227
"Crawley 005C","E01031594","15-19 years","Female",36,39,42,38,38,193
"Crawley 005C","E01031594","20-24 years","Female",25,22,23,27,32,129
"Crawley 005C","E01031594","25-29 years","Female",47,43,41,33,30,194
"Crawley 005C","E01031594","30-34 years","Female",55,56,47,49,43,250
"Crawley 005C","E01031594","35-39 years","Female",72,70,69,65,66,342
"Crawley 005C","E01031594","40-44 years","Female",40,45,57,57,67,266
"Crawley 005C","E01031594","45-49 years","Female",60,49,37,44,44,234
"Crawley 005C","E01031594","50-54 years","Female",39,40,49,47,51,226
"Crawley 005C","E01031594","55-59 years","Female",43,50,51,51,40,235
"Crawley 005C","E01031594","60-64 years","Female",39,39,44,45,50,217
"Crawley 005C","E01031594","65-69 years","Female",37,35,29,24,22,147
"Crawley 005C","E01031594","70-74 years","Female",25,33,38,37,35,168
"Crawley 005C","E01031594","75-79 years","Female",24,20,21,22,25,112
"Crawley 005C","E01031594","80-84 years","Female",16,11,10,14,15,66
"Crawley 005C","E01031594","85+ years","Female",13,13,13,13,11,63
"Crawley 005D","E01031600","0-4 years","Male",53,50,42,47,49,241
"Crawley 005D","E01031600","5-9 years","Male",46,52,60,57,54,269
"Crawley 005D","E01031600","10-14 years","Male",41,44,47,48,46,226
"Crawley 005D","E01031600","15-19 years","Male",42,31,35,35,36,179
"Crawley 005D","E01031600","20-24 years","Male",25,26,26,25,22,124
"Crawley 005D","E01031600","25-29 years","Male",31,29,26,27,26,139
"Crawley 005D","E01031600","30-34 years","Male",69,60,50,48,48,275
"Crawley 005D","E01031600","35-39 years","Male",61,74,78,65,62,340
"Crawley 005D","E01031600","40-44 years","Male",64,65,74,73,71,347
"Crawley 005D","E01031600","45-49 years","Male",44,40,48,49,49,230
"Crawley 005D","E01031600","50-54 years","Male",53,54,49,47,46,249
"Crawley 005D","E01031600","55-59 years","Male",48,47,47,41,46,229
"Crawley 005D","E01031600","60-64 years","Male",32,34,38,41,40,185
"Crawley 005D","E01031600","65-69 years","Male",30,30,29,28,35,152
"Crawley 005D","E01031600","70-74 years","Male",25,24,23,19,17,108
"Crawley 005D","E01031600","75-79 years","Male",19,29,23,31,30,132
"Crawley 005D","E01031600","80-84 years","Male",9,7,9,11,11,47
"Crawley 005D","E01031600","85+ years","Male",15,13,15,13,14,70
"Crawley 005D","E01031600","0-4 years","Female",55,52,41,40,30,218
"Crawley 005D","E01031600","5-9 years","Female",33,47,53,51,51,235
"Crawley 005D","E01031600","10-14 years","Female",38,37,35,33,31,174
"Crawley 005D","E01031600","15-19 years","Female",29,35,36,33,27,160
"Crawley 005D","E01031600","20-24 years","Female",32,30,29,28,24,143
"Crawley 005D","E01031600","25-29 years","Female",50,53,48,54,60,265
"Crawley 005D","E01031600","30-34 years","Female",58,60,64,58,49,289
"Crawley 005D","E01031600","35-39 years","Female",68,60,65,59,57,309
"Crawley 005D","E01031600","40-44 years","Female",49,52,55,54,66,276
"Crawley 005D","E01031600","45-49 years","Female",53,47,48,48,48,244
"Crawley 005D","E01031600","50-54 years","Female",45,50,57,52,47,251
"Crawley 005D","E01031600","55-59 years","Female",35,40,37,44,40,196
"Crawley 005D","E01031600","60-64 years","Female",42,37,33,33,44,189
"Crawley 005D","E01031600","65-69 years","Female",41,36,40,42,42,201
"Crawley 005D","E01031600","70-74 years","Female",31,32,28,27,28,146
"Crawley 005D","E01031600","75-79 years","Female",30,27,29,29,27,142
"Crawley 005D","E01031600","80-84 years","Female",22,20,17,27,23,109
"Crawley 005D","E01031600","85+ years","Female",33,35,36,30,29,163
"Crawley 005E","E01031603","0-4 years","Male",48,46,44,44,49,231
"Crawley 005E","E01031603","5-9 years","Male",70,81,79,79,66,375
"Crawley 005E","E01031603","10-14 years","Male",35,40,48,51,54,228
"Crawley 005E","E01031603","15-19 years","Male",38,36,38,37,32,181
"Crawley 005E","E01031603","20-24 years","Male",44,43,43,52,47,229
"Crawley 005E","E01031603","25-29 years","Male",81,76,70,61,62,350
"Crawley 005E","E01031603","30-34 years","Male",69,81,83,81,75,389
"Crawley 005E","E01031603","35-39 years","Male",59,69,71,63,68,330
"Crawley 005E","E01031603","40-44 years","Male",56,50,55,61,47,269
"Crawley 005E","E01031603","45-49 years","Male",58,55,62,59,68,302
"Crawley 005E","E01031603","50-54 years","Male",60,55,55,56,56,282
"Crawley 005E","E01031603","55-59 years","Male",45,51,50,60,60,266
"Crawley 005E","E01031603","60-64 years","Male",45,47,46,49,45,232
"Crawley 005E","E01031603","65-69 years","Male",30,29,33,28,33,153
"Crawley 005E","E01031603","70-74 years","Male",23,19,20,21,19,102
"Crawley 005E","E01031603","75-79 years","Male",12,13,14,17,14,70
"Crawley 005E","E01031603","80-84 years","Male",20,14,12,12,7,65
"Crawley 005E","E01031603","85+ years","Male",9,10,8,6,7,40
"Crawley 005E","E01031603","0-4 years","Female",40,46,57,50,53,246
"Crawley 005E","E01031603","5-9 years","Female",35,39,36,39,45,194
"Crawley 005E","E01031603","10-14 years","Female",39,36,37,31,26,169
"Crawley 005E","E01031603","15-19 years","Female",41,40,40,44,39,204
"Crawley 005E","E01031603","20-24 years","Female",59,64,58,49,50,280
"Crawley 005E","E01031603","25-29 years","Female",60,47,52,41,43,243
"Crawley 005E","E01031603","30-34 years","Female",46,58,60,63,53,280
"Crawley 005E","E01031603","35-39 years","Female",61,60,53,47,50,271
"Crawley 005E","E01031603","40-44 years","Female",45,49,47,51,58,250
"Crawley 005E","E01031603","45-49 years","Female",63,62,66,57,52,300
"Crawley 005E","E01031603","50-54 years","Female",46,47,54,59,57,263
"Crawley 005E","E01031603","55-59 years","Female",46,43,41,37,44,211
"Crawley 005E","E01031603","60-64 years","Female",38,35,41,52,52,218
"Crawley 005E","E01031603","65-69 years","Female",34,27,25,24,26,136
"Crawley 005E","E01031603","70-74 years","Female",17,20,27,29,32,125
"Crawley 005E","E01031603","75-79 years","Female",17,17,12,12,11,69
"Crawley 005E","E01031603","80-84 years","Female",22,20,23,23,18,106
"Crawley 005E","E01031603","85+ years","Female",16,21,20,20,19,96
"Crawley 006A","E01031564","0-4 years","Male",56,61,62,57,49,285
"Crawley 006A","E01031564","5-9 years","Male",50,58,62,72,73,315
"Crawley 006A","E01031564","10-14 years","Male",31,36,46,36,44,193
"Crawley 006A","E01031564","15-19 years","Male",50,39,35,43,38,205
"Crawley 006A","E01031564","20-24 years","Male",45,49,48,45,33,220
"Crawley 006A","E01031564","25-29 years","Male",33,37,34,28,32,164
"Crawley 006A","E01031564","30-34 years","Male",62,54,55,55,37,263
"Crawley 006A","E01031564","35-39 years","Male",72,76,68,66,63,345
"Crawley 006A","E01031564","40-44 years","Male",45,41,55,59,68,268
"Crawley 006A","E01031564","45-49 years","Male",43,42,36,40,32,193
"Crawley 006A","E01031564","50-54 years","Male",42,35,46,48,52,223
"Crawley 006A","E01031564","55-59 years","Male",42,44,44,42,48,220
"Crawley 006A","E01031564","60-64 years","Male",43,47,43,46,42,221
"Crawley 006A","E01031564","65-69 years","Male",33,32,34,35,35,169
"Crawley 006A","E01031564","70-74 years","Male",20,17,22,20,21,100
"Crawley 006A","E01031564","75-79 years","Male",29,31,23,22,19,124
"Crawley 006A","E01031564","80-84 years","Male",26,31,34,30,27,148
"Crawley 006A","E01031564","85+ years","Male",22,18,18,16,17,91
"Crawley 006A","E01031564","0-4 years","Female",53,48,37,43,51,232
"Crawley 006A","E01031564","5-9 years","Female",44,52,50,57,55,258
"Crawley 006A","E01031564","10-14 years","Female",31,32,36,36,37,172
"Crawley 006A","E01031564","15-19 years","Female",37,33,37,42,42,191
"Crawley 006A","E01031564","20-24 years","Female",34,29,29,26,21,139
"Crawley 006A","E01031564","25-29 years","Female",77,59,49,47,49,281
"Crawley 006A","E01031564","30-34 years","Female",52,56,52,59,54,273
"Crawley 006A","E01031564","35-39 years","Female",57,57,62,56,63,295
"Crawley 006A","E01031564","40-44 years","Female",45,48,50,59,53,255
"Crawley 006A","E01031564","45-49 years","Female",50,47,47,39,46,229
"Crawley 006A","E01031564","50-54 years","Female",59,64,59,59,51,292
"Crawley 006A","E01031564","55-59 years","Female",50,49,51,56,55,261
"Crawley 006A","E01031564","60-64 years","Female",40,49,51,48,52,240
"Crawley 006A","E01031564","65-69 years","Female",33,31,29,34,34,161
"Crawley 006A","E01031564","70-74 years","Female",26,27,33,32,32,150
"Crawley 006A","E01031564","75-79 years","Female",49,43,39,30,23,184
"Crawley 006A","E01031564","80-84 years","Female",37,29,26,33,39,164
"Crawley 006A","E01031564","85+ years","Female",21,33,32,38,44,168
"Crawley 006B","E01031565","0-4 years","Male",91,87,98,93,86,455
"Crawley 006B","E01031565","5-9 years","Male",75,83,84,90,92,424
"Crawley 006B","E01031565","10-14 years","Male",72,67,77,75,79,370
"Crawley 006B","E01031565","15-19 years","Male",78,76,64,72,76,366
"Crawley 006B","E01031565","20-24 years","Male",70,67,69,61,56,323
"Crawley 006B","E01031565","25-29 years","Male",73,77,70,79,77,376
"Crawley 006B","E01031565","30-34 years","Male",66,66,76,78,80,366
"Crawley 006B","E01031565","35-39 years","Male",80,89,90,84,88,431
"Crawley 006B","E01031565","40-44 years","Male",70,67,73,70,65,345
"Crawley 006B","E01031565","45-49 years","Male",64,67,54,59,68,312
"Crawley 006B","E01031565","50-54 years","Male",74,74,66,65,52,331
"Crawley 006B","E01031565","55-59 years","Male",62,62,73,70,69,336
"Crawley 006B","E01031565","60-64 years","Male",52,56,57,66,64,295
"Crawley 006B","E01031565","65-69 years","Male",41,35,39,38,50,203
"Crawley 006B","E01031565","70-74 years","Male",45,52,41,39,37,214
"Crawley 006B","E01031565","75-79 years","Male",27,22,33,33,34,149
"Crawley 006B","E01031565","80-84 years","Male",11,15,17,15,14,72
"Crawley 006B","E01031565","85+ years","Male",32,26,25,29,28,140
"Crawley 006B","E01031565","0-4 years","Female",59,67,78,75,90,369
"Crawley 006B","E01031565","5-9 years","Female",72,84,85,82,75,398
"Crawley 006B","E01031565","10-14 years","Female",73,70,70,68,78,359
"Crawley 006B","E01031565","15-19 years","Female",66,63,62,61,55,307
"Crawley 006B","E01031565","20-24 years","Female",58,51,53,50,49,261
"Crawley 006B","E01031565","25-29 years","Female",85,80,80,89,78,412
"Crawley 006B","E01031565","30-34 years","Female",81,82,86,69,73,391
"Crawley 006B","E01031565","35-39 years","Female",85,92,104,114,107,502
"Crawley 006B","E01031565","40-44 years","Female",81,80,79,69,78,387
"Crawley 006B","E01031565","45-49 years","Female",77,66,54,63,60,320
"Crawley 006B","E01031565","50-54 years","Female",70,68,75,64,69,346
"Crawley 006B","E01031565","55-59 years","Female",68,70,68,80,70,356
"Crawley 006B","E01031565","60-64 years","Female",53,50,63,61,57,284
"Crawley 006B","E01031565","65-69 years","Female",35,34,32,29,38,168
"Crawley 006B","E01031565","70-74 years","Female",31,28,24,29,28,140
"Crawley 006B","E01031565","75-79 years","Female",28,30,27,32,29,146
"Crawley 006B","E01031565","80-84 years","Female",42,36,39,33,25,175
"Crawley 006B","E01031565","85+ years","Female",31,29,22,26,28,136
"Crawley 006C","E01031566","0-4 years","Male",77,64,64,60,67,332
"Crawley 006C","E01031566","5-9 years","Male",63,64,61,67,67,322
"Crawley 006C","E01031566","10-14 years","Male",41,39,46,42,44,212
"Crawley 006C","E01031566","15-19 years","Male",39,41,42,50,53,225
"Crawley 006C","E01031566","20-24 years","Male",38,34,37,32,32,173
"Crawley 006C","E01031566","25-29 years","Male",59,63,55,54,49,280
"Crawley 006C","E01031566","30-34 years","Male",57,65,57,52,47,278
"Crawley 006C","E01031566","35-39 years","Male",45,43,43,40,34,205
"Crawley 006C","E01031566","40-44 years","Male",64,62,66,69,63,324
"Crawley 006C","E01031566","45-49 years","Male",44,45,52,47,49,237
"Crawley 006C","E01031566","50-54 years","Male",74,64,58,66,65,327
"Crawley 006C","E01031566","55-59 years","Male",41,45,55,52,47,240
"Crawley 006C","E01031566","60-64 years","Male",59,64,49,56,54,282
"Crawley 006C","E01031566","65-69 years","Male",45,37,47,42,46,217
"Crawley 006C","E01031566","70-74 years","Male",33,41,39,40,47,200
"Crawley 006C","E01031566","75-79 years","Male",33,28,30,30,30,151
"Crawley 006C","E01031566","80-84 years","Male",26,27,23,23,24,123
"Crawley 006C","E01031566","85+ years","Male",21,19,18,19,18,95
"Crawley 006C","E01031566","0-4 years","Female",50,56,57,58,44,265
"Crawley 006C","E01031566","5-9 years","Female",43,35,40,45,47,210
"Crawley 006C","E01031566","10-14 years","Female",36,39,42,49,41,207
"Crawley 006C","E01031566","15-19 years","Female",36,35,27,31,39,168
"Crawley 006C","E01031566","20-24 years","Female",42,35,42,38,35,192
"Crawley 006C","E01031566","25-29 years","Female",63,69,51,52,42,277
"Crawley 006C","E01031566","30-34 years","Female",57,57,53,56,54,277
"Crawley 006C","E01031566","35-39 years","Female",53,55,67,56,61,292
"Crawley 006C","E01031566","40-44 years","Female",46,43,39,50,51,229
"Crawley 006C","E01031566","45-49 years","Female",46,48,52,48,41,235
"Crawley 006C","E01031566","50-54 years","Female",73,57,56,52,52,290
"Crawley 006C","E01031566","55-59 years","Female",54,61,61,57,57,290
"Crawley 006C","E01031566","60-64 years","Female",46,53,53,53,57,262
"Crawley 006C","E01031566","65-69 years","Female",48,44,41,40,40,213
"Crawley 006C","E01031566","70-74 years","Female",31,46,47,57,61,242
"Crawley 006C","E01031566","75-79 years","Female",33,24,30,27,26,140
"Crawley 006C","E01031566","80-84 years","Female",32,23,18,28,36,137
"Crawley 006C","E01031566","85+ years","Female",29,29,30,24,23,135
"Crawley 006D","E01031567","0-4 years","Male",33,28,27,33,40,161
"Crawley 006D","E01031567","5-9 years","Male",44,41,35,28,30,178
"Crawley 006D","E01031567","10-14 years","Male",31,36,34,38,41,180
"Crawley 006D","E01031567","15-19 years","Male",38,39,49,45,46,217
"Crawley 006D","E01031567","20-24 years","Male",47,41,41,38,36,203
"Crawley 006D","E01031567","25-29 years","Male",34,39,38,36,34,181
"Crawley 006D","E01031567","30-34 years","Male",30,28,33,40,39,170
"Crawley 006D","E01031567","35-39 years","Male",39,41,34,25,20,159
"Crawley 006D","E01031567","40-44 years","Male",46,43,48,47,50,234
"Crawley 006D","E01031567","45-49 years","Male",49,48,48,46,50,241
"Crawley 006D","E01031567","50-54 years","Male",47,50,44,48,39,228
"Crawley 006D","E01031567","55-59 years","Male",34,33,45,46,48,206
"Crawley 006D","E01031567","60-64 years","Male",42,38,34,29,33,176
"Crawley 006D","E01031567","65-69 years","Male",32,30,36,38,29,165
"Crawley 006D","E01031567","70-74 years","Male",23,31,31,36,53,174
"Crawley 006D","E01031567","75-79 years","Male",33,31,31,23,16,134
"Crawley 006D","E01031567","80-84 years","Male",28,24,23,26,27,128
"Crawley 006D","E01031567","85+ years","Male",25,36,33,28,27,149
"Crawley 006D","E01031567","0-4 years","Female",27,28,31,36,33,155
"Crawley 006D","E01031567","5-9 years","Female",35,34,33,31,39,172
"Crawley 006D","E01031567","10-14 years","Female",19,22,33,30,24,128
"Crawley 006D","E01031567","15-19 years","Female",49,36,33,29,33,180
"Crawley 006D","E01031567","20-24 years","Female",25,31,26,27,28,137
"Crawley 006D","E01031567","25-29 years","Female",42,26,32,29,28,157
"Crawley 006D","E01031567","30-34 years","Female",36,45,46,43,39,209
"Crawley 006D","E01031567","35-39 years","Female",41,41,44,39,46,211
"Crawley 006D","E01031567","40-44 years","Female",39,37,31,37,42,186
"Crawley 006D","E01031567","45-49 years","Female",40,33,35,31,31,170
"Crawley 006D","E01031567","50-54 years","Female",56,57,49,49,41,252
"Crawley 006D","E01031567","55-59 years","Female",47,52,54,48,49,250
"Crawley 006D","E01031567","60-64 years","Female",42,44,40,46,47,219
"Crawley 006D","E01031567","65-69 years","Female",42,34,39,43,44,202
"Crawley 006D","E01031567","70-74 years","Female",31,32,35,30,29,157
"Crawley 006D","E01031567","75-79 years","Female",33,35,36,33,34,171
"Crawley 006D","E01031567","80-84 years","Female",37,41,35,30,37,180
"Crawley 006D","E01031567","85+ years","Female",74,78,87,86,74,399
"Crawley 006E","E01031568","0-4 years","Male",60,56,66,58,61,301
"Crawley 006E","E01031568","5-9 years","Male",66,58,68,67,57,316
"Crawley 006E","E01031568","10-14 years","Male",43,45,45,45,49,227
"Crawley 006E","E01031568","15-19 years","Male",40,42,36,36,39,193
"Crawley 006E","E01031568","20-24 years","Male",41,43,54,57,53,248
"Crawley 006E","E01031568","25-29 years","Male",60,57,57,43,44,261
"Crawley 006E","E01031568","30-34 years","Male",70,66,64,62,65,327
"Crawley 006E","E01031568","35-39 years","Male",84,92,96,94,83,449
"Crawley 006E","E01031568","40-44 years","Male",49,44,53,54,57,257
"Crawley 006E","E01031568","45-49 years","Male",58,48,38,40,39,223
"Crawley 006E","E01031568","50-54 years","Male",51,51,52,50,52,256
"Crawley 006E","E01031568","55-59 years","Male",50,53,58,59,60,280
"Crawley 006E","E01031568","60-64 years","Male",26,27,31,31,29,144
"Crawley 006E","E01031568","65-69 years","Male",32,31,28,27,27,145
"Crawley 006E","E01031568","70-74 years","Male",8,11,11,10,13,53
"Crawley 006E","E01031568","75-79 years","Male",6,6,6,4,5,27
"Crawley 006E","E01031568","80-84 years","Male",7,4,4,4,4,23
"Crawley 006E","E01031568","85+ years","Male",5,8,5,5,6,29
"Crawley 006E","E01031568","0-4 years","Female",56,60,58,50,48,272
"Crawley 006E","E01031568","5-9 years","Female",54,56,54,47,47,258
"Crawley 006E","E01031568","10-14 years","Female",24,27,25,34,31,141
"Crawley 006E","E01031568","15-19 years","Female",30,31,32,33,34,160
"Crawley 006E","E01031568","20-24 years","Female",40,39,30,28,35,172
"Crawley 006E","E01031568","25-29 years","Female",83,72,68,63,51,337
"Crawley 006E","E01031568","30-34 years","Female",88,85,101,93,86,453
"Crawley 006E","E01031568","35-39 years","Female",62,66,67,69,75,339
"Crawley 006E","E01031568","40-44 years","Female",54,51,47,48,48,248
"Crawley 006E","E01031568","45-49 years","Female",58,57,55,48,43,261
"Crawley 006E","E01031568","50-54 years","Female",52,57,58,58,49,274
"Crawley 006E","E01031568","55-59 years","Female",47,44,42,52,61,246
"Crawley 006E","E01031568","60-64 years","Female",26,32,35,30,31,154
"Crawley 006E","E01031568","65-69 years","Female",22,22,23,24,22,113
"Crawley 006E","E01031568","70-74 years","Female",12,12,12,15,14,65
"Crawley 006E","E01031568","75-79 years","Female",9,8,9,8,11,45
"Crawley 006E","E01031568","80-84 years","Female",9,10,8,6,6,39
"Crawley 006E","E01031568","85+ years","Female",9,9,5,6,8,37
"Crawley 007A","E01031596","0-4 years","Male",105,103,86,80,71,445
"Crawley 007A","E01031596","5-9 years","Male",65,56,67,81,78,347
"Crawley 007A","E01031596","10-14 years","Male",76,68,64,57,78,343
"Crawley 007A","E01031596","15-19 years","Male",46,55,53,59,57,270
"Crawley 007A","E01031596","20-24 years","Male",38,35,33,33,32,171
"Crawley 007A","E01031596","25-29 years","Male",67,61,56,58,56,298
"Crawley 007A","E01031596","30-34 years","Male",102,100,107,91,100,500
"Crawley 007A","E01031596","35-39 years","Male",92,96,101,102,96,487
"Crawley 007A","E01031596","40-44 years","Male",70,65,66,68,74,343
"Crawley 007A","E01031596","45-49 years","Male",63,58,57,53,62,293
"Crawley 007A","E01031596","50-54 years","Male",73,71,77,73,60,354
"Crawley 007A","E01031596","55-59 years","Male",46,42,35,35,33,191
"Crawley 007A","E01031596","60-64 years","Male",41,42,44,45,44,216
"Crawley 007A","E01031596","65-69 years","Male",29,25,27,24,22,127
"Crawley 007A","E01031596","70-74 years","Male",28,27,27,26,22,130
"Crawley 007A","E01031596","75-79 years","Male",16,19,18,20,24,97
"Crawley 007A","E01031596","80-84 years","Male",15,13,10,7,6,51
"Crawley 007A","E01031596","85+ years","Male",15,14,14,14,13,70
"Crawley 007A","E01031596","0-4 years","Female",80,68,74,93,104,419
"Crawley 007A","E01031596","5-9 years","Female",91,86,82,82,80,421
"Crawley 007A","E01031596","10-14 years","Female",63,65,62,59,74,323
"Crawley 007A","E01031596","15-19 years","Female",64,63,59,53,50,289
"Crawley 007A","E01031596","20-24 years","Female",57,49,51,50,46,253
"Crawley 007A","E01031596","25-29 years","Female",74,68,59,65,70,336
"Crawley 007A","E01031596","30-34 years","Female",95,91,82,85,82,435
"Crawley 007A","E01031596","35-39 years","Female",107,110,118,103,99,537
"Crawley 007A","E01031596","40-44 years","Female",54,56,64,66,64,304
"Crawley 007A","E01031596","45-49 years","Female",62,51,52,42,61,268
"Crawley 007A","E01031596","50-54 years","Female",49,47,44,44,41,225
"Crawley 007A","E01031596","55-59 years","Female",38,39,42,48,45,212
"Crawley 007A","E01031596","60-64 years","Female",49,46,43,37,39,214
"Crawley 007A","E01031596","65-69 years","Female",27,29,32,30,31,149
"Crawley 007A","E01031596","70-74 years","Female",28,24,28,30,27,137
"Crawley 007A","E01031596","75-79 years","Female",23,25,20,21,19,108
"Crawley 007A","E01031596","80-84 years","Female",17,13,10,11,14,65
"Crawley 007A","E01031596","85+ years","Female",44,44,40,39,38,205
"Crawley 007B","E01031597","0-4 years","Male",41,29,27,20,24,141
"Crawley 007B","E01031597","5-9 years","Male",44,46,51,50,43,234
"Crawley 007B","E01031597","10-14 years","Male",44,45,48,43,47,227
"Crawley 007B","E01031597","15-19 years","Male",43,34,34,38,34,183
"Crawley 007B","E01031597","20-24 years","Male",31,29,28,38,32,158
"Crawley 007B","E01031597","25-29 years","Male",42,38,28,28,31,167
"Crawley 007B","E01031597","30-34 years","Male",46,41,39,37,34,197
"Crawley 007B","E01031597","35-39 years","Male",53,49,50,47,54,253
"Crawley 007B","E01031597","40-44 years","Male",56,53,53,51,45,258
"Crawley 007B","E01031597","45-49 years","Male",64,62,64,62,62,314
"Crawley 007B","E01031597","50-54 years","Male",60,49,52,50,53,264
"Crawley 007B","E01031597","55-59 years","Male",53,54,55,46,44,252
"Crawley 007B","E01031597","60-64 years","Male",63,55,52,63,61,294
"Crawley 007B","E01031597","65-69 years","Male",45,36,42,37,42,202
"Crawley 007B","E01031597","70-74 years","Male",41,52,41,49,43,226
"Crawley 007B","E01031597","75-79 years","Male",37,33,32,30,35,167
"Crawley 007B","E01031597","80-84 years","Male",16,13,16,17,17,79
"Crawley 007B","E01031597","85+ years","Male",12,11,13,14,11,61
"Crawley 007B","E01031597","0-4 years","Female",34,36,33,33,32,168
"Crawley 007B","E01031597","5-9 years","Female",39,41,37,44,40,201
"Crawley 007B","E01031597","10-14 years","Female",43,44,49,50,54,240
"Crawley 007B","E01031597","15-19 years","Female",39,40,42,44,48,213
"Crawley 007B","E01031597","20-24 years","Female",32,24,22,25,29,132
"Crawley 007B","E01031597","25-29 years","Female",29,28,26,26,21,130
"Crawley 007B","E01031597","30-34 years","Female",50,48,47,49,45,239
"Crawley 007B","E01031597","35-39 years","Female",41,39,46,40,43,209
"Crawley 007B","E01031597","40-44 years","Female",59,37,41,52,43,232
"Crawley 007B","E01031597","45-49 years","Female",48,49,39,34,41,211
"Crawley 007B","E01031597","50-54 years","Female",51,61,62,61,52,287
"Crawley 007B","E01031597","55-59 years","Female",55,48,44,45,45,237
"Crawley 007B","E01031597","60-64 years","Female",62,66,63,60,52,303
"Crawley 007B","E01031597","65-69 years","Female",51,49,54,45,53,252
"Crawley 007B","E01031597","70-74 years","Female",33,41,39,55,59,227
"Crawley 007B","E01031597","75-79 years","Female",30,39,32,30,28,159
"Crawley 007B","E01031597","80-84 years","Female",35,31,32,29,31,158
"Crawley 007B","E01031597","85+ years","Female",28,27,31,32,32,150
"Crawley 007C","E01031598","0-4 years","Male",76,82,71,66,73,368
"Crawley 007C","E01031598","5-9 years","Male",53,56,51,50,51,261
"Crawley 007C","E01031598","10-14 years","Male",34,38,48,53,59,232
"Crawley 007C","E01031598","15-19 years","Male",32,29,29,24,26,140
"Crawley 007C","E01031598","20-24 years","Male",41,40,48,46,42,217
"Crawley 007C","E01031598","25-29 years","Male",57,57,63,62,68,307
"Crawley 007C","E01031598","30-34 years","Male",82,76,75,76,81,390
"Crawley 007C","E01031598","35-39 years","Male",87,90,93,85,78,433
"Crawley 007C","E01031598","40-44 years","Male",63,56,53,61,75,308
"Crawley 007C","E01031598","45-49 years","Male",62,59,55,55,58,289
"Crawley 007C","E01031598","50-54 years","Male",46,52,56,54,65,273
"Crawley 007C","E01031598","55-59 years","Male",67,65,66,66,56,320
"Crawley 007C","E01031598","60-64 years","Male",37,40,46,47,44,214
"Crawley 007C","E01031598","65-69 years","Male",31,28,30,32,33,154
"Crawley 007C","E01031598","70-74 years","Male",30,31,34,29,29,153
"Crawley 007C","E01031598","75-79 years","Male",12,10,7,7,9,45
"Crawley 007C","E01031598","80-84 years","Male",12,13,16,16,11,68
"Crawley 007C","E01031598","85+ years","Male",9,5,7,5,8,34
"Crawley 007C","E01031598","0-4 years","Female",73,81,63,65,61,343
"Crawley 007C","E01031598","5-9 years","Female",38,35,36,39,45,193
"Crawley 007C","E01031598","10-14 years","Female",38,41,40,35,43,197
"Crawley 007C","E01031598","15-19 years","Female",34,35,32,31,36,168
"Crawley 007C","E01031598","20-24 years","Female",41,42,44,45,51,223
"Crawley 007C","E01031598","25-29 years","Female",90,80,68,63,67,368
"Crawley 007C","E01031598","30-34 years","Female",80,87,80,74,76,397
"Crawley 007C","E01031598","35-39 years","Female",59,65,71,76,80,351
"Crawley 007C","E01031598","40-44 years","Female",51,49,55,58,55,268
"Crawley 007C","E01031598","45-49 years","Female",44,46,46,43,39,218
"Crawley 007C","E01031598","50-54 years","Female",69,69,76,69,74,357
"Crawley 007C","E01031598","55-59 years","Female",36,44,44,53,56,233
"Crawley 007C","E01031598","60-64 years","Female",41,34,29,37,39,180
"Crawley 007C","E01031598","65-69 years","Female",46,40,37,35,30,188
"Crawley 007C","E01031598","70-74 years","Female",22,26,30,37,49,164
"Crawley 007C","E01031598","75-79 years","Female",33,29,23,25,23,133
"Crawley 007C","E01031598","80-84 years","Female",25,23,36,30,38,152
"Crawley 007C","E01031598","85+ years","Female",59,62,57,61,48,287
"Crawley 007D","E01031599","0-4 years","Male",81,88,90,72,78,409
"Crawley 007D","E01031599","5-9 years","Male",58,62,73,76,78,347
"Crawley 007D","E01031599","10-14 years","Male",42,48,45,41,41,217
"Crawley 007D","E01031599","15-19 years","Male",34,32,34,31,32,163
"Crawley 007D","E01031599","20-24 years","Male",56,61,45,54,53,269
"Crawley 007D","E01031599","25-29 years","Male",82,72,78,80,74,386
"Crawley 007D","E01031599","30-34 years","Male",98,99,99,100,96,492
"Crawley 007D","E01031599","35-39 years","Male",78,68,63,63,59,331
"Crawley 007D","E01031599","40-44 years","Male",81,90,91,83,93,438
"Crawley 007D","E01031599","45-49 years","Male",75,73,82,86,77,393
"Crawley 007D","E01031599","50-54 years","Male",64,65,62,65,74,330
"Crawley 007D","E01031599","55-59 years","Male",65,66,61,63,69,324
"Crawley 007D","E01031599","60-64 years","Male",33,38,40,49,53,213
"Crawley 007D","E01031599","65-69 years","Male",31,27,28,29,27,142
"Crawley 007D","E01031599","70-74 years","Male",20,29,34,34,40,157
"Crawley 007D","E01031599","75-79 years","Male",24,20,18,23,23,108
"Crawley 007D","E01031599","80-84 years","Male",16,24,24,21,14,99
"Crawley 007D","E01031599","85+ years","Male",21,22,25,22,21,111
"Crawley 007D","E01031599","0-4 years","Female",98,93,112,98,82,483
"Crawley 007D","E01031599","5-9 years","Female",46,49,50,55,55,255
"Crawley 007D","E01031599","10-14 years","Female",33,34,39,44,49,199
"Crawley 007D","E01031599","15-19 years","Female",37,34,35,32,32,170
"Crawley 007D","E01031599","20-24 years","Female",60,50,57,49,39,255
"Crawley 007D","E01031599","25-29 years","Female",94,95,101,105,97,492
"Crawley 007D","E01031599","30-34 years","Female",84,80,80,81,77,402
"Crawley 007D","E01031599","35-39 years","Female",75,78,80,83,83,399
"Crawley 007D","E01031599","40-44 years","Female",64,71,74,75,69,353
"Crawley 007D","E01031599","45-49 years","Female",47,48,50,46,44,235
"Crawley 007D","E01031599","50-54 years","Female",61,63,62,67,61,314
"Crawley 007D","E01031599","55-59 years","Female",55,53,59,57,61,285
"Crawley 007D","E01031599","60-64 years","Female",33,33,30,31,32,159
"Crawley 007D","E01031599","65-69 years","Female",36,37,36,38,35,182
"Crawley 007D","E01031599","70-74 years","Female",25,28,39,34,37,163
"Crawley 007D","E01031599","75-79 years","Female",32,30,25,27,25,139
"Crawley 007D","E01031599","80-84 years","Female",18,16,20,22,21,97
"Crawley 007D","E01031599","85+ years","Female",45,44,36,34,29,188
"Crawley 007E","E01031608","0-4 years","Male",95,96,107,120,132,550
"Crawley 007E","E01031608","5-9 years","Male",54,55,64,67,78,318
"Crawley 007E","E01031608","10-14 years","Male",35,36,37,37,47,192
"Crawley 007E","E01031608","15-19 years","Male",43,46,50,65,60,264
"Crawley 007E","E01031608","20-24 years","Male",79,74,78,74,67,372
"Crawley 007E","E01031608","25-29 years","Male",87,99,101,98,99,484
"Crawley 007E","E01031608","30-34 years","Male",106,100,106,119,124,555
"Crawley 007E","E01031608","35-39 years","Male",93,103,105,126,130,557
"Crawley 007E","E01031608","40-44 years","Male",55,48,55,58,68,284
"Crawley 007E","E01031608","45-49 years","Male",60,67,69,86,85,367
"Crawley 007E","E01031608","50-54 years","Male",61,66,76,71,72,346
"Crawley 007E","E01031608","55-59 years","Male",37,39,43,56,60,235
"Crawley 007E","E01031608","60-64 years","Male",41,40,40,38,36,195
"Crawley 007E","E01031608","65-69 years","Male",26,30,37,37,40,170
"Crawley 007E","E01031608","70-74 years","Male",19,18,21,23,23,104
"Crawley 007E","E01031608","75-79 years","Male",24,22,17,20,16,99
"Crawley 007E","E01031608","80-84 years","Male",9,9,12,11,16,57
"Crawley 007E","E01031608","85+ years","Male",4,3,1,3,4,15
"Crawley 007E","E01031608","0-4 years","Female",85,100,97,109,109,500
"Crawley 007E","E01031608","5-9 years","Female",48,47,68,75,78,316
"Crawley 007E","E01031608","10-14 years","Female",43,37,36,39,51,206
"Crawley 007E","E01031608","15-19 years","Female",53,57,66,68,70,314
"Crawley 007E","E01031608","20-24 years","Female",58,65,81,80,70,354
"Crawley 007E","E01031608","25-29 years","Female",82,81,92,111,98,464
"Crawley 007E","E01031608","30-34 years","Female",77,75,74,82,100,408
"Crawley 007E","E01031608","35-39 years","Female",93,106,115,125,117,556
"Crawley 007E","E01031608","40-44 years","Female",53,51,62,80,110,356
"Crawley 007E","E01031608","45-49 years","Female",51,58,57,62,59,287
"Crawley 007E","E01031608","50-54 years","Female",50,46,54,55,61,266
"Crawley 007E","E01031608","55-59 years","Female",45,48,44,55,54,246
"Crawley 007E","E01031608","60-64 years","Female",41,43,49,50,51,234
"Crawley 007E","E01031608","65-69 years","Female",27,29,33,30,36,155
"Crawley 007E","E01031608","70-74 years","Female",22,24,26,27,25,124
"Crawley 007E","E01031608","75-79 years","Female",18,17,17,16,21,89
"Crawley 007E","E01031608","80-84 years","Female",16,12,12,13,14,67
"Crawley 007E","E01031608","85+ years","Female",17,18,12,13,10,70
"Crawley 008A","E01031578","0-4 years","Male",72,57,59,61,56,305
"Crawley 008A","E01031578","5-9 years","Male",65,67,69,76,71,348
"Crawley 008A","E01031578","10-14 years","Male",57,54,56,57,59,283
"Crawley 008A","E01031578","15-19 years","Male",39,46,51,46,48,230
"Crawley 008A","E01031578","20-24 years","Male",54,42,51,60,57,264
"Crawley 008A","E01031578","25-29 years","Male",52,54,49,48,48,251
"Crawley 008A","E01031578","30-34 years","Male",51,50,50,43,42,236
"Crawley 008A","E01031578","35-39 years","Male",85,75,72,62,60,354
"Crawley 008A","E01031578","40-44 years","Male",91,77,73,61,55,357
"Crawley 008A","E01031578","45-49 years","Male",97,103,94,85,71,450
"Crawley 008A","E01031578","50-54 years","Male",71,66,69,71,80,357
"Crawley 008A","E01031578","55-59 years","Male",51,50,58,58,51,268
"Crawley 008A","E01031578","60-64 years","Male",40,41,44,45,48,218
"Crawley 008A","E01031578","65-69 years","Male",33,32,26,28,29,148
"Crawley 008A","E01031578","70-74 years","Male",21,19,25,26,25,116
"Crawley 008A","E01031578","75-79 years","Male",6,6,7,10,11,40
"Crawley 008A","E01031578","80-84 years","Male",3,7,8,5,7,30
"Crawley 008A","E01031578","85+ years","Male",6,5,5,6,7,29
"Crawley 008A","E01031578","0-4 years","Female",65,48,48,59,67,287
"Crawley 008A","E01031578","5-9 years","Female",62,47,50,44,35,238
"Crawley 008A","E01031578","10-14 years","Female",44,54,47,43,43,231
"Crawley 008A","E01031578","15-19 years","Female",40,40,41,33,37,191
"Crawley 008A","E01031578","20-24 years","Female",41,40,38,42,35,196
"Crawley 008A","E01031578","25-29 years","Female",58,52,63,49,47,269
"Crawley 008A","E01031578","30-34 years","Female",75,67,67,65,67,341
"Crawley 008A","E01031578","35-39 years","Female",93,82,86,73,68,402
"Crawley 008A","E01031578","40-44 years","Female",74,62,63,72,71,342
"Crawley 008A","E01031578","45-49 years","Female",84,93,91,82,78,428
"Crawley 008A","E01031578","50-54 years","Female",85,86,82,76,76,405
"Crawley 008A","E01031578","55-59 years","Female",47,44,50,51,56,248
"Crawley 008A","E01031578","60-64 years","Female",43,47,48,49,41,228
"Crawley 008A","E01031578","65-69 years","Female",46,39,36,31,31,183
"Crawley 008A","E01031578","70-74 years","Female",19,25,31,32,32,139
"Crawley 008A","E01031578","75-79 years","Female",19,21,18,21,21,100
"Crawley 008A","E01031578","80-84 years","Female",7,10,13,12,16,58
"Crawley 008A","E01031578","85+ years","Female",8,13,9,11,11,52
"Crawley 008B","E01031580","0-4 years","Male",110,107,97,80,75,469
"Crawley 008B","E01031580","5-9 years","Male",107,109,109,107,114,546
"Crawley 008B","E01031580","10-14 years","Male",91,100,105,97,86,479
"Crawley 008B","E01031580","15-19 years","Male",103,92,96,98,94,483
"Crawley 008B","E01031580","20-24 years","Male",53,58,65,68,77,321
"Crawley 008B","E01031580","25-29 years","Male",69,76,70,61,74,350
"Crawley 008B","E01031580","30-34 years","Male",87,78,73,71,60,369
"Crawley 008B","E01031580","35-39 years","Male",99,93,96,86,75,449
"Crawley 008B","E01031580","40-44 years","Male",132,114,113,116,101,576
"Crawley 008B","E01031580","45-49 years","Male",143,140,140,112,109,644
"Crawley 008B","E01031580","50-54 years","Male",83,92,98,120,117,510
"Crawley 008B","E01031580","55-59 years","Male",69,67,64,64,71,335
"Crawley 008B","E01031580","60-64 years","Male",34,35,42,45,43,199
"Crawley 008B","E01031580","65-69 years","Male",32,40,42,46,55,215
"Crawley 008B","E01031580","70-74 years","Male",13,15,18,17,20,83
"Crawley 008B","E01031580","75-79 years","Male",15,18,16,15,13,77
"Crawley 008B","E01031580","80-84 years","Male",3,2,4,3,2,14
"Crawley 008B","E01031580","85+ years","Male",3,6,7,9,12,37
"Crawley 008B","E01031580","0-4 years","Female",86,83,78,71,68,386
"Crawley 008B","E01031580","5-9 years","Female",103,101,98,87,83,472
"Crawley 008B","E01031580","10-14 years","Female",121,116,122,121,131,611
"Crawley 008B","E01031580","15-19 years","Female",91,99,93,103,102,488
"Crawley 008B","E01031580","20-24 years","Female",61,52,52,49,62,276
"Crawley 008B","E01031580","25-29 years","Female",65,60,61,52,53,291
"Crawley 008B","E01031580","30-34 years","Female",108,100,96,92,81,477
"Crawley 008B","E01031580","35-39 years","Female",125,117,118,106,94,560
"Crawley 008B","E01031580","40-44 years","Female",113,111,107,106,101,538
"Crawley 008B","E01031580","45-49 years","Female",122,127,121,114,121,605
"Crawley 008B","E01031580","50-54 years","Female",88,88,89,90,81,436
"Crawley 008B","E01031580","55-59 years","Female",64,64,79,83,85,375
"Crawley 008B","E01031580","60-64 years","Female",34,35,40,52,56,217
"Crawley 008B","E01031580","65-69 years","Female",36,28,27,26,24,141
"Crawley 008B","E01031580","70-74 years","Female",21,36,38,39,43,177
"Crawley 008B","E01031580","75-79 years","Female",14,14,13,19,22,82
"Crawley 008B","E01031580","80-84 years","Female",8,6,9,9,9,41
"Crawley 008B","E01031580","85+ years","Female",11,13,13,10,11,58
"Crawley 008C","E01031581","0-4 years","Male",63,53,40,33,35,224
"Crawley 008C","E01031581","5-9 years","Male",78,77,77,66,60,358
"Crawley 008C","E01031581","10-14 years","Male",62,66,70,72,77,347
"Crawley 008C","E01031581","15-19 years","Male",67,71,70,67,69,344
"Crawley 008C","E01031581","20-24 years","Male",48,45,49,56,55,253
"Crawley 008C","E01031581","25-29 years","Male",38,36,38,41,42,195
"Crawley 008C","E01031581","30-34 years","Male",38,40,39,37,35,189
"Crawley 008C","E01031581","35-39 years","Male",71,65,64,56,55,311
"Crawley 008C","E01031581","40-44 years","Male",68,68,71,66,68,341
"Crawley 008C","E01031581","45-49 years","Male",112,100,84,86,82,464
"Crawley 008C","E01031581","50-54 years","Male",80,86,92,86,88,432
"Crawley 008C","E01031581","55-59 years","Male",45,54,64,77,79,319
"Crawley 008C","E01031581","60-64 years","Male",38,39,44,40,34,195
"Crawley 008C","E01031581","65-69 years","Male",21,30,22,25,29,127
"Crawley 008C","E01031581","70-74 years","Male",14,11,19,20,22,86
"Crawley 008C","E01031581","75-79 years","Male",15,14,15,16,15,75
"Crawley 008C","E01031581","80-84 years","Male",8,8,7,6,7,36
"Crawley 008C","E01031581","85+ years","Male",2,3,1,4,3,13
"Crawley 008C","E01031581","0-4 years","Female",56,45,49,35,30,215
"Crawley 008C","E01031581","5-9 years","Female",73,79,75,72,66,365
"Crawley 008C","E01031581","10-14 years","Female",71,66,67,74,77,355
"Crawley 008C","E01031581","15-19 years","Female",55,57,56,55,53,276
"Crawley 008C","E01031581","20-24 years","Female",37,38,46,40,42,203
"Crawley 008C","E01031581","25-29 years","Female",41,45,30,34,36,186
"Crawley 008C","E01031581","30-34 years","Female",52,46,43,40,42,223
"Crawley 008C","E01031581","35-39 years","Female",69,70,63,54,49,305
"Crawley 008C","E01031581","40-44 years","Female",94,81,79,87,85,426
"Crawley 008C","E01031581","45-49 years","Female",103,92,83,91,93,462
"Crawley 008C","E01031581","50-54 years","Female",78,91,101,91,95,456
"Crawley 008C","E01031581","55-59 years","Female",41,46,47,49,53,236
"Crawley 008C","E01031581","60-64 years","Female",24,23,26,31,29,133
"Crawley 008C","E01031581","65-69 years","Female",24,22,22,22,19,109
"Crawley 008C","E01031581","70-74 years","Female",16,17,21,18,24,96
"Crawley 008C","E01031581","75-79 years","Female",14,18,19,16,13,80
"Crawley 008C","E01031581","80-84 years","Female",5,6,4,6,6,27
"Crawley 008C","E01031581","85+ years","Female",8,11,16,21,21,77
"Crawley 008D","E01031592","0-4 years","Male",50,47,52,51,55,255
"Crawley 008D","E01031592","5-9 years","Male",55,56,55,52,48,266
"Crawley 008D","E01031592","10-14 years","Male",58,54,50,55,67,284
"Crawley 008D","E01031592","15-19 years","Male",52,48,54,45,44,243
"Crawley 008D","E01031592","20-24 years","Male",55,50,53,47,46,251
"Crawley 008D","E01031592","25-29 years","Male",46,56,49,49,43,243
"Crawley 008D","E01031592","30-34 years","Male",66,59,53,45,47,270
"Crawley 008D","E01031592","35-39 years","Male",69,63,71,63,65,331
"Crawley 008D","E01031592","40-44 years","Male",77,80,73,65,59,354
"Crawley 008D","E01031592","45-49 years","Male",85,84,84,86,88,427
"Crawley 008D","E01031592","50-54 years","Male",81,88,90,74,73,406
"Crawley 008D","E01031592","55-59 years","Male",64,67,63,71,73,338
"Crawley 008D","E01031592","60-64 years","Male",66,61,68,68,68,331
"Crawley 008D","E01031592","65-69 years","Male",72,65,57,58,54,306
"Crawley 008D","E01031592","70-74 years","Male",43,52,61,65,59,280
"Crawley 008D","E01031592","75-79 years","Male",29,24,23,27,36,139
"Crawley 008D","E01031592","80-84 years","Male",14,13,21,23,21,92
"Crawley 008D","E01031592","85+ years","Male",18,16,14,14,16,78
"Crawley 008D","E01031592","0-4 years","Female",45,47,50,35,35,212
"Crawley 008D","E01031592","5-9 years","Female",73,77,66,71,73,360
"Crawley 008D","E01031592","10-14 years","Female",59,59,70,66,67,321
"Crawley 008D","E01031592","15-19 years","Female",55,60,62,63,56,296
"Crawley 008D","E01031592","20-24 years","Female",30,31,34,30,28,153
"Crawley 008D","E01031592","25-29 years","Female",62,53,45,43,36,239
"Crawley 008D","E01031592","30-34 years","Female",58,62,57,47,49,273
"Crawley 008D","E01031592","35-39 years","Female",64,60,67,67,66,324
"Crawley 008D","E01031592","40-44 years","Female",75,64,62,61,59,321
"Crawley 008D","E01031592","45-49 years","Female",67,70,77,76,80,370
"Crawley 008D","E01031592","50-54 years","Female",82,72,70,77,73,374
"Crawley 008D","E01031592","55-59 years","Female",81,84,77,61,69,372
"Crawley 008D","E01031592","60-64 years","Female",75,77,80,87,96,415
"Crawley 008D","E01031592","65-69 years","Female",56,50,53,56,54,269
"Crawley 008D","E01031592","70-74 years","Female",38,48,52,62,59,259
"Crawley 008D","E01031592","75-79 years","Female",20,21,28,21,26,116
"Crawley 008D","E01031592","80-84 years","Female",25,22,20,17,15,99
"Crawley 008D","E01031592","85+ years","Female",19,25,15,24,19,102
"Crawley 009A","E01031560","0-4 years","Male",50,56,43,45,44,238
"Crawley 009A","E01031560","5-9 years","Male",44,45,50,45,45,229
"Crawley 009A","E01031560","10-14 years","Male",42,46,52,49,48,237
"Crawley 009A","E01031560","15-19 years","Male",34,32,33,37,38,174
"Crawley 009A","E01031560","20-24 years","Male",36,34,35,32,30,167
"Crawley 009A","E01031560","25-29 years","Male",35,42,42,41,42,202
"Crawley 009A","E01031560","30-34 years","Male",47,43,38,38,36,202
"Crawley 009A","E01031560","35-39 years","Male",40,45,47,47,39,218
"Crawley 009A","E01031560","40-44 years","Male",40,41,41,46,60,228
"Crawley 009A","E01031560","45-49 years","Male",40,45,42,41,32,200
"Crawley 009A","E01031560","50-54 years","Male",79,62,48,46,57,292
"Crawley 009A","E01031560","55-59 years","Male",50,50,54,55,55,264
"Crawley 009A","E01031560","60-64 years","Male",49,50,51,52,46,248
"Crawley 009A","E01031560","65-69 years","Male",54,47,45,38,43,227
"Crawley 009A","E01031560","70-74 years","Male",50,53,58,62,56,279
"Crawley 009A","E01031560","75-79 years","Male",22,27,23,29,36,137
"Crawley 009A","E01031560","80-84 years","Male",23,20,22,19,14,98
"Crawley 009A","E01031560","85+ years","Male",22,17,17,19,22,97
"Crawley 009A","E01031560","0-4 years","Female",40,39,40,40,38,197
"Crawley 009A","E01031560","5-9 years","Female",32,33,29,33,34,161
"Crawley 009A","E01031560","10-14 years","Female",35,34,35,41,38,183
"Crawley 009A","E01031560","15-19 years","Female",44,43,41,47,52,227
"Crawley 009A","E01031560","20-24 years","Female",32,31,28,30,31,152
"Crawley 009A","E01031560","25-29 years","Female",28,30,27,23,21,129
"Crawley 009A","E01031560","30-34 years","Female",41,51,51,46,40,229
"Crawley 009A","E01031560","35-39 years","Female",36,38,31,29,28,162
"Crawley 009A","E01031560","40-44 years","Female",39,36,39,50,52,216
"Crawley 009A","E01031560","45-49 years","Female",51,50,46,38,35,220
"Crawley 009A","E01031560","50-54 years","Female",56,59,55,53,53,276
"Crawley 009A","E01031560","55-59 years","Female",66,56,55,53,56,286
"Crawley 009A","E01031560","60-64 years","Female",46,58,60,61,62,287
"Crawley 009A","E01031560","65-69 years","Female",59,56,55,53,45,268
"Crawley 009A","E01031560","70-74 years","Female",45,43,49,61,67,265
"Crawley 009A","E01031560","75-79 years","Female",30,28,29,27,33,147
"Crawley 009A","E01031560","80-84 years","Female",34,33,33,32,33,165
"Crawley 009A","E01031560","85+ years","Female",35,38,42,43,42,200
"Crawley 009B","E01031561","0-4 years","Male",43,45,53,47,50,238
"Crawley 009B","E01031561","5-9 years","Male",35,40,37,41,39,192
"Crawley 009B","E01031561","10-14 years","Male",40,41,45,47,47,220
"Crawley 009B","E01031561","15-19 years","Male",36,39,35,35,36,181
"Crawley 009B","E01031561","20-24 years","Male",66,71,66,62,60,325
"Crawley 009B","E01031561","25-29 years","Male",65,54,58,50,54,281
"Crawley 009B","E01031561","30-34 years","Male",52,60,52,57,53,274
"Crawley 009B","E01031561","35-39 years","Male",39,43,46,47,41,216
"Crawley 009B","E01031561","40-44 years","Male",43,46,34,39,46,208
"Crawley 009B","E01031561","45-49 years","Male",51,51,56,48,43,249
"Crawley 009B","E01031561","50-54 years","Male",56,49,44,58,59,266
"Crawley 009B","E01031561","55-59 years","Male",48,54,54,51,44,251
"Crawley 009B","E01031561","60-64 years","Male",51,48,48,41,37,225
"Crawley 009B","E01031561","65-69 years","Male",38,33,31,36,44,182
"Crawley 009B","E01031561","70-74 years","Male",49,46,47,36,35,213
"Crawley 009B","E01031561","75-79 years","Male",30,33,27,32,33,155
"Crawley 009B","E01031561","80-84 years","Male",15,14,15,15,19,78
"Crawley 009B","E01031561","85+ years","Male",27,36,36,34,32,165
"Crawley 009B","E01031561","0-4 years","Female",41,45,48,36,37,207
"Crawley 009B","E01031561","5-9 years","Female",44,42,45,52,48,231
"Crawley 009B","E01031561","10-14 years","Female",29,26,30,35,38,158
"Crawley 009B","E01031561","15-19 years","Female",36,41,39,43,40,199
"Crawley 009B","E01031561","20-24 years","Female",24,23,23,19,25,114
"Crawley 009B","E01031561","25-29 years","Female",42,42,45,41,34,204
"Crawley 009B","E01031561","30-34 years","Female",39,40,37,36,30,182
"Crawley 009B","E01031561","35-39 years","Female",43,45,48,50,46,232
"Crawley 009B","E01031561","40-44 years","Female",45,48,45,46,54,238
"Crawley 009B","E01031561","45-49 years","Female",50,50,48,48,42,238
"Crawley 009B","E01031561","50-54 years","Female",46,46,49,39,47,227
"Crawley 009B","E01031561","55-59 years","Female",49,49,47,47,39,231
"Crawley 009B","E01031561","60-64 years","Female",50,53,48,58,58,267
"Crawley 009B","E01031561","65-69 years","Female",51,47,43,38,38,217
"Crawley 009B","E01031561","70-74 years","Female",51,47,46,46,40,230
"Crawley 009B","E01031561","75-79 years","Female",32,39,47,41,46,205
"Crawley 009B","E01031561","80-84 years","Female",25,20,20,31,29,125
"Crawley 009B","E01031561","85+ years","Female",26,30,28,25,29,138
"Crawley 009C","E01031562","0-4 years","Male",50,59,49,53,39,250
"Crawley 009C","E01031562","5-9 years","Male",51,49,54,60,56,270
"Crawley 009C","E01031562","10-14 years","Male",34,30,38,43,46,191
"Crawley 009C","E01031562","15-19 years","Male",37,41,35,37,31,181
"Crawley 009C","E01031562","20-24 years","Male",31,25,22,24,27,129
"Crawley 009C","E01031562","25-29 years","Male",43,53,50,49,47,242
"Crawley 009C","E01031562","30-34 years","Male",51,46,47,36,32,212
"Crawley 009C","E01031562","35-39 years","Male",53,62,62,51,42,270
"Crawley 009C","E01031562","40-44 years","Male",26,24,24,30,31,135
"Crawley 009C","E01031562","45-49 years","Male",55,50,43,43,39,230
"Crawley 009C","E01031562","50-54 years","Male",35,39,40,44,45,203
"Crawley 009C","E01031562","55-59 years","Male",47,44,38,36,33,198
"Crawley 009C","E01031562","60-64 years","Male",34,41,41,45,41,202
"Crawley 009C","E01031562","65-69 years","Male",38,36,37,39,41,191
"Crawley 009C","E01031562","70-74 years","Male",24,34,26,24,22,130
"Crawley 009C","E01031562","75-79 years","Male",21,21,25,23,28,118
"Crawley 009C","E01031562","80-84 years","Male",17,17,15,21,22,92
"Crawley 009C","E01031562","85+ years","Male",7,7,11,7,6,38
"Crawley 009C","E01031562","0-4 years","Female",56,53,50,55,54,268
"Crawley 009C","E01031562","5-9 years","Female",35,43,46,45,43,212
"Crawley 009C","E01031562","10-14 years","Female",34,39,35,33,34,175
"Crawley 009C","E01031562","15-19 years","Female",32,27,29,32,31,151
"Crawley 009C","E01031562","20-24 years","Female",41,36,36,36,28,177
"Crawley 009C","E01031562","25-29 years","Female",45,43,46,41,36,211
"Crawley 009C","E01031562","30-34 years","Female",50,54,59,52,48,263
"Crawley 009C","E01031562","35-39 years","Female",38,42,44,52,51,227
"Crawley 009C","E01031562","40-44 years","Female",37,35,39,41,32,184
"Crawley 009C","E01031562","45-49 years","Female",35,36,33,37,48,189
"Crawley 009C","E01031562","50-54 years","Female",33,38,37,31,34,173
"Crawley 009C","E01031562","55-59 years","Female",28,28,32,35,37,160
"Crawley 009C","E01031562","60-64 years","Female",45,44,37,40,34,200
"Crawley 009C","E01031562","65-69 years","Female",53,56,49,45,43,246
"Crawley 009C","E01031562","70-74 years","Female",33,45,51,57,55,241
"Crawley 009C","E01031562","75-79 years","Female",22,17,19,22,23,103
"Crawley 009C","E01031562","80-84 years","Female",27,25,26,19,20,117
"Crawley 009C","E01031562","85+ years","Female",32,29,26,30,27,144
"Crawley 009D","E01031563","0-4 years","Male",29,33,29,22,24,137
"Crawley 009D","E01031563","5-9 years","Male",46,45,54,55,62,262
"Crawley 009D","E01031563","10-14 years","Male",37,42,51,53,47,230
"Crawley 009D","E01031563","15-19 years","Male",49,44,51,47,53,244
"Crawley 009D","E01031563","20-24 years","Male",34,38,43,37,35,187
"Crawley 009D","E01031563","25-29 years","Male",52,52,38,55,58,255
"Crawley 009D","E01031563","30-34 years","Male",34,37,38,33,32,174
"Crawley 009D","E01031563","35-39 years","Male",40,33,39,41,39,192
"Crawley 009D","E01031563","40-44 years","Male",28,33,30,35,35,161
"Crawley 009D","E01031563","45-49 years","Male",53,51,49,44,42,239
"Crawley 009D","E01031563","50-54 years","Male",60,62,62,57,64,305
"Crawley 009D","E01031563","55-59 years","Male",49,53,51,58,49,260
"Crawley 009D","E01031563","60-64 years","Male",41,35,41,40,49,206
"Crawley 009D","E01031563","65-69 years","Male",46,42,40,42,41,211
"Crawley 009D","E01031563","70-74 years","Male",26,28,36,34,34,158
"Crawley 009D","E01031563","75-79 years","Male",14,21,21,22,21,99
"Crawley 009D","E01031563","80-84 years","Male",14,10,10,12,11,57
"Crawley 009D","E01031563","85+ years","Male",26,24,18,14,14,96
"Crawley 009D","E01031563","0-4 years","Female",34,28,33,39,36,170
"Crawley 009D","E01031563","5-9 years","Female",29,37,31,29,28,154
"Crawley 009D","E01031563","10-14 years","Female",31,29,31,35,39,165
"Crawley 009D","E01031563","15-19 years","Female",43,36,37,29,27,172
"Crawley 009D","E01031563","20-24 years","Female",37,32,30,26,25,150
"Crawley 009D","E01031563","25-29 years","Female",55,53,48,49,45,250
"Crawley 009D","E01031563","30-34 years","Female",37,39,39,34,34,183
"Crawley 009D","E01031563","35-39 years","Female",59,60,60,67,67,313
"Crawley 009D","E01031563","40-44 years","Female",46,48,45,45,49,233
"Crawley 009D","E01031563","45-49 years","Female",40,41,39,45,48,213
"Crawley 009D","E01031563","50-54 years","Female",55,53,57,52,49,266
"Crawley 009D","E01031563","55-59 years","Female",57,60,58,54,57,286
"Crawley 009D","E01031563","60-64 years","Female",32,34,39,48,48,201
"Crawley 009D","E01031563","65-69 years","Female",32,34,35,29,29,159
"Crawley 009D","E01031563","70-74 years","Female",42,47,44,50,47,230
"Crawley 009D","E01031563","75-79 years","Female",25,19,20,17,17,98
"Crawley 009D","E01031563","80-84 years","Female",41,37,37,31,30,176
"Crawley 009D","E01031563","85+ years","Female",52,52,57,58,58,277
"Crawley 009E","E01031579","0-4 years","Male",48,55,44,45,45,237
"Crawley 009E","E01031579","5-9 years","Male",45,42,39,44,44,214
"Crawley 009E","E01031579","10-14 years","Male",50,52,55,38,38,233
"Crawley 009E","E01031579","15-19 years","Male",55,55,53,50,46,259
"Crawley 009E","E01031579","20-24 years","Male",28,30,29,25,26,138
"Crawley 009E","E01031579","25-29 years","Male",65,61,64,63,60,313
"Crawley 009E","E01031579","30-34 years","Male",87,74,63,56,60,340
"Crawley 009E","E01031579","35-39 years","Male",64,58,62,64,64,312
"Crawley 009E","E01031579","40-44 years","Male",78,75,56,57,57,323
"Crawley 009E","E01031579","45-49 years","Male",50,55,62,70,65,302
"Crawley 009E","E01031579","50-54 years","Male",62,54,54,37,37,244
"Crawley 009E","E01031579","55-59 years","Male",33,43,52,52,58,238
"Crawley 009E","E01031579","60-64 years","Male",28,28,26,33,27,142
"Crawley 009E","E01031579","65-69 years","Male",14,18,20,23,26,101
"Crawley 009E","E01031579","70-74 years","Male",9,12,11,10,10,52
"Crawley 009E","E01031579","75-79 years","Male",8,7,10,12,12,49
"Crawley 009E","E01031579","80-84 years","Male",5,4,3,2,1,15
"Crawley 009E","E01031579","85+ years","Male",5,5,7,5,3,25
"Crawley 009E","E01031579","0-4 years","Female",56,52,48,46,38,240
"Crawley 009E","E01031579","5-9 years","Female",64,65,59,55,49,292
"Crawley 009E","E01031579","10-14 years","Female",37,37,43,47,51,215
"Crawley 009E","E01031579","15-19 years","Female",47,44,35,37,37,200
"Crawley 009E","E01031579","20-24 years","Female",39,44,47,41,43,214
"Crawley 009E","E01031579","25-29 years","Female",67,60,60,53,55,295
"Crawley 009E","E01031579","30-34 years","Female",75,78,71,69,70,363
"Crawley 009E","E01031579","35-39 years","Female",67,72,68,64,62,333
"Crawley 009E","E01031579","40-44 years","Female",70,69,67,73,76,355
"Crawley 009E","E01031579","45-49 years","Female",57,61,61,65,60,304
"Crawley 009E","E01031579","50-54 years","Female",69,66,57,48,49,289
"Crawley 009E","E01031579","55-59 years","Female",36,47,50,52,53,238
"Crawley 009E","E01031579","60-64 years","Female",28,27,27,32,38,152
"Crawley 009E","E01031579","65-69 years","Female",13,14,14,13,12,66
"Crawley 009E","E01031579","70-74 years","Female",13,15,16,17,20,81
"Crawley 009E","E01031579","75-79 years","Female",8,13,11,10,10,52
"Crawley 009E","E01031579","80-84 years","Female",8,7,4,4,4,27
"Crawley 009E","E01031579","85+ years","Female",20,15,14,16,13,78
"Crawley 009F","E01031582","0-4 years","Male",121,108,94,88,116,527
"Crawley 009F","E01031582","5-9 years","Male",67,78,81,81,71,378
"Crawley 009F","E01031582","10-14 years","Male",74,65,59,69,69,336
"Crawley 009F","E01031582","15-19 years","Male",57,64,65,59,57,302
"Crawley 009F","E01031582","20-24 years","Male",52,55,50,59,54,270
"Crawley 009F","E01031582","25-29 years","Male",88,90,90,86,82,436
"Crawley 009F","E01031582","30-34 years","Male",80,69,79,82,77,387
"Crawley 009F","E01031582","35-39 years","Male",101,93,91,91,83,459
"Crawley 009F","E01031582","40-44 years","Male",86,87,90,87,83,433
"Crawley 009F","E01031582","45-49 years","Male",97,89,85,83,82,436
"Crawley 009F","E01031582","50-54 years","Male",65,64,79,79,78,365
"Crawley 009F","E01031582","55-59 years","Male",48,51,58,74,73,304
"Crawley 009F","E01031582","60-64 years","Male",32,34,33,37,40,176
"Crawley 009F","E01031582","65-69 years","Male",15,12,15,16,13,71
"Crawley 009F","E01031582","70-74 years","Male",13,14,12,7,13,59
"Crawley 009F","E01031582","75-79 years","Male",6,3,3,4,7,23
"Crawley 009F","E01031582","80-84 years","Male",2,3,0,1,0,6
"Crawley 009F","E01031582","85+ years","Male",2,2,4,2,1,11
"Crawley 009F","E01031582","0-4 years","Female",66,75,71,71,61,344
"Crawley 009F","E01031582","5-9 years","Female",68,55,57,53,49,282
"Crawley 009F","E01031582","10-14 years","Female",56,67,66,63,57,309
"Crawley 009F","E01031582","15-19 years","Female",40,39,41,45,47,212
"Crawley 009F","E01031582","20-24 years","Female",52,41,40,42,45,220
"Crawley 009F","E01031582","25-29 years","Female",88,92,80,80,73,413
"Crawley 009F","E01031582","30-34 years","Female",106,86,90,89,87,458
"Crawley 009F","E01031582","35-39 years","Female",106,103,97,94,79,479
"Crawley 009F","E01031582","40-44 years","Female",101,90,105,91,99,486
"Crawley 009F","E01031582","45-49 years","Female",89,96,86,87,74,432
"Crawley 009F","E01031582","50-54 years","Female",88,85,89,94,90,446
"Crawley 009F","E01031582","55-59 years","Female",34,39,46,49,59,227
"Crawley 009F","E01031582","60-64 years","Female",39,39,43,35,34,190
"Crawley 009F","E01031582","65-69 years","Female",29,23,24,26,28,130
"Crawley 009F","E01031582","70-74 years","Female",11,15,15,15,17,73
"Crawley 009F","E01031582","75-79 years","Female",5,6,9,7,8,35
"Crawley 009F","E01031582","80-84 years","Female",2,3,3,4,4,16
"Crawley 009F","E01031582","85+ years","Female",12,10,10,11,9,52
"Crawley 010A","E01031547","0-4 years","Male",47,50,43,43,35,218
"Crawley 010A","E01031547","5-9 years","Male",60,65,69,66,67,327
"Crawley 010A","E01031547","10-14 years","Male",42,45,46,41,44,218
"Crawley 010A","E01031547","15-19 years","Male",47,37,37,30,31,182
"Crawley 010A","E01031547","20-24 years","Male",45,52,49,45,39,230
"Crawley 010A","E01031547","25-29 years","Male",63,64,52,45,49,273
"Crawley 010A","E01031547","30-34 years","Male",48,50,49,52,49,248
"Crawley 010A","E01031547","35-39 years","Male",51,54,58,45,46,254
"Crawley 010A","E01031547","40-44 years","Male",44,38,36,45,49,212
"Crawley 010A","E01031547","45-49 years","Male",49,53,50,44,38,234
"Crawley 010A","E01031547","50-54 years","Male",46,46,38,44,48,222
"Crawley 010A","E01031547","55-59 years","Male",38,39,49,47,39,212
"Crawley 010A","E01031547","60-64 years","Male",36,38,28,31,40,173
"Crawley 010A","E01031547","65-69 years","Male",13,13,18,18,16,78
"Crawley 010A","E01031547","70-74 years","Male",7,6,2,2,4,21
"Crawley 010A","E01031547","75-79 years","Male",4,3,7,6,2,22
"Crawley 010A","E01031547","80-84 years","Male",9,8,6,9,9,41
"Crawley 010A","E01031547","85+ years","Male",3,10,5,4,5,27
"Crawley 010A","E01031547","0-4 years","Female",47,53,56,48,47,251
"Crawley 010A","E01031547","5-9 years","Female",38,36,28,29,37,168
"Crawley 010A","E01031547","10-14 years","Female",53,53,58,58,58,280
"Crawley 010A","E01031547","15-19 years","Female",39,40,44,38,39,200
"Crawley 010A","E01031547","20-24 years","Female",31,25,19,20,19,114
"Crawley 010A","E01031547","25-29 years","Female",67,64,58,50,44,283
"Crawley 010A","E01031547","30-34 years","Female",67,70,62,63,55,317
"Crawley 010A","E01031547","35-39 years","Female",60,59,59,67,57,302
"Crawley 010A","E01031547","40-44 years","Female",50,52,46,40,52,240
"Crawley 010A","E01031547","45-49 years","Female",59,53,57,49,44,262
"Crawley 010A","E01031547","50-54 years","Female",64,63,60,60,59,306
"Crawley 010A","E01031547","55-59 years","Female",48,45,43,52,52,240
"Crawley 010A","E01031547","60-64 years","Female",23,27,28,25,28,131
"Crawley 010A","E01031547","65-69 years","Female",22,24,25,32,26,129
"Crawley 010A","E01031547","70-74 years","Female",13,15,9,8,21,66
"Crawley 010A","E01031547","75-79 years","Female",22,20,20,19,19,100
"Crawley 010A","E01031547","80-84 years","Female",2,2,4,4,4,16
"Crawley 010A","E01031547","85+ years","Female",9,10,4,2,3,28
"Crawley 010B","E01031548","0-4 years","Male",92,77,72,63,67,371
"Crawley 010B","E01031548","5-9 years","Male",80,86,78,80,77,401
"Crawley 010B","E01031548","10-14 years","Male",59,60,77,62,72,330
"Crawley 010B","E01031548","15-19 years","Male",45,49,41,57,54,246
"Crawley 010B","E01031548","20-24 years","Male",39,39,41,33,30,182
"Crawley 010B","E01031548","25-29 years","Male",58,60,49,47,41,255
"Crawley 010B","E01031548","30-34 years","Male",83,67,68,64,55,337
"Crawley 010B","E01031548","35-39 years","Male",83,83,85,85,79,415
"Crawley 010B","E01031548","40-44 years","Male",59,67,69,68,66,329
"Crawley 010B","E01031548","45-49 years","Male",55,51,52,53,53,264
"Crawley 010B","E01031548","50-54 years","Male",75,73,72,61,59,340
"Crawley 010B","E01031548","55-59 years","Male",50,54,54,58,57,273
"Crawley 010B","E01031548","60-64 years","Male",42,38,38,39,36,193
"Crawley 010B","E01031548","65-69 years","Male",35,33,38,32,33,171
"Crawley 010B","E01031548","70-74 years","Male",20,28,28,28,26,130
"Crawley 010B","E01031548","75-79 years","Male",9,12,14,19,21,75
"Crawley 010B","E01031548","80-84 years","Male",2,4,4,5,9,24
"Crawley 010B","E01031548","85+ years","Male",5,6,7,5,5,28
"Crawley 010B","E01031548","0-4 years","Female",93,85,82,71,78,409
"Crawley 010B","E01031548","5-9 years","Female",67,73,71,76,77,364
"Crawley 010B","E01031548","10-14 years","Female",32,35,34,43,45,189
"Crawley 010B","E01031548","15-19 years","Female",32,27,25,21,22,127
"Crawley 010B","E01031548","20-24 years","Female",74,60,55,44,49,282
"Crawley 010B","E01031548","25-29 years","Female",57,50,49,42,37,235
"Crawley 010B","E01031548","30-34 years","Female",70,66,68,79,76,359
"Crawley 010B","E01031548","35-39 years","Female",87,91,90,76,65,409
"Crawley 010B","E01031548","40-44 years","Female",53,59,58,70,79,319
"Crawley 010B","E01031548","45-49 years","Female",56,49,53,47,47,252
"Crawley 010B","E01031548","50-54 years","Female",56,53,51,45,46,251
"Crawley 010B","E01031548","55-59 years","Female",52,55,54,62,55,278
"Crawley 010B","E01031548","60-64 years","Female",38,39,42,36,47,202
"Crawley 010B","E01031548","65-69 years","Female",40,34,37,43,43,197
"Crawley 010B","E01031548","70-74 years","Female",12,16,18,23,19,88
"Crawley 010B","E01031548","75-79 years","Female",13,17,14,13,12,69
"Crawley 010B","E01031548","80-84 years","Female",4,2,1,0,0,7
"Crawley 010B","E01031548","85+ years","Female",12,9,10,10,8,49
"Crawley 010C","E01031549","0-4 years","Male",96,86,94,87,77,440
"Crawley 010C","E01031549","5-9 years","Male",64,69,62,68,75,338
"Crawley 010C","E01031549","10-14 years","Male",63,71,66,74,85,359
"Crawley 010C","E01031549","15-19 years","Male",55,62,66,53,48,284
"Crawley 010C","E01031549","20-24 years","Male",38,43,45,51,47,224
"Crawley 010C","E01031549","25-29 years","Male",63,55,58,47,44,267
"Crawley 010C","E01031549","30-34 years","Male",93,89,76,65,57,380
"Crawley 010C","E01031549","35-39 years","Male",83,92,90,91,84,440
"Crawley 010C","E01031549","40-44 years","Male",84,96,101,99,103,483
"Crawley 010C","E01031549","45-49 years","Male",50,54,51,60,57,272
"Crawley 010C","E01031549","50-54 years","Male",52,49,54,52,54,261
"Crawley 010C","E01031549","55-59 years","Male",52,48,48,44,41,233
"Crawley 010C","E01031549","60-64 years","Male",42,44,44,47,53,230
"Crawley 010C","E01031549","65-69 years","Male",24,27,24,24,19,118
"Crawley 010C","E01031549","70-74 years","Male",7,7,11,10,12,47
"Crawley 010C","E01031549","75-79 years","Male",11,10,9,12,8,50
"Crawley 010C","E01031549","80-84 years","Male",5,7,9,6,7,34
"Crawley 010C","E01031549","85+ years","Male",7,8,6,6,7,34
"Crawley 010C","E01031549","0-4 years","Female",77,65,67,66,67,342
"Crawley 010C","E01031549","5-9 years","Female",87,85,80,73,61,386
"Crawley 010C","E01031549","10-14 years","Female",50,64,63,59,66,302
"Crawley 010C","E01031549","15-19 years","Female",45,53,58,61,52,269
"Crawley 010C","E01031549","20-24 years","Female",46,36,37,34,38,191
"Crawley 010C","E01031549","25-29 years","Female",85,73,73,66,52,349
"Crawley 010C","E01031549","30-34 years","Female",105,107,102,100,99,513
"Crawley 010C","E01031549","35-39 years","Female",67,72,72,63,63,337
"Crawley 010C","E01031549","40-44 years","Female",62,73,60,71,80,346
"Crawley 010C","E01031549","45-49 years","Female",52,52,54,55,56,269
"Crawley 010C","E01031549","50-54 years","Female",53,46,47,46,40,232
"Crawley 010C","E01031549","55-59 years","Female",59,55,48,47,50,259
"Crawley 010C","E01031549","60-64 years","Female",41,49,48,44,52,234
"Crawley 010C","E01031549","65-69 years","Female",23,27,36,44,36,166
"Crawley 010C","E01031549","70-74 years","Female",3,6,7,7,11,34
"Crawley 010C","E01031549","75-79 years","Female",8,7,4,9,11,39
"Crawley 010C","E01031549","80-84 years","Female",7,4,4,4,3,22
"Crawley 010C","E01031549","85+ years","Female",7,7,9,8,9,40
"Crawley 010D","E01031550","0-4 years","Male",43,41,36,41,44,205
"Crawley 010D","E01031550","5-9 years","Male",77,74,66,60,50,327
"Crawley 010D","E01031550","10-14 years","Male",47,46,45,49,53,240
"Crawley 010D","E01031550","15-19 years","Male",51,48,45,40,37,221
"Crawley 010D","E01031550","20-24 years","Male",44,46,52,54,52,248
"Crawley 010D","E01031550","25-29 years","Male",30,31,30,32,25,148
"Crawley 010D","E01031550","30-34 years","Male",56,51,53,44,45,249
"Crawley 010D","E01031550","35-39 years","Male",63,73,62,59,59,316
"Crawley 010D","E01031550","40-44 years","Male",43,38,43,43,53,220
"Crawley 010D","E01031550","45-49 years","Male",71,64,68,55,46,304
"Crawley 010D","E01031550","50-54 years","Male",77,70,65,66,59,337
"Crawley 010D","E01031550","55-59 years","Male",63,65,55,64,58,305
"Crawley 010D","E01031550","60-64 years","Male",41,53,57,54,64,269
"Crawley 010D","E01031550","65-69 years","Male",11,9,16,21,23,80
"Crawley 010D","E01031550","70-74 years","Male",21,22,21,13,14,91
"Crawley 010D","E01031550","75-79 years","Male",4,4,7,11,8,34
"Crawley 010D","E01031550","80-84 years","Male",9,9,8,11,2,39
"Crawley 010D","E01031550","85+ years","Male",3,3,4,5,6,21
"Crawley 010D","E01031550","0-4 years","Female",40,41,35,39,41,196
"Crawley 010D","E01031550","5-9 years","Female",49,44,41,34,33,201
"Crawley 010D","E01031550","10-14 years","Female",51,46,45,49,53,244
"Crawley 010D","E01031550","15-19 years","Female",63,63,50,49,45,270
"Crawley 010D","E01031550","20-24 years","Female",38,31,28,26,20,143
"Crawley 010D","E01031550","25-29 years","Female",63,63,58,59,48,291
"Crawley 010D","E01031550","30-34 years","Female",54,47,41,47,51,240
"Crawley 010D","E01031550","35-39 years","Female",60,69,69,59,55,312
"Crawley 010D","E01031550","40-44 years","Female",66,63,58,56,54,297
"Crawley 010D","E01031550","45-49 years","Female",54,49,56,49,51,259
"Crawley 010D","E01031550","50-54 years","Female",91,85,77,73,55,381
"Crawley 010D","E01031550","55-59 years","Female",56,64,72,69,70,331
"Crawley 010D","E01031550","60-64 years","Female",39,42,43,45,56,225
"Crawley 010D","E01031550","65-69 years","Female",10,10,13,15,14,62
"Crawley 010D","E01031550","70-74 years","Female",21,23,22,26,24,116
"Crawley 010D","E01031550","75-79 years","Female",6,7,10,11,10,44
"Crawley 010D","E01031550","80-84 years","Female",4,5,1,2,5,17
"Crawley 010D","E01031550","85+ years","Female",2,3,2,3,2,12
"Crawley 010E","E01031569","0-4 years","Male",65,74,76,77,83,375
"Crawley 010E","E01031569","5-9 years","Male",65,58,59,56,56,294
"Crawley 010E","E01031569","10-14 years","Male",54,54,53,52,53,266
"Crawley 010E","E01031569","15-19 years","Male",45,40,46,43,51,225
"Crawley 010E","E01031569","20-24 years","Male",22,27,30,30,24,133
"Crawley 010E","E01031569","25-29 years","Male",39,36,34,39,35,183
"Crawley 010E","E01031569","30-34 years","Male",65,57,58,62,58,300
"Crawley 010E","E01031569","35-39 years","Male",79,78,73,65,61,356
"Crawley 010E","E01031569","40-44 years","Male",51,50,55,54,55,265
"Crawley 010E","E01031569","45-49 years","Male",61,54,52,54,46,267
"Crawley 010E","E01031569","50-54 years","Male",41,49,46,52,55,243
"Crawley 010E","E01031569","55-59 years","Male",39,37,43,37,37,193
"Crawley 010E","E01031569","60-64 years","Male",40,34,27,30,26,157
"Crawley 010E","E01031569","65-69 years","Male",43,39,36,35,34,187
"Crawley 010E","E01031569","70-74 years","Male",31,34,42,44,49,200
"Crawley 010E","E01031569","75-79 years","Male",15,16,20,15,14,80
"Crawley 010E","E01031569","80-84 years","Male",11,13,18,18,18,78
"Crawley 010E","E01031569","85+ years","Male",5,6,10,10,12,43
"Crawley 010E","E01031569","0-4 years","Female",50,43,54,53,56,256
"Crawley 010E","E01031569","5-9 years","Female",56,64,59,57,54,290
"Crawley 010E","E01031569","10-14 years","Female",53,56,61,67,62,299
"Crawley 010E","E01031569","15-19 years","Female",38,39,40,43,52,212
"Crawley 010E","E01031569","20-24 years","Female",32,30,31,32,26,151
"Crawley 010E","E01031569","25-29 years","Female",50,46,46,40,39,221
"Crawley 010E","E01031569","30-34 years","Female",80,76,69,67,65,357
"Crawley 010E","E01031569","35-39 years","Female",50,51,74,70,74,319
"Crawley 010E","E01031569","40-44 years","Female",47,48,38,42,42,217
"Crawley 010E","E01031569","45-49 years","Female",50,41,47,54,41,233
"Crawley 010E","E01031569","50-54 years","Female",53,54,48,50,55,260
"Crawley 010E","E01031569","55-59 years","Female",52,54,47,37,42,232
"Crawley 010E","E01031569","60-64 years","Female",40,33,40,38,41,192
"Crawley 010E","E01031569","65-69 years","Female",62,62,56,46,45,271
"Crawley 010E","E01031569","70-74 years","Female",35,43,50,55,57,240
"Crawley 010E","E01031569","75-79 years","Female",22,20,18,18,18,96
"Crawley 010E","E01031569","80-84 years","Female",12,11,12,12,14,61
"Crawley 010E","E01031569","85+ years","Female",7,7,8,6,7,35
"Crawley 011A","E01031595","0-4 years","Male",68,60,60,61,59,308
"Crawley 011A","E01031595","5-9 years","Male",62,60,64,55,53,294
"Crawley 011A","E01031595","10-14 years","Male",59,69,73,62,71,334
"Crawley 011A","E01031595","15-19 years","Male",52,55,46,56,59,268
"Crawley 011A","E01031595","20-24 years","Male",37,37,41,38,47,200
"Crawley 011A","E01031595","25-29 years","Male",76,65,62,53,45,301
"Crawley 011A","E01031595","30-34 years","Male",54,50,49,55,48,256
"Crawley 011A","E01031595","35-39 years","Male",57,54,61,59,55,286
"Crawley 011A","E01031595","40-44 years","Male",56,57,52,50,51,266
"Crawley 011A","E01031595","45-49 years","Male",53,58,66,67,57,301
"Crawley 011A","E01031595","50-54 years","Male",43,43,46,47,50,229
"Crawley 011A","E01031595","55-59 years","Male",57,57,51,47,42,254
"Crawley 011A","E01031595","60-64 years","Male",25,27,37,39,42,170
"Crawley 011A","E01031595","65-69 years","Male",24,23,17,20,21,105
"Crawley 011A","E01031595","70-74 years","Male",18,17,18,20,17,90
"Crawley 011A","E01031595","75-79 years","Male",22,20,24,17,17,100
"Crawley 011A","E01031595","80-84 years","Male",23,23,26,24,23,119
"Crawley 011A","E01031595","85+ years","Male",9,10,9,9,9,46
"Crawley 011A","E01031595","0-4 years","Female",58,39,46,49,48,240
"Crawley 011A","E01031595","5-9 years","Female",50,54,52,61,60,277
"Crawley 011A","E01031595","10-14 years","Female",50,45,53,42,47,237
"Crawley 011A","E01031595","15-19 years","Female",44,50,44,50,54,242
"Crawley 011A","E01031595","20-24 years","Female",54,44,46,37,34,215
"Crawley 011A","E01031595","25-29 years","Female",60,51,47,46,41,245
"Crawley 011A","E01031595","30-34 years","Female",77,75,70,70,69,361
"Crawley 011A","E01031595","35-39 years","Female",65,60,55,56,54,290
"Crawley 011A","E01031595","40-44 years","Female",68,65,70,71,74,348
"Crawley 011A","E01031595","45-49 years","Female",56,65,58,51,58,288
"Crawley 011A","E01031595","50-54 years","Female",55,54,53,61,58,281
"Crawley 011A","E01031595","55-59 years","Female",50,55,57,52,49,263
"Crawley 011A","E01031595","60-64 years","Female",36,35,40,47,50,208
"Crawley 011A","E01031595","65-69 years","Female",42,39,33,35,34,183
"Crawley 011A","E01031595","70-74 years","Female",30,42,46,42,43,203
"Crawley 011A","E01031595","75-79 years","Female",27,24,25,25,30,131
"Crawley 011A","E01031595","80-84 years","Female",30,33,24,25,21,133
"Crawley 011A","E01031595","85+ years","Female",32,27,32,33,35,159
"Crawley 011B","E01031604","0-4 years","Male",43,33,41,49,51,217
"Crawley 011B","E01031604","5-9 years","Male",53,45,49,45,44,236
"Crawley 011B","E01031604","10-14 years","Male",50,52,51,53,56,262
"Crawley 011B","E01031604","15-19 years","Male",64,57,60,52,56,289
"Crawley 011B","E01031604","20-24 years","Male",33,37,32,35,32,169
"Crawley 011B","E01031604","25-29 years","Male",50,45,47,46,50,238
"Crawley 011B","E01031604","30-34 years","Male",56,46,45,43,40,230
"Crawley 011B","E01031604","35-39 years","Male",60,55,54,51,64,284
"Crawley 011B","E01031604","40-44 years","Male",60,63,64,65,53,305
"Crawley 011B","E01031604","45-49 years","Male",46,48,48,44,43,229
"Crawley 011B","E01031604","50-54 years","Male",49,47,45,45,40,226
"Crawley 011B","E01031604","55-59 years","Male",37,40,46,51,61,235
"Crawley 011B","E01031604","60-64 years","Male",40,37,41,36,36,190
"Crawley 011B","E01031604","65-69 years","Male",30,35,36,35,32,168
"Crawley 011B","E01031604","70-74 years","Male",32,37,28,31,32,160
"Crawley 011B","E01031604","75-79 years","Male",26,29,38,36,35,164
"Crawley 011B","E01031604","80-84 years","Male",15,13,12,17,20,77
"Crawley 011B","E01031604","85+ years","Male",14,11,14,11,10,60
"Crawley 011B","E01031604","0-4 years","Female",46,48,49,47,43,233
"Crawley 011B","E01031604","5-9 years","Female",30,37,43,38,48,196
"Crawley 011B","E01031604","10-14 years","Female",50,58,60,60,47,275
"Crawley 011B","E01031604","15-19 years","Female",44,38,41,45,53,221
"Crawley 011B","E01031604","20-24 years","Female",33,31,32,27,28,151
"Crawley 011B","E01031604","25-29 years","Female",40,42,43,40,39,204
"Crawley 011B","E01031604","30-34 years","Female",45,47,53,57,60,262
"Crawley 011B","E01031604","35-39 years","Female",69,66,59,48,56,298
"Crawley 011B","E01031604","40-44 years","Female",53,58,51,52,43,257
"Crawley 011B","E01031604","45-49 years","Female",72,66,62,65,55,320
"Crawley 011B","E01031604","50-54 years","Female",65,63,72,70,71,341
"Crawley 011B","E01031604","55-59 years","Female",49,52,56,52,58,267
"Crawley 011B","E01031604","60-64 years","Female",48,48,47,52,45,240
"Crawley 011B","E01031604","65-69 years","Female",38,39,38,35,35,185
"Crawley 011B","E01031604","70-74 years","Female",27,29,33,28,30,147
"Crawley 011B","E01031604","75-79 years","Female",31,26,26,30,29,142
"Crawley 011B","E01031604","80-84 years","Female",36,33,30,26,30,155
"Crawley 011B","E01031604","85+ years","Female",39,33,30,37,41,180
"Crawley 011C","E01031605","0-4 years","Male",47,49,43,48,41,228
"Crawley 011C","E01031605","5-9 years","Male",60,68,72,76,78,354
"Crawley 011C","E01031605","10-14 years","Male",50,48,55,52,55,260
"Crawley 011C","E01031605","15-19 years","Male",41,41,45,48,51,226
"Crawley 011C","E01031605","20-24 years","Male",37,33,31,37,34,172
"Crawley 011C","E01031605","25-29 years","Male",65,57,60,54,51,287
"Crawley 011C","E01031605","30-34 years","Male",46,42,45,48,47,228
"Crawley 011C","E01031605","35-39 years","Male",64,68,57,54,58,301
"Crawley 011C","E01031605","40-44 years","Male",63,55,60,61,53,292
"Crawley 011C","E01031605","45-49 years","Male",48,50,61,58,61,278
"Crawley 011C","E01031605","50-54 years","Male",40,37,31,32,34,174
"Crawley 011C","E01031605","55-59 years","Male",39,46,38,42,44,209
"Crawley 011C","E01031605","60-64 years","Male",51,48,57,56,55,267
"Crawley 011C","E01031605","65-69 years","Male",21,22,22,23,31,119
"Crawley 011C","E01031605","70-74 years","Male",24,21,20,18,15,98
"Crawley 011C","E01031605","75-79 years","Male",21,17,16,14,17,85
"Crawley 011C","E01031605","80-84 years","Male",18,19,18,20,24,99
"Crawley 011C","E01031605","85+ years","Male",16,19,22,24,19,100
"Crawley 011C","E01031605","0-4 years","Female",56,59,56,69,60,300
"Crawley 011C","E01031605","5-9 years","Female",91,86,78,70,67,392
"Crawley 011C","E01031605","10-14 years","Female",52,59,58,69,79,317
"Crawley 011C","E01031605","15-19 years","Female",51,42,51,52,57,253
"Crawley 011C","E01031605","20-24 years","Female",36,34,36,31,29,166
"Crawley 011C","E01031605","25-29 years","Female",57,69,65,67,59,317
"Crawley 011C","E01031605","30-34 years","Female",62,47,48,55,54,266
"Crawley 011C","E01031605","35-39 years","Female",70,73,71,66,62,342
"Crawley 011C","E01031605","40-44 years","Female",61,49,52,59,65,286
"Crawley 011C","E01031605","45-49 years","Female",50,58,56,58,54,276
"Crawley 011C","E01031605","50-54 years","Female",45,44,45,44,37,215
"Crawley 011C","E01031605","55-59 years","Female",50,47,48,46,54,245
"Crawley 011C","E01031605","60-64 years","Female",17,19,24,28,31,119
"Crawley 011C","E01031605","65-69 years","Female",32,28,23,18,15,116
"Crawley 011C","E01031605","70-74 years","Female",21,21,17,13,17,89
"Crawley 011C","E01031605","75-79 years","Female",22,19,19,23,21,104
"Crawley 011C","E01031605","80-84 years","Female",48,40,33,23,19,163
"Crawley 011C","E01031605","85+ years","Female",29,43,40,44,43,199
"Crawley 011D","E01031606","0-4 years","Male",49,46,43,42,36,216
"Crawley 011D","E01031606","5-9 years","Male",84,68,62,64,69,347
"Crawley 011D","E01031606","10-14 years","Male",56,61,68,74,71,330
"Crawley 011D","E01031606","15-19 years","Male",53,54,45,48,43,243
"Crawley 011D","E01031606","20-24 years","Male",31,30,29,26,29,145
"Crawley 011D","E01031606","25-29 years","Male",29,30,30,27,34,150
"Crawley 011D","E01031606","30-34 years","Male",41,37,39,38,33,188
"Crawley 011D","E01031606","35-39 years","Male",54,57,48,47,46,252
"Crawley 011D","E01031606","40-44 years","Male",47,47,40,46,47,227
"Crawley 011D","E01031606","45-49 years","Male",63,65,62,64,59,313
"Crawley 011D","E01031606","50-54 years","Male",50,48,51,53,58,260
"Crawley 011D","E01031606","55-59 years","Male",34,42,44,45,47,212
"Crawley 011D","E01031606","60-64 years","Male",43,45,41,41,37,207
"Crawley 011D","E01031606","65-69 years","Male",38,31,36,38,41,184
"Crawley 011D","E01031606","70-74 years","Male",19,26,26,25,23,119
"Crawley 011D","E01031606","75-79 years","Male",24,18,19,16,18,95
"Crawley 011D","E01031606","80-84 years","Male",20,18,16,17,20,91
"Crawley 011D","E01031606","85+ years","Male",18,17,18,16,16,85
"Crawley 011D","E01031606","0-4 years","Female",54,57,47,43,51,252
"Crawley 011D","E01031606","5-9 years","Female",46,52,46,52,49,245
"Crawley 011D","E01031606","10-14 years","Female",60,64,60,64,53,301
"Crawley 011D","E01031606","15-19 years","Female",37,35,40,47,54,213
"Crawley 011D","E01031606","20-24 years","Female",30,21,17,15,15,98
"Crawley 011D","E01031606","25-29 years","Female",31,33,35,31,33,163
"Crawley 011D","E01031606","30-34 years","Female",57,61,54,51,54,277
"Crawley 011D","E01031606","35-39 years","Female",46,50,58,54,49,257
"Crawley 011D","E01031606","40-44 years","Female",50,45,33,46,53,227
"Crawley 011D","E01031606","45-49 years","Female",54,43,46,47,51,241
"Crawley 011D","E01031606","50-54 years","Female",70,80,73,63,53,339
"Crawley 011D","E01031606","55-59 years","Female",48,47,49,54,55,253
"Crawley 011D","E01031606","60-64 years","Female",43,46,48,46,53,236
"Crawley 011D","E01031606","65-69 years","Female",34,39,30,28,29,160
"Crawley 011D","E01031606","70-74 years","Female",36,29,31,32,31,159
"Crawley 011D","E01031606","75-79 years","Female",23,27,27,21,24,122
"Crawley 011D","E01031606","80-84 years","Female",40,35,37,36,28,176
"Crawley 011D","E01031606","85+ years","Female",25,25,28,29,28,135
"Crawley 011E","E01031607","0-4 years","Male",49,50,41,35,38,213
"Crawley 011E","E01031607","5-9 years","Male",56,57,51,54,51,269
"Crawley 011E","E01031607","10-14 years","Male",63,71,82,81,81,378
"Crawley 011E","E01031607","15-19 years","Male",35,36,35,31,38,175
"Crawley 011E","E01031607","20-24 years","Male",47,46,45,48,45,231
"Crawley 011E","E01031607","25-29 years","Male",29,29,27,29,31,145
"Crawley 011E","E01031607","30-34 years","Male",53,47,40,38,35,213
"Crawley 011E","E01031607","35-39 years","Male",61,52,57,51,53,274
"Crawley 011E","E01031607","40-44 years","Male",39,42,40,40,41,202
"Crawley 011E","E01031607","45-49 years","Male",41,42,43,43,44,213
"Crawley 011E","E01031607","50-54 years","Male",58,55,56,53,55,277
"Crawley 011E","E01031607","55-59 years","Male",55,59,58,68,72,312
"Crawley 011E","E01031607","60-64 years","Male",34,45,47,42,41,209
"Crawley 011E","E01031607","65-69 years","Male",37,35,40,38,33,183
"Crawley 011E","E01031607","70-74 years","Male",21,25,21,21,29,117
"Crawley 011E","E01031607","75-79 years","Male",24,25,26,23,22,120
"Crawley 011E","E01031607","80-84 years","Male",21,19,17,17,14,88
"Crawley 011E","E01031607","85+ years","Male",7,8,10,15,21,61
"Crawley 011E","E01031607","0-4 years","Female",42,39,40,42,45,208
"Crawley 011E","E01031607","5-9 years","Female",51,60,57,48,46,262
"Crawley 011E","E01031607","10-14 years","Female",48,50,50,56,52,256
"Crawley 011E","E01031607","15-19 years","Female",42,40,44,43,49,218
"Crawley 011E","E01031607","20-24 years","Female",32,37,33,27,32,161
"Crawley 011E","E01031607","25-29 years","Female",34,30,31,35,30,160
"Crawley 011E","E01031607","30-34 years","Female",47,47,46,38,39,217
"Crawley 011E","E01031607","35-39 years","Female",56,65,67,74,62,324
"Crawley 011E","E01031607","40-44 years","Female",56,54,52,42,51,255
"Crawley 011E","E01031607","45-49 years","Female",41,44,47,51,46,229
"Crawley 011E","E01031607","50-54 years","Female",40,36,35,34,42,187
"Crawley 011E","E01031607","55-59 years","Female",48,46,45,49,46,234
"Crawley 011E","E01031607","60-64 years","Female",36,34,42,46,51,209
"Crawley 011E","E01031607","65-69 years","Female",34,34,34,34,31,167
"Crawley 011E","E01031607","70-74 years","Female",27,24,20,23,26,120
"Crawley 011E","E01031607","75-79 years","Female",24,27,29,24,29,133
"Crawley 011E","E01031607","80-84 years","Female",24,24,22,20,11,101
"Crawley 011E","E01031607","85+ years","Female",25,24,27,23,23,122
"Crawley 012A","E01031546","0-4 years","Male",75,81,71,50,50,327
"Crawley 012A","E01031546","5-9 years","Male",61,66,64,71,57,319
"Crawley 012A","E01031546","10-14 years","Male",49,54,49,51,65,268
"Crawley 012A","E01031546","15-19 years","Male",54,49,53,53,54,263
"Crawley 012A","E01031546","20-24 years","Male",71,80,79,78,59,367
"Crawley 012A","E01031546","25-29 years","Male",44,46,48,41,36,215
"Crawley 012A","E01031546","30-34 years","Male",76,59,66,62,56,319
"Crawley 012A","E01031546","35-39 years","Male",55,53,50,49,50,257
"Crawley 012A","E01031546","40-44 years","Male",63,68,66,59,58,314
"Crawley 012A","E01031546","45-49 years","Male",48,51,45,47,51,242
"Crawley 012A","E01031546","50-54 years","Male",67,57,68,58,58,308
"Crawley 012A","E01031546","55-59 years","Male",43,50,44,44,36,217
"Crawley 012A","E01031546","60-64 years","Male",37,38,40,40,39,194
"Crawley 012A","E01031546","65-69 years","Male",37,34,42,43,33,189
"Crawley 012A","E01031546","70-74 years","Male",9,10,10,11,16,56
"Crawley 012A","E01031546","75-79 years","Male",1,0,1,1,2,5
"Crawley 012A","E01031546","80-84 years","Male",4,6,5,6,3,24
"Crawley 012A","E01031546","85+ years","Male",2,1,2,1,1,7
"Crawley 012A","E01031546","0-4 years","Female",53,54,53,52,55,267
"Crawley 012A","E01031546","5-9 years","Female",74,70,62,64,46,316
"Crawley 012A","E01031546","10-14 years","Female",53,55,52,50,55,265
"Crawley 012A","E01031546","15-19 years","Female",53,52,46,42,44,237
"Crawley 012A","E01031546","20-24 years","Female",38,33,37,36,26,170
"Crawley 012A","E01031546","25-29 years","Female",73,63,61,47,49,293
"Crawley 012A","E01031546","30-34 years","Female",65,60,63,63,59,310
"Crawley 012A","E01031546","35-39 years","Female",63,62,55,61,71,312
"Crawley 012A","E01031546","40-44 years","Female",67,63,54,50,47,281
"Crawley 012A","E01031546","45-49 years","Female",46,47,50,45,46,234
"Crawley 012A","E01031546","50-54 years","Female",45,42,40,42,39,208
"Crawley 012A","E01031546","55-59 years","Female",55,52,45,38,37,227
"Crawley 012A","E01031546","60-64 years","Female",47,42,45,50,55,239
"Crawley 012A","E01031546","65-69 years","Female",15,23,26,29,29,122
"Crawley 012A","E01031546","70-74 years","Female",3,5,5,8,11,32
"Crawley 012A","E01031546","75-79 years","Female",3,3,5,3,2,16
"Crawley 012A","E01031546","80-84 years","Female",5,5,3,2,1,16
"Crawley 012A","E01031546","85+ years","Female",0,2,7,6,3,18
"Crawley 012B","E01031551","0-4 years","Male",82,80,73,62,55,352
"Crawley 012B","E01031551","5-9 years","Male",66,64,60,67,64,321
"Crawley 012B","E01031551","10-14 years","Male",51,52,50,50,50,253
"Crawley 012B","E01031551","15-19 years","Male",70,74,73,66,62,345
"Crawley 012B","E01031551","20-24 years","Male",52,42,42,46,46,228
"Crawley 012B","E01031551","25-29 years","Male",61,65,62,55,45,288
"Crawley 012B","E01031551","30-34 years","Male",76,70,64,65,65,340
"Crawley 012B","E01031551","35-39 years","Male",82,91,91,82,70,416
"Crawley 012B","E01031551","40-44 years","Male",59,65,65,66,73,328
"Crawley 012B","E01031551","45-49 years","Male",47,47,48,54,48,244
"Crawley 012B","E01031551","50-54 years","Male",53,54,54,58,70,289
"Crawley 012B","E01031551","55-59 years","Male",38,37,39,38,37,189
"Crawley 012B","E01031551","60-64 years","Male",32,26,26,23,25,132
"Crawley 012B","E01031551","65-69 years","Male",43,41,42,45,40,211
"Crawley 012B","E01031551","70-74 years","Male",6,9,15,19,23,72
"Crawley 012B","E01031551","75-79 years","Male",8,3,2,1,0,14
"Crawley 012B","E01031551","80-84 years","Male",2,3,3,1,1,10
"Crawley 012B","E01031551","85+ years","Male",4,3,2,2,4,15
"Crawley 012B","E01031551","0-4 years","Female",65,77,70,64,65,341
"Crawley 012B","E01031551","5-9 years","Female",81,76,74,67,55,353
"Crawley 012B","E01031551","10-14 years","Female",48,54,56,60,64,282
"Crawley 012B","E01031551","15-19 years","Female",48,41,43,39,48,219
"Crawley 012B","E01031551","20-24 years","Female",56,51,47,39,40,233
"Crawley 012B","E01031551","25-29 years","Female",63,60,52,55,49,279
"Crawley 012B","E01031551","30-34 years","Female",68,68,72,66,54,328
"Crawley 012B","E01031551","35-39 years","Female",81,77,69,73,81,381
"Crawley 012B","E01031551","40-44 years","Female",53,60,56,59,59,287
"Crawley 012B","E01031551","45-49 years","Female",72,74,72,54,49,321
"Crawley 012B","E01031551","50-54 years","Female",52,49,60,69,67,297
"Crawley 012B","E01031551","55-59 years","Female",38,38,39,34,36,185
"Crawley 012B","E01031551","60-64 years","Female",42,47,45,50,47,231
"Crawley 012B","E01031551","65-69 years","Female",15,14,15,24,28,96
"Crawley 012B","E01031551","70-74 years","Female",6,8,9,6,7,36
"Crawley 012B","E01031551","75-79 years","Female",11,9,7,4,4,35
"Crawley 012B","E01031551","80-84 years","Female",1,0,1,0,0,2
"Crawley 012B","E01031551","85+ years","Female",0,1,4,4,6,15
"Crawley 012C","E01031553","0-4 years","Male",58,59,48,39,44,248
"Crawley 012C","E01031553","5-9 years","Male",67,57,66,66,60,316
"Crawley 012C","E01031553","10-14 years","Male",75,68,65,66,65,339
"Crawley 012C","E01031553","15-19 years","Male",70,70,57,66,61,324
"Crawley 012C","E01031553","20-24 years","Male",57,55,52,54,45,263
"Crawley 012C","E01031553","25-29 years","Male",67,69,75,69,64,344
"Crawley 012C","E01031553","30-34 years","Male",54,53,55,58,63,283
"Crawley 012C","E01031553","35-39 years","Male",58,60,56,58,52,284
"Crawley 012C","E01031553","40-44 years","Male",65,71,64,58,60,318
"Crawley 012C","E01031553","45-49 years","Male",57,55,59,52,51,274
"Crawley 012C","E01031553","50-54 years","Male",49,56,54,59,55,273
"Crawley 012C","E01031553","55-59 years","Male",48,39,44,40,53,224
"Crawley 012C","E01031553","60-64 years","Male",19,30,30,35,36,150
"Crawley 012C","E01031553","65-69 years","Male",21,20,17,17,21,96
"Crawley 012C","E01031553","70-74 years","Male",11,16,21,24,22,94
"Crawley 012C","E01031553","75-79 years","Male",5,10,12,13,13,53
"Crawley 012C","E01031553","80-84 years","Male",3,3,1,2,2,11
"Crawley 012C","E01031553","85+ years","Male",2,1,1,1,1,6
"Crawley 012C","E01031553","0-4 years","Female",53,50,42,56,51,252
"Crawley 012C","E01031553","5-9 years","Female",81,65,63,55,50,314
"Crawley 012C","E01031553","10-14 years","Female",53,61,52,57,63,286
"Crawley 012C","E01031553","15-19 years","Female",62,60,67,62,51,302
"Crawley 012C","E01031553","20-24 years","Female",81,67,55,54,55,312
"Crawley 012C","E01031553","25-29 years","Female",62,70,68,64,65,329
"Crawley 012C","E01031553","30-34 years","Female",56,44,43,43,42,228
"Crawley 012C","E01031553","35-39 years","Female",61,64,58,52,55,290
"Crawley 012C","E01031553","40-44 years","Female",66,63,62,56,51,298
"Crawley 012C","E01031553","45-49 years","Female",73,67,62,66,61,329
"Crawley 012C","E01031553","50-54 years","Female",41,43,42,39,38,203
"Crawley 012C","E01031553","55-59 years","Female",34,35,37,43,50,199
"Crawley 012C","E01031553","60-64 years","Female",29,28,26,24,26,133
"Crawley 012C","E01031553","65-69 years","Female",22,19,26,33,34,134
"Crawley 012C","E01031553","70-74 years","Female",13,20,20,21,25,99
"Crawley 012C","E01031553","75-79 years","Female",2,1,0,2,3,8
"Crawley 012C","E01031553","80-84 years","Female",1,1,1,1,3,7
"Crawley 012C","E01031553","85+ years","Female",1,1,2,3,0,7
"Crawley 012D","E01031554","0-4 years","Male",71,67,80,84,75,377
"Crawley 012D","E01031554","5-9 years","Male",88,78,81,73,75,395
"Crawley 012D","E01031554","10-14 years","Male",51,57,55,58,61,282
"Crawley 012D","E01031554","15-19 years","Male",46,47,49,52,50,244
"Crawley 012D","E01031554","20-24 years","Male",62,66,72,70,69,339
"Crawley 012D","E01031554","25-29 years","Male",86,82,80,79,78,405
"Crawley 012D","E01031554","30-34 years","Male",86,95,99,101,93,474
"Crawley 012D","E01031554","35-39 years","Male",92,90,81,87,86,436
"Crawley 012D","E01031554","40-44 years","Male",79,73,76,74,74,376
"Crawley 012D","E01031554","45-49 years","Male",60,72,68,71,74,345
"Crawley 012D","E01031554","50-54 years","Male",59,55,66,68,67,315
"Crawley 012D","E01031554","55-59 years","Male",35,42,43,46,61,227
"Crawley 012D","E01031554","60-64 years","Male",39,34,33,30,29,165
"Crawley 012D","E01031554","65-69 years","Male",41,47,39,38,36,201
"Crawley 012D","E01031554","70-74 years","Male",17,15,19,22,24,97
"Crawley 012D","E01031554","75-79 years","Male",7,9,8,7,11,42
"Crawley 012D","E01031554","80-84 years","Male",3,3,10,12,14,42
"Crawley 012D","E01031554","85+ years","Male",3,2,1,1,1,8
"Crawley 012D","E01031554","0-4 years","Female",77,79,70,71,73,370
"Crawley 012D","E01031554","5-9 years","Female",71,61,57,59,61,309
"Crawley 012D","E01031554","10-14 years","Female",40,55,54,57,58,264
"Crawley 012D","E01031554","15-19 years","Female",35,31,36,39,39,180
"Crawley 012D","E01031554","20-24 years","Female",63,63,60,64,60,310
"Crawley 012D","E01031554","25-29 years","Female",82,84,80,89,92,427
"Crawley 012D","E01031554","30-34 years","Female",104,89,91,85,82,451
"Crawley 012D","E01031554","35-39 years","Female",100,105,107,98,94,504
"Crawley 012D","E01031554","40-44 years","Female",64,55,59,73,71,322
"Crawley 012D","E01031554","45-49 years","Female",85,79,73,67,73,377
"Crawley 012D","E01031554","50-54 years","Female",50,52,58,54,57,271
"Crawley 012D","E01031554","55-59 years","Female",41,40,37,38,41,197
"Crawley 012D","E01031554","60-64 years","Female",46,40,37,39,41,203
"Crawley 012D","E01031554","65-69 years","Female",42,42,44,41,40,209
"Crawley 012D","E01031554","70-74 years","Female",19,22,30,39,43,153
"Crawley 012D","E01031554","75-79 years","Female",11,12,11,11,15,60
"Crawley 012D","E01031554","80-84 years","Female",4,4,5,4,2,19
"Crawley 012D","E01031554","85+ years","Female",5,2,4,3,4,18
"Crawley 012E","E01031555","0-4 years","Male",64,55,57,59,67,302
"Crawley 012E","E01031555","5-9 years","Male",77,79,78,76,72,382
"Crawley 012E","E01031555","10-14 years","Male",87,79,67,76,74,383
"Crawley 012E","E01031555","15-19 years","Male",56,65,66,64,65,316
"Crawley 012E","E01031555","20-24 years","Male",76,68,64,59,60,327
"Crawley 012E","E01031555","25-29 years","Male",47,51,48,54,54,254
"Crawley 012E","E01031555","30-34 years","Male",54,58,54,57,48,271
"Crawley 012E","E01031555","35-39 years","Male",63,64,65,56,55,303
"Crawley 012E","E01031555","40-44 years","Male",55,47,57,48,47,254
"Crawley 012E","E01031555","45-49 years","Male",68,73,66,76,66,349
"Crawley 012E","E01031555","50-54 years","Male",42,40,45,46,54,227
"Crawley 012E","E01031555","55-59 years","Male",38,52,50,52,49,241
"Crawley 012E","E01031555","60-64 years","Male",32,32,37,44,50,195
"Crawley 012E","E01031555","65-69 years","Male",27,19,21,22,21,110
"Crawley 012E","E01031555","70-74 years","Male",21,22,19,21,16,99
"Crawley 012E","E01031555","75-79 years","Male",10,10,9,10,13,52
"Crawley 012E","E01031555","80-84 years","Male",4,5,5,5,2,21
"Crawley 012E","E01031555","85+ years","Male",4,4,3,4,2,17
"Crawley 012E","E01031555","0-4 years","Female",74,66,51,45,53,289
"Crawley 012E","E01031555","5-9 years","Female",79,84,84,79,68,394
"Crawley 012E","E01031555","10-14 years","Female",51,57,66,72,78,324
"Crawley 012E","E01031555","15-19 years","Female",79,66,63,57,57,322
"Crawley 012E","E01031555","20-24 years","Female",47,45,42,39,40,213
"Crawley 012E","E01031555","25-29 years","Female",72,67,66,72,72,349
"Crawley 012E","E01031555","30-34 years","Female",66,61,66,62,57,312
"Crawley 012E","E01031555","35-39 years","Female",61,66,58,50,55,290
"Crawley 012E","E01031555","40-44 years","Female",61,63,56,59,58,297
"Crawley 012E","E01031555","45-49 years","Female",57,61,64,64,65,311
"Crawley 012E","E01031555","50-54 years","Female",41,55,59,59,62,276
"Crawley 012E","E01031555","55-59 years","Female",46,39,36,34,43,198
"Crawley 012E","E01031555","60-64 years","Female",30,23,28,34,32,147
"Crawley 012E","E01031555","65-69 years","Female",27,30,30,28,21,136
"Crawley 012E","E01031555","70-74 years","Female",30,29,26,28,31,144
"Crawley 012E","E01031555","75-79 years","Female",11,13,14,15,17,70
"Crawley 012E","E01031555","80-84 years","Female",10,4,8,7,8,37
"Crawley 012E","E01031555","85+ years","Female",1,1,2,2,5,11
"Crawley 013A","E01031552","0-4 years","Male",82,78,80,93,67,400
"Crawley 013A","E01031552","5-9 years","Male",85,82,76,70,77,390
"Crawley 013A","E01031552","10-14 years","Male",59,62,67,69,61,318
"Crawley 013A","E01031552","15-19 years","Male",46,43,45,49,42,225
"Crawley 013A","E01031552","20-24 years","Male",50,53,55,47,48,253
"Crawley 013A","E01031552","25-29 years","Male",76,75,67,67,55,340
"Crawley 013A","E01031552","30-34 years","Male",110,93,89,90,82,464
"Crawley 013A","E01031552","35-39 years","Male",86,89,90,93,89,447
"Crawley 013A","E01031552","40-44 years","Male",61,61,66,64,60,312
"Crawley 013A","E01031552","45-49 years","Male",74,73,69,64,66,346
"Crawley 013A","E01031552","50-54 years","Male",52,51,53,57,54,267
"Crawley 013A","E01031552","55-59 years","Male",52,54,54,54,60,274
"Crawley 013A","E01031552","60-64 years","Male",38,40,30,34,35,177
"Crawley 013A","E01031552","65-69 years","Male",55,52,56,51,43,257
"Crawley 013A","E01031552","70-74 years","Male",33,41,41,48,47,210
"Crawley 013A","E01031552","75-79 years","Male",17,15,14,21,23,90
"Crawley 013A","E01031552","80-84 years","Male",13,12,9,8,9,51
"Crawley 013A","E01031552","85+ years","Male",12,11,12,15,17,67
"Crawley 013A","E01031552","0-4 years","Female",77,77,62,67,70,353
"Crawley 013A","E01031552","5-9 years","Female",90,89,90,93,77,439
"Crawley 013A","E01031552","10-14 years","Female",53,61,64,63,75,316
"Crawley 013A","E01031552","15-19 years","Female",37,36,35,39,39,186
"Crawley 013A","E01031552","20-24 years","Female",60,55,53,54,49,271
"Crawley 013A","E01031552","25-29 years","Female",105,103,90,84,77,459
"Crawley 013A","E01031552","30-34 years","Female",118,108,108,101,90,525
"Crawley 013A","E01031552","35-39 years","Female",72,83,90,94,93,432
"Crawley 013A","E01031552","40-44 years","Female",77,82,81,72,70,382
"Crawley 013A","E01031552","45-49 years","Female",54,54,51,58,65,282
"Crawley 013A","E01031552","50-54 years","Female",48,50,46,48,42,234
"Crawley 013A","E01031552","55-59 years","Female",61,59,65,62,61,308
"Crawley 013A","E01031552","60-64 years","Female",60,64,60,52,51,287
"Crawley 013A","E01031552","65-69 years","Female",76,79,82,76,67,380
"Crawley 013A","E01031552","70-74 years","Female",33,36,39,45,49,202
"Crawley 013A","E01031552","75-79 years","Female",13,16,21,24,27,101
"Crawley 013A","E01031552","80-84 years","Female",16,16,14,13,12,71
"Crawley 013A","E01031552","85+ years","Female",17,10,10,7,6,50
"Crawley 013B","E01031556","0-4 years","Male",73,66,69,67,56,331
"Crawley 013B","E01031556","5-9 years","Male",64,66,63,53,52,298
"Crawley 013B","E01031556","10-14 years","Male",47,48,42,58,66,261
"Crawley 013B","E01031556","15-19 years","Male",85,79,75,55,50,344
"Crawley 013B","E01031556","20-24 years","Male",53,59,62,70,61,305
"Crawley 013B","E01031556","25-29 years","Male",56,50,40,48,55,249
"Crawley 013B","E01031556","30-34 years","Male",75,64,64,59,57,319
"Crawley 013B","E01031556","35-39 years","Male",72,82,83,80,70,387
"Crawley 013B","E01031556","40-44 years","Male",54,51,44,44,58,251
"Crawley 013B","E01031556","45-49 years","Male",81,72,67,64,57,341
"Crawley 013B","E01031556","50-54 years","Male",53,53,50,52,56,264
"Crawley 013B","E01031556","55-59 years","Male",46,53,52,46,46,243
"Crawley 013B","E01031556","60-64 years","Male",49,38,46,50,43,226
"Crawley 013B","E01031556","65-69 years","Male",8,13,13,13,20,67
"Crawley 013B","E01031556","70-74 years","Male",11,13,16,13,11,64
"Crawley 013B","E01031556","75-79 years","Male",8,7,9,15,21,60
"Crawley 013B","E01031556","80-84 years","Male",1,2,2,2,2,9
"Crawley 013B","E01031556","85+ years","Male",2,3,2,2,1,10
"Crawley 013B","E01031556","0-4 years","Female",57,62,62,51,47,279
"Crawley 013B","E01031556","5-9 years","Female",52,43,47,57,57,256
"Crawley 013B","E01031556","10-14 years","Female",68,72,68,50,51,309
"Crawley 013B","E01031556","15-19 years","Female",65,61,64,61,52,303
"Crawley 013B","E01031556","20-24 years","Female",60,54,51,50,50,265
"Crawley 013B","E01031556","25-29 years","Female",64,62,61,57,56,300
"Crawley 013B","E01031556","30-34 years","Female",79,72,80,74,64,369
"Crawley 013B","E01031556","35-39 years","Female",77,81,75,65,65,363
"Crawley 013B","E01031556","40-44 years","Female",75,73,71,83,78,380
"Crawley 013B","E01031556","45-49 years","Female",66,68,67,65,71,337
"Crawley 013B","E01031556","50-54 years","Female",66,66,58,56,47,293
"Crawley 013B","E01031556","55-59 years","Female",57,60,61,64,65,307
"Crawley 013B","E01031556","60-64 years","Female",35,41,48,51,53,228
"Crawley 013B","E01031556","65-69 years","Female",25,27,24,30,31,137
"Crawley 013B","E01031556","70-74 years","Female",21,19,20,26,29,115
"Crawley 013B","E01031556","75-79 years","Female",3,4,6,8,8,29
"Crawley 013B","E01031556","80-84 years","Female",7,5,5,7,9,33
"Crawley 013B","E01031556","85+ years","Female",6,5,4,5,8,28
"Crawley 013C","E01031557","0-4 years","Male",80,71,68,74,73,366
"Crawley 013C","E01031557","5-9 years","Male",52,54,54,44,46,250
"Crawley 013C","E01031557","10-14 years","Male",43,37,42,42,38,202
"Crawley 013C","E01031557","15-19 years","Male",23,34,25,27,27,136
"Crawley 013C","E01031557","20-24 years","Male",28,28,33,28,28,145
"Crawley 013C","E01031557","25-29 years","Male",92,95,86,84,67,424
"Crawley 013C","E01031557","30-34 years","Male",112,115,105,108,109,549
"Crawley 013C","E01031557","35-39 years","Male",113,122,119,116,112,582
"Crawley 013C","E01031557","40-44 years","Male",86,101,94,102,96,479
"Crawley 013C","E01031557","45-49 years","Male",94,92,104,97,95,482
"Crawley 013C","E01031557","50-54 years","Male",74,87,84,80,79,404
"Crawley 013C","E01031557","55-59 years","Male",60,66,72,81,83,362
"Crawley 013C","E01031557","60-64 years","Male",42,51,54,50,59,256
"Crawley 013C","E01031557","65-69 years","Male",36,38,43,43,46,206
"Crawley 013C","E01031557","70-74 years","Male",18,21,20,24,24,107
"Crawley 013C","E01031557","75-79 years","Male",9,11,9,9,16,54
"Crawley 013C","E01031557","80-84 years","Male",9,11,13,14,14,61
"Crawley 013C","E01031557","85+ years","Male",3,4,3,6,6,22
"Crawley 013C","E01031557","0-4 years","Female",76,78,85,77,65,381
"Crawley 013C","E01031557","5-9 years","Female",66,61,62,53,60,302
"Crawley 013C","E01031557","10-14 years","Female",41,39,48,52,51,231
"Crawley 013C","E01031557","15-19 years","Female",17,18,17,16,18,86
"Crawley 013C","E01031557","20-24 years","Female",52,53,59,55,53,272
"Crawley 013C","E01031557","25-29 years","Female",121,114,117,111,102,565
"Crawley 013C","E01031557","30-34 years","Female",115,112,101,114,114,556
"Crawley 013C","E01031557","35-39 years","Female",93,97,91,92,95,468
"Crawley 013C","E01031557","40-44 years","Female",75,78,80,76,62,371
"Crawley 013C","E01031557","45-49 years","Female",62,65,55,59,73,314
"Crawley 013C","E01031557","50-54 years","Female",73,71,69,60,62,335
"Crawley 013C","E01031557","55-59 years","Female",54,70,76,75,74,349
"Crawley 013C","E01031557","60-64 years","Female",32,33,35,41,40,181
"Crawley 013C","E01031557","65-69 years","Female",36,34,31,34,35,170
"Crawley 013C","E01031557","70-74 years","Female",16,22,28,30,35,131
"Crawley 013C","E01031557","75-79 years","Female",9,10,10,10,12,51
"Crawley 013C","E01031557","80-84 years","Female",3,3,3,4,4,17
"Crawley 013C","E01031557","85+ years","Female",9,5,6,8,7,35
"Crawley 013D","E01031558","0-4 years","Male",80,85,79,67,61,372
"Crawley 013D","E01031558","5-9 years","Male",77,78,83,79,78,395
"Crawley 013D","E01031558","10-14 years","Male",49,50,54,63,56,272
"Crawley 013D","E01031558","15-19 years","Male",56,51,52,50,50,259
"Crawley 013D","E01031558","20-24 years","Male",48,46,49,47,39,229
"Crawley 013D","E01031558","25-29 years","Male",40,46,41,39,40,206
"Crawley 013D","E01031558","30-34 years","Male",65,60,61,55,51,292
"Crawley 013D","E01031558","35-39 years","Male",52,56,60,67,59,294
"Crawley 013D","E01031558","40-44 years","Male",58,52,45,54,62,271
"Crawley 013D","E01031558","45-49 years","Male",55,53,49,44,39,240
"Crawley 013D","E01031558","50-54 years","Male",48,49,51,55,52,255
"Crawley 013D","E01031558","55-59 years","Male",47,43,45,37,39,211
"Crawley 013D","E01031558","60-64 years","Male",31,35,34,41,48,189
"Crawley 013D","E01031558","65-69 years","Male",55,47,48,49,41,240
"Crawley 013D","E01031558","70-74 years","Male",28,29,34,33,42,166
"Crawley 013D","E01031558","75-79 years","Male",17,21,20,24,24,106
"Crawley 013D","E01031558","80-84 years","Male",3,3,4,7,11,28
"Crawley 013D","E01031558","85+ years","Male",1,4,6,4,4,19
"Crawley 013D","E01031558","0-4 years","Female",42,32,33,38,32,177
"Crawley 013D","E01031558","5-9 years","Female",69,75,64,59,58,325
"Crawley 013D","E01031558","10-14 years","Female",63,66,80,79,76,364
"Crawley 013D","E01031558","15-19 years","Female",63,59,57,67,66,312
"Crawley 013D","E01031558","20-24 years","Female",68,50,50,37,42,247
"Crawley 013D","E01031558","25-29 years","Female",64,66,61,63,59,313
"Crawley 013D","E01031558","30-34 years","Female",59,59,66,60,57,301
"Crawley 013D","E01031558","35-39 years","Female",62,59,60,60,61,302
"Crawley 013D","E01031558","40-44 years","Female",50,52,55,57,60,274
"Crawley 013D","E01031558","45-49 years","Female",56,52,45,38,38,229
"Crawley 013D","E01031558","50-54 years","Female",50,54,55,61,54,274
"Crawley 013D","E01031558","55-59 years","Female",61,58,63,62,67,311
"Crawley 013D","E01031558","60-64 years","Female",50,55,54,52,51,262
"Crawley 013D","E01031558","65-69 years","Female",59,50,56,54,49,268
"Crawley 013D","E01031558","70-74 years","Female",30,38,45,44,48,205
"Crawley 013D","E01031558","75-79 years","Female",21,23,23,27,27,121
"Crawley 013D","E01031558","80-84 years","Female",13,13,18,14,13,71
"Crawley 013D","E01031558","85+ years","Female",10,9,8,10,11,48
"Crawley 013E","E01031559","0-4 years","Male",63,66,57,63,55,304
"Crawley 013E","E01031559","5-9 years","Male",81,91,83,75,78,408
"Crawley 013E","E01031559","10-14 years","Male",65,69,63,65,70,332
"Crawley 013E","E01031559","15-19 years","Male",59,58,63,58,56,294
"Crawley 013E","E01031559","20-24 years","Male",50,52,48,55,54,259
"Crawley 013E","E01031559","25-29 years","Male",40,43,41,40,32,196
"Crawley 013E","E01031559","30-34 years","Male",67,58,54,59,58,296
"Crawley 013E","E01031559","35-39 years","Male",89,93,89,72,66,409
"Crawley 013E","E01031559","40-44 years","Male",44,48,50,51,49,242
"Crawley 013E","E01031559","45-49 years","Male",69,66,65,64,59,323
"Crawley 013E","E01031559","50-54 years","Male",35,35,41,40,45,196
"Crawley 013E","E01031559","55-59 years","Male",45,47,45,46,51,234
"Crawley 013E","E01031559","60-64 years","Male",28,29,30,36,31,154
"Crawley 013E","E01031559","65-69 years","Male",26,29,31,34,35,155
"Crawley 013E","E01031559","70-74 years","Male",20,15,21,16,19,91
"Crawley 013E","E01031559","75-79 years","Male",6,11,10,15,16,58
"Crawley 013E","E01031559","80-84 years","Male",5,4,2,6,9,26
"Crawley 013E","E01031559","85+ years","Male",3,6,7,6,6,28
"Crawley 013E","E01031559","0-4 years","Female",81,73,68,54,48,324
"Crawley 013E","E01031559","5-9 years","Female",68,74,68,71,64,345
"Crawley 013E","E01031559","10-14 years","Female",65,75,84,82,82,388
"Crawley 013E","E01031559","15-19 years","Female",45,37,29,35,39,185
"Crawley 013E","E01031559","20-24 years","Female",50,50,52,49,54,255
"Crawley 013E","E01031559","25-29 years","Female",65,71,65,62,54,317
"Crawley 013E","E01031559","30-34 years","Female",87,73,62,68,61,351
"Crawley 013E","E01031559","35-39 years","Female",55,70,77,62,67,331
"Crawley 013E","E01031559","40-44 years","Female",58,51,43,45,46,243
"Crawley 013E","E01031559","45-49 years","Female",62,64,69,71,76,342
"Crawley 013E","E01031559","50-54 years","Female",38,44,51,45,54,232
"Crawley 013E","E01031559","55-59 years","Female",36,34,30,31,32,163
"Crawley 013E","E01031559","60-64 years","Female",37,34,38,37,37,183
"Crawley 013E","E01031559","65-69 years","Female",40,43,35,30,38,186
"Crawley 013E","E01031559","70-74 years","Female",11,13,15,16,17,72
"Crawley 013E","E01031559","75-79 years","Female",10,9,9,11,9,48
"Crawley 013E","E01031559","80-84 years","Female",7,11,9,12,19,58
"Crawley 013E","E01031559","85+ years","Female",7,3,8,8,6,32
"Horsham 001A","E01031670","0-4 years","Male",43,35,40,34,40,192
"Horsham 001A","E01031670","5-9 years","Male",36,47,43,37,37,200
"Horsham 001A","E01031670","10-14 years","Male",25,30,28,36,28,147
"Horsham 001A","E01031670","15-19 years","Male",60,52,49,45,39,245
"Horsham 001A","E01031670","20-24 years","Male",58,53,70,77,76,334
"Horsham 001A","E01031670","25-29 years","Male",52,48,54,52,46,252
"Horsham 001A","E01031670","30-34 years","Male",76,72,59,60,72,339
"Horsham 001A","E01031670","35-39 years","Male",51,55,69,71,63,309
"Horsham 001A","E01031670","40-44 years","Male",63,65,60,60,59,307
"Horsham 001A","E01031670","45-49 years","Male",56,59,53,53,65,286
"Horsham 001A","E01031670","50-54 years","Male",58,65,63,61,47,294
"Horsham 001A","E01031670","55-59 years","Male",59,60,67,55,62,303
"Horsham 001A","E01031670","60-64 years","Male",36,35,35,42,47,195
"Horsham 001A","E01031670","65-69 years","Male",41,34,29,30,30,164
"Horsham 001A","E01031670","70-74 years","Male",32,34,41,44,42,193
"Horsham 001A","E01031670","75-79 years","Male",30,25,27,25,23,130
"Horsham 001A","E01031670","80-84 years","Male",13,18,20,25,25,101
"Horsham 001A","E01031670","85+ years","Male",16,14,8,6,6,50
"Horsham 001A","E01031670","0-4 years","Female",56,52,50,39,41,238
"Horsham 001A","E01031670","5-9 years","Female",41,39,34,47,42,203
"Horsham 001A","E01031670","10-14 years","Female",19,26,26,27,27,125
"Horsham 001A","E01031670","15-19 years","Female",28,24,26,19,19,116
"Horsham 001A","E01031670","20-24 years","Female",47,39,43,47,47,223
"Horsham 001A","E01031670","25-29 years","Female",73,72,69,70,66,350
"Horsham 001A","E01031670","30-34 years","Female",52,61,60,56,60,289
"Horsham 001A","E01031670","35-39 years","Female",62,51,59,64,61,297
"Horsham 001A","E01031670","40-44 years","Female",60,67,65,71,72,335
"Horsham 001A","E01031670","45-49 years","Female",58,53,45,48,47,251
"Horsham 001A","E01031670","50-54 years","Female",64,71,70,65,51,321
"Horsham 001A","E01031670","55-59 years","Female",51,55,53,57,70,286
"Horsham 001A","E01031670","60-64 years","Female",35,34,45,52,49,215
"Horsham 001A","E01031670","65-69 years","Female",43,44,39,36,32,194
"Horsham 001A","E01031670","70-74 years","Female",27,31,36,37,34,165
"Horsham 001A","E01031670","75-79 years","Female",22,25,29,30,40,146
"Horsham 001A","E01031670","80-84 years","Female",31,34,35,37,30,167
"Horsham 001A","E01031670","85+ years","Female",25,24,24,22,26,121
"Horsham 001B","E01031671","0-4 years","Male",48,43,34,34,39,198
"Horsham 001B","E01031671","5-9 years","Male",42,51,42,43,41,219
"Horsham 001B","E01031671","10-14 years","Male",42,40,36,35,36,189
"Horsham 001B","E01031671","15-19 years","Male",40,39,42,40,43,204
"Horsham 001B","E01031671","20-24 years","Male",35,36,34,29,28,162
"Horsham 001B","E01031671","25-29 years","Male",40,52,52,54,54,252
"Horsham 001B","E01031671","30-34 years","Male",41,34,42,38,39,194
"Horsham 001B","E01031671","35-39 years","Male",57,51,49,42,48,247
"Horsham 001B","E01031671","40-44 years","Male",61,59,60,60,67,307
"Horsham 001B","E01031671","45-49 years","Male",69,65,58,55,47,294
"Horsham 001B","E01031671","50-54 years","Male",78,88,88,81,78,413
"Horsham 001B","E01031671","55-59 years","Male",86,88,82,86,98,440
"Horsham 001B","E01031671","60-64 years","Male",57,64,72,73,69,335
"Horsham 001B","E01031671","65-69 years","Male",51,43,46,40,39,219
"Horsham 001B","E01031671","70-74 years","Male",39,44,38,44,43,208
"Horsham 001B","E01031671","75-79 years","Male",24,23,30,25,28,130
"Horsham 001B","E01031671","80-84 years","Male",13,15,10,14,14,66
"Horsham 001B","E01031671","85+ years","Male",23,23,18,20,19,103
"Horsham 001B","E01031671","0-4 years","Female",34,37,39,33,33,176
"Horsham 001B","E01031671","5-9 years","Female",44,46,43,40,40,213
"Horsham 001B","E01031671","10-14 years","Female",50,52,50,55,52,259
"Horsham 001B","E01031671","15-19 years","Female",35,33,35,35,35,173
"Horsham 001B","E01031671","20-24 years","Female",34,37,42,40,43,196
"Horsham 001B","E01031671","25-29 years","Female",52,38,44,48,50,232
"Horsham 001B","E01031671","30-34 years","Female",31,44,37,50,53,215
"Horsham 001B","E01031671","35-39 years","Female",41,39,40,39,43,202
"Horsham 001B","E01031671","40-44 years","Female",61,67,60,51,47,286
"Horsham 001B","E01031671","45-49 years","Female",70,61,53,58,63,305
"Horsham 001B","E01031671","50-54 years","Female",71,72,80,76,68,367
"Horsham 001B","E01031671","55-59 years","Female",74,81,74,73,67,369
"Horsham 001B","E01031671","60-64 years","Female",45,48,53,56,60,262
"Horsham 001B","E01031671","65-69 years","Female",60,54,52,50,46,262
"Horsham 001B","E01031671","70-74 years","Female",33,44,44,49,50,220
"Horsham 001B","E01031671","75-79 years","Female",23,19,17,16,19,94
"Horsham 001B","E01031671","80-84 years","Female",19,21,17,20,22,99
"Horsham 001B","E01031671","85+ years","Female",11,11,15,15,19,71
"Horsham 001C","E01031673","0-4 years","Male",67,62,71,71,68,339
"Horsham 001C","E01031673","5-9 years","Male",49,53,58,62,55,277
"Horsham 001C","E01031673","10-14 years","Male",41,40,35,30,38,184
"Horsham 001C","E01031673","15-19 years","Male",50,49,54,53,46,252
"Horsham 001C","E01031673","20-24 years","Male",30,33,34,36,42,175
"Horsham 001C","E01031673","25-29 years","Male",52,49,54,52,51,258
"Horsham 001C","E01031673","30-34 years","Male",59,50,58,70,72,309
"Horsham 001C","E01031673","35-39 years","Male",48,63,57,55,53,276
"Horsham 001C","E01031673","40-44 years","Male",58,51,50,57,53,269
"Horsham 001C","E01031673","45-49 years","Male",51,52,54,60,65,282
"Horsham 001C","E01031673","50-54 years","Male",76,71,66,55,51,319
"Horsham 001C","E01031673","55-59 years","Male",49,53,57,63,58,280
"Horsham 001C","E01031673","60-64 years","Male",47,45,47,50,63,252
"Horsham 001C","E01031673","65-69 years","Male",28,28,30,30,29,145
"Horsham 001C","E01031673","70-74 years","Male",29,28,32,35,34,158
"Horsham 001C","E01031673","75-79 years","Male",19,21,16,19,21,96
"Horsham 001C","E01031673","80-84 years","Male",15,13,12,8,8,56
"Horsham 001C","E01031673","85+ years","Male",5,13,8,11,11,48
"Horsham 001C","E01031673","0-4 years","Female",53,45,46,40,39,223
"Horsham 001C","E01031673","5-9 years","Female",44,51,55,59,54,263
"Horsham 001C","E01031673","10-14 years","Female",38,37,36,39,39,189
"Horsham 001C","E01031673","15-19 years","Female",42,47,46,53,49,237
"Horsham 001C","E01031673","20-24 years","Female",46,43,46,43,39,217
"Horsham 001C","E01031673","25-29 years","Female",64,63,56,52,65,300
"Horsham 001C","E01031673","30-34 years","Female",57,50,55,55,50,267
"Horsham 001C","E01031673","35-39 years","Female",68,82,73,69,61,353
"Horsham 001C","E01031673","40-44 years","Female",53,57,64,68,62,304
"Horsham 001C","E01031673","45-49 years","Female",63,61,70,66,73,333
"Horsham 001C","E01031673","50-54 years","Female",49,50,43,47,49,238
"Horsham 001C","E01031673","55-59 years","Female",53,55,62,62,56,288
"Horsham 001C","E01031673","60-64 years","Female",37,39,34,39,39,188
"Horsham 001C","E01031673","65-69 years","Female",54,46,51,40,45,236
"Horsham 001C","E01031673","70-74 years","Female",27,31,32,39,39,168
"Horsham 001C","E01031673","75-79 years","Female",32,29,30,27,24,142
"Horsham 001C","E01031673","80-84 years","Female",13,11,15,22,21,82
"Horsham 001C","E01031673","85+ years","Female",13,15,8,12,16,64
"Horsham 001D","E01031676","0-4 years","Male",86,103,130,156,176,651
"Horsham 001D","E01031676","5-9 years","Male",90,89,103,119,149,550
"Horsham 001D","E01031676","10-14 years","Male",130,134,131,155,174,724
"Horsham 001D","E01031676","15-19 years","Male",97,97,105,110,107,516
"Horsham 001D","E01031676","20-24 years","Male",72,71,79,91,103,416
"Horsham 001D","E01031676","25-29 years","Male",77,82,113,129,160,561
"Horsham 001D","E01031676","30-34 years","Male",84,90,110,139,161,584
"Horsham 001D","E01031676","35-39 years","Male",105,119,123,141,157,645
"Horsham 001D","E01031676","40-44 years","Male",93,92,113,139,171,608
"Horsham 001D","E01031676","45-49 years","Male",127,122,121,130,140,640
"Horsham 001D","E01031676","50-54 years","Male",151,170,160,163,163,807
"Horsham 001D","E01031676","55-59 years","Male",85,89,111,125,140,550
"Horsham 001D","E01031676","60-64 years","Male",97,94,99,109,116,515
"Horsham 001D","E01031676","65-69 years","Male",119,120,114,113,103,569
"Horsham 001D","E01031676","70-74 years","Male",86,90,108,116,109,509
"Horsham 001D","E01031676","75-79 years","Male",57,69,65,66,75,332
"Horsham 001D","E01031676","80-84 years","Male",32,37,52,52,47,220
"Horsham 001D","E01031676","85+ years","Male",8,12,11,16,27,74
"Horsham 001D","E01031676","0-4 years","Female",82,103,116,143,190,634
"Horsham 001D","E01031676","5-9 years","Female",76,87,110,130,143,546
"Horsham 001D","E01031676","10-14 years","Female",131,132,128,134,150,675
"Horsham 001D","E01031676","15-19 years","Female",86,79,84,93,107,449
"Horsham 001D","E01031676","20-24 years","Female",62,90,104,110,127,493
"Horsham 001D","E01031676","25-29 years","Female",103,106,129,171,175,684
"Horsham 001D","E01031676","30-34 years","Female",94,100,123,183,225,725
"Horsham 001D","E01031676","35-39 years","Female",84,99,119,133,157,592
"Horsham 001D","E01031676","40-44 years","Female",95,105,119,153,173,645
"Horsham 001D","E01031676","45-49 years","Female",140,128,137,138,137,680
"Horsham 001D","E01031676","50-54 years","Female",118,142,151,160,181,752
"Horsham 001D","E01031676","55-59 years","Female",112,114,129,129,133,617
"Horsham 001D","E01031676","60-64 years","Female",88,96,98,108,108,498
"Horsham 001D","E01031676","65-69 years","Female",106,99,94,93,98,490
"Horsham 001D","E01031676","70-74 years","Female",109,135,131,121,125,621
"Horsham 001D","E01031676","75-79 years","Female",48,56,70,78,81,333
"Horsham 001D","E01031676","80-84 years","Female",33,43,40,55,65,236
"Horsham 001D","E01031676","85+ years","Female",9,10,14,15,21,69
"Horsham 002A","E01031644","0-4 years","Male",42,56,77,74,87,336
"Horsham 002A","E01031644","5-9 years","Male",43,44,43,48,49,227
"Horsham 002A","E01031644","10-14 years","Male",55,52,49,43,47,246
"Horsham 002A","E01031644","15-19 years","Male",46,44,50,46,47,233
"Horsham 002A","E01031644","20-24 years","Male",27,29,31,33,35,155
"Horsham 002A","E01031644","25-29 years","Male",23,23,25,24,27,122
"Horsham 002A","E01031644","30-34 years","Male",38,41,44,44,44,211
"Horsham 002A","E01031644","35-39 years","Male",44,48,62,68,71,293
"Horsham 002A","E01031644","40-44 years","Male",70,67,62,57,62,318
"Horsham 002A","E01031644","45-49 years","Male",55,65,68,73,79,340
"Horsham 002A","E01031644","50-54 years","Male",41,42,53,57,60,253
"Horsham 002A","E01031644","55-59 years","Male",66,60,51,57,54,288
"Horsham 002A","E01031644","60-64 years","Male",53,57,59,53,58,280
"Horsham 002A","E01031644","65-69 years","Male",65,50,52,50,50,267
"Horsham 002A","E01031644","70-74 years","Male",22,42,40,50,51,205
"Horsham 002A","E01031644","75-79 years","Male",21,16,17,17,21,92
"Horsham 002A","E01031644","80-84 years","Male",6,8,8,7,9,38
"Horsham 002A","E01031644","85+ years","Male",3,4,4,7,5,23
"Horsham 002A","E01031644","0-4 years","Female",39,42,58,60,63,262
"Horsham 002A","E01031644","5-9 years","Female",51,54,54,59,69,287
"Horsham 002A","E01031644","10-14 years","Female",45,57,64,57,61,284
"Horsham 002A","E01031644","15-19 years","Female",40,42,45,44,42,213
"Horsham 002A","E01031644","20-24 years","Female",21,23,29,27,30,130
"Horsham 002A","E01031644","25-29 years","Female",31,36,45,46,46,204
"Horsham 002A","E01031644","30-34 years","Female",30,38,42,38,46,194
"Horsham 002A","E01031644","35-39 years","Female",49,61,68,78,92,348
"Horsham 002A","E01031644","40-44 years","Female",47,57,53,64,78,299
"Horsham 002A","E01031644","45-49 years","Female",62,65,66,65,54,312
"Horsham 002A","E01031644","50-54 years","Female",58,57,67,61,75,318
"Horsham 002A","E01031644","55-59 years","Female",58,59,59,51,55,282
"Horsham 002A","E01031644","60-64 years","Female",54,50,49,58,57,268
"Horsham 002A","E01031644","65-69 years","Female",51,54,57,60,63,285
"Horsham 002A","E01031644","70-74 years","Female",29,41,40,43,47,200
"Horsham 002A","E01031644","75-79 years","Female",9,10,13,12,14,58
"Horsham 002A","E01031644","80-84 years","Female",10,11,12,16,18,67
"Horsham 002A","E01031644","85+ years","Female",14,17,13,14,16,74
"Horsham 002B","E01031645","0-4 years","Male",42,43,35,32,28,180
"Horsham 002B","E01031645","5-9 years","Male",50,63,64,60,61,298
"Horsham 002B","E01031645","10-14 years","Male",42,32,30,33,36,173
"Horsham 002B","E01031645","15-19 years","Male",47,44,40,38,33,202
"Horsham 002B","E01031645","20-24 years","Male",28,26,30,26,28,138
"Horsham 002B","E01031645","25-29 years","Male",39,36,49,48,38,210
"Horsham 002B","E01031645","30-34 years","Male",32,26,28,30,23,139
"Horsham 002B","E01031645","35-39 years","Male",41,45,40,33,37,196
"Horsham 002B","E01031645","40-44 years","Male",56,51,53,56,56,272
"Horsham 002B","E01031645","45-49 years","Male",76,79,68,71,66,360
"Horsham 002B","E01031645","50-54 years","Male",66,61,63,65,65,320
"Horsham 002B","E01031645","55-59 years","Male",46,48,51,54,52,251
"Horsham 002B","E01031645","60-64 years","Male",37,38,37,30,33,175
"Horsham 002B","E01031645","65-69 years","Male",33,35,35,44,42,189
"Horsham 002B","E01031645","70-74 years","Male",14,19,23,24,25,105
"Horsham 002B","E01031645","75-79 years","Male",7,10,8,8,10,43
"Horsham 002B","E01031645","80-84 years","Male",11,10,11,9,4,45
"Horsham 002B","E01031645","85+ years","Male",11,8,14,17,22,72
"Horsham 002B","E01031645","0-4 years","Female",51,46,45,42,42,226
"Horsham 002B","E01031645","5-9 years","Female",51,51,51,51,49,253
"Horsham 002B","E01031645","10-14 years","Female",48,47,50,47,44,236
"Horsham 002B","E01031645","15-19 years","Female",41,45,41,53,55,235
"Horsham 002B","E01031645","20-24 years","Female",42,44,41,36,38,201
"Horsham 002B","E01031645","25-29 years","Female",46,38,33,38,44,199
"Horsham 002B","E01031645","30-34 years","Female",41,37,34,26,26,164
"Horsham 002B","E01031645","35-39 years","Female",66,70,68,73,60,337
"Horsham 002B","E01031645","40-44 years","Female",54,60,53,57,63,287
"Horsham 002B","E01031645","45-49 years","Female",67,58,63,62,60,310
"Horsham 002B","E01031645","50-54 years","Female",76,69,64,54,53,316
"Horsham 002B","E01031645","55-59 years","Female",63,66,68,65,71,333
"Horsham 002B","E01031645","60-64 years","Female",39,50,55,54,54,252
"Horsham 002B","E01031645","65-69 years","Female",30,22,19,27,30,128
"Horsham 002B","E01031645","70-74 years","Female",13,17,22,22,23,97
"Horsham 002B","E01031645","75-79 years","Female",19,21,20,17,14,91
"Horsham 002B","E01031645","80-84 years","Female",15,17,17,17,19,85
"Horsham 002B","E01031645","85+ years","Female",8,6,8,13,12,47
"Horsham 002C","E01031646","0-4 years","Male",40,34,38,33,33,178
"Horsham 002C","E01031646","5-9 years","Male",41,39,37,37,33,187
"Horsham 002C","E01031646","10-14 years","Male",55,42,42,34,39,212
"Horsham 002C","E01031646","15-19 years","Male",58,58,60,66,58,300
"Horsham 002C","E01031646","20-24 years","Male",46,53,50,48,52,249
"Horsham 002C","E01031646","25-29 years","Male",29,33,39,36,42,179
"Horsham 002C","E01031646","30-34 years","Male",32,31,34,38,37,172
"Horsham 002C","E01031646","35-39 years","Male",26,26,29,30,32,143
"Horsham 002C","E01031646","40-44 years","Male",47,43,37,36,32,195
"Horsham 002C","E01031646","45-49 years","Male",79,70,67,60,54,330
"Horsham 002C","E01031646","50-54 years","Male",80,85,83,85,81,414
"Horsham 002C","E01031646","55-59 years","Male",75,80,83,87,89,414
"Horsham 002C","E01031646","60-64 years","Male",46,50,50,52,56,254
"Horsham 002C","E01031646","65-69 years","Male",34,34,39,39,38,184
"Horsham 002C","E01031646","70-74 years","Male",26,28,24,25,26,129
"Horsham 002C","E01031646","75-79 years","Male",13,17,24,20,21,95
"Horsham 002C","E01031646","80-84 years","Male",7,5,7,8,9,36
"Horsham 002C","E01031646","85+ years","Male",3,2,3,2,4,14
"Horsham 002C","E01031646","0-4 years","Female",34,29,33,32,26,154
"Horsham 002C","E01031646","5-9 years","Female",40,30,39,36,34,179
"Horsham 002C","E01031646","10-14 years","Female",62,62,50,53,56,283
"Horsham 002C","E01031646","15-19 years","Female",61,59,54,64,59,297
"Horsham 002C","E01031646","20-24 years","Female",42,41,43,37,39,202
"Horsham 002C","E01031646","25-29 years","Female",47,48,50,49,51,245
"Horsham 002C","E01031646","30-34 years","Female",27,27,31,31,31,147
"Horsham 002C","E01031646","35-39 years","Female",62,56,48,36,34,236
"Horsham 002C","E01031646","40-44 years","Female",57,45,50,49,50,251
"Horsham 002C","E01031646","45-49 years","Female",84,88,78,64,63,377
"Horsham 002C","E01031646","50-54 years","Female",85,83,91,88,92,439
"Horsham 002C","E01031646","55-59 years","Female",64,63,69,72,75,343
"Horsham 002C","E01031646","60-64 years","Female",46,48,46,53,50,243
"Horsham 002C","E01031646","65-69 years","Female",42,43,41,46,48,220
"Horsham 002C","E01031646","70-74 years","Female",21,25,27,30,33,136
"Horsham 002C","E01031646","75-79 years","Female",21,21,22,19,16,99
"Horsham 002C","E01031646","80-84 years","Female",11,14,15,19,18,77
"Horsham 002C","E01031646","85+ years","Female",17,18,21,14,15,85
"Horsham 002D","E01031647","0-4 years","Male",25,25,25,29,25,129
"Horsham 002D","E01031647","5-9 years","Male",28,30,29,24,26,137
"Horsham 002D","E01031647","10-14 years","Male",31,30,30,30,33,154
"Horsham 002D","E01031647","15-19 years","Male",34,37,29,37,32,169
"Horsham 002D","E01031647","20-24 years","Male",43,32,34,38,41,188
"Horsham 002D","E01031647","25-29 years","Male",23,20,25,22,19,109
"Horsham 002D","E01031647","30-34 years","Male",34,34,33,31,32,164
"Horsham 002D","E01031647","35-39 years","Male",43,45,43,46,42,219
"Horsham 002D","E01031647","40-44 years","Male",36,34,33,36,37,176
"Horsham 002D","E01031647","45-49 years","Male",36,36,33,30,32,167
"Horsham 002D","E01031647","50-54 years","Male",44,44,44,36,38,206
"Horsham 002D","E01031647","55-59 years","Male",45,47,53,58,58,261
"Horsham 002D","E01031647","60-64 years","Male",27,31,33,29,32,152
"Horsham 002D","E01031647","65-69 years","Male",34,28,22,28,31,143
"Horsham 002D","E01031647","70-74 years","Male",16,21,26,26,27,116
"Horsham 002D","E01031647","75-79 years","Male",17,18,18,20,18,91
"Horsham 002D","E01031647","80-84 years","Male",9,7,7,9,15,47
"Horsham 002D","E01031647","85+ years","Male",2,15,20,27,20,84
"Horsham 002D","E01031647","0-4 years","Female",55,42,45,41,47,230
"Horsham 002D","E01031647","5-9 years","Female",38,37,30,29,36,170
"Horsham 002D","E01031647","10-14 years","Female",33,37,34,32,30,166
"Horsham 002D","E01031647","15-19 years","Female",37,42,41,33,26,179
"Horsham 002D","E01031647","20-24 years","Female",25,22,22,22,25,116
"Horsham 002D","E01031647","25-29 years","Female",35,33,38,42,40,188
"Horsham 002D","E01031647","30-34 years","Female",43,36,33,32,38,182
"Horsham 002D","E01031647","35-39 years","Female",48,50,41,37,33,209
"Horsham 002D","E01031647","40-44 years","Female",35,39,41,35,33,183
"Horsham 002D","E01031647","45-49 years","Female",52,43,37,44,40,216
"Horsham 002D","E01031647","50-54 years","Female",62,62,56,51,51,282
"Horsham 002D","E01031647","55-59 years","Female",41,43,52,57,48,241
"Horsham 002D","E01031647","60-64 years","Female",30,28,32,30,37,157
"Horsham 002D","E01031647","65-69 years","Female",38,41,39,41,36,195
"Horsham 002D","E01031647","70-74 years","Female",25,28,31,32,31,147
"Horsham 002D","E01031647","75-79 years","Female",11,13,17,21,26,88
"Horsham 002D","E01031647","80-84 years","Female",10,22,22,26,16,96
"Horsham 002D","E01031647","85+ years","Female",7,21,36,42,46,152
"Horsham 002E","E01031649","0-4 years","Male",28,32,25,19,13,117
"Horsham 002E","E01031649","5-9 years","Male",42,34,33,39,39,187
"Horsham 002E","E01031649","10-14 years","Male",29,38,31,32,32,162
"Horsham 002E","E01031649","15-19 years","Male",39,35,34,31,29,168
"Horsham 002E","E01031649","20-24 years","Male",21,25,24,26,24,120
"Horsham 002E","E01031649","25-29 years","Male",30,27,23,21,18,119
"Horsham 002E","E01031649","30-34 years","Male",31,30,34,34,35,164
"Horsham 002E","E01031649","35-39 years","Male",54,58,49,42,33,236
"Horsham 002E","E01031649","40-44 years","Male",35,39,41,47,53,215
"Horsham 002E","E01031649","45-49 years","Male",45,43,34,31,32,185
"Horsham 002E","E01031649","50-54 years","Male",46,44,52,45,47,234
"Horsham 002E","E01031649","55-59 years","Male",44,45,46,42,40,217
"Horsham 002E","E01031649","60-64 years","Male",31,31,35,42,47,186
"Horsham 002E","E01031649","65-69 years","Male",34,34,29,22,19,138
"Horsham 002E","E01031649","70-74 years","Male",30,34,42,50,48,204
"Horsham 002E","E01031649","75-79 years","Male",10,12,10,16,20,68
"Horsham 002E","E01031649","80-84 years","Male",6,5,4,4,6,25
"Horsham 002E","E01031649","85+ years","Male",7,9,7,10,9,42
"Horsham 002E","E01031649","0-4 years","Female",29,26,22,22,19,118
"Horsham 002E","E01031649","5-9 years","Female",37,39,36,37,33,182
"Horsham 002E","E01031649","10-14 years","Female",30,35,34,26,30,155
"Horsham 002E","E01031649","15-19 years","Female",32,23,23,28,25,131
"Horsham 002E","E01031649","20-24 years","Female",23,24,27,24,20,118
"Horsham 002E","E01031649","25-29 years","Female",17,18,17,20,24,96
"Horsham 002E","E01031649","30-34 years","Female",31,31,22,22,22,128
"Horsham 002E","E01031649","35-39 years","Female",45,39,48,49,50,231
"Horsham 002E","E01031649","40-44 years","Female",42,35,41,40,40,198
"Horsham 002E","E01031649","45-49 years","Female",61,64,53,49,47,274
"Horsham 002E","E01031649","50-54 years","Female",44,46,53,55,57,255
"Horsham 002E","E01031649","55-59 years","Female",39,37,36,35,37,184
"Horsham 002E","E01031649","60-64 years","Female",31,33,36,41,41,182
"Horsham 002E","E01031649","65-69 years","Female",37,31,34,26,22,150
"Horsham 002E","E01031649","70-74 years","Female",19,23,22,28,27,119
"Horsham 002E","E01031649","75-79 years","Female",13,18,18,21,24,94
"Horsham 002E","E01031649","80-84 years","Female",36,32,34,26,25,153
"Horsham 002E","E01031649","85+ years","Female",6,12,11,16,17,62
"Horsham 002F","E01031650","0-4 years","Male",29,23,20,21,19,112
"Horsham 002F","E01031650","5-9 years","Male",43,34,28,24,32,161
"Horsham 002F","E01031650","10-14 years","Male",42,41,49,53,48,233
"Horsham 002F","E01031650","15-19 years","Male",37,37,34,38,32,178
"Horsham 002F","E01031650","20-24 years","Male",29,22,19,18,23,111
"Horsham 002F","E01031650","25-29 years","Male",8,12,16,17,18,71
"Horsham 002F","E01031650","30-34 years","Male",21,17,22,22,23,105
"Horsham 002F","E01031650","35-39 years","Male",34,36,28,29,24,151
"Horsham 002F","E01031650","40-44 years","Male",43,35,41,42,48,209
"Horsham 002F","E01031650","45-49 years","Male",50,54,44,43,42,233
"Horsham 002F","E01031650","50-54 years","Male",62,56,57,54,55,284
"Horsham 002F","E01031650","55-59 years","Male",64,63,59,55,47,288
"Horsham 002F","E01031650","60-64 years","Male",59,62,75,79,86,361
"Horsham 002F","E01031650","65-69 years","Male",29,25,24,27,39,144
"Horsham 002F","E01031650","70-74 years","Male",35,42,44,40,31,192
"Horsham 002F","E01031650","75-79 years","Male",16,15,18,24,27,100
"Horsham 002F","E01031650","80-84 years","Male",6,5,4,5,6,26
"Horsham 002F","E01031650","85+ years","Male",5,3,4,3,4,19
"Horsham 002F","E01031650","0-4 years","Female",22,25,20,30,28,125
"Horsham 002F","E01031650","5-9 years","Female",49,47,43,39,38,216
"Horsham 002F","E01031650","10-14 years","Female",57,50,44,45,45,241
"Horsham 002F","E01031650","15-19 years","Female",55,54,57,56,61,283
"Horsham 002F","E01031650","20-24 years","Female",25,19,26,33,26,129
"Horsham 002F","E01031650","25-29 years","Female",22,21,26,30,31,130
"Horsham 002F","E01031650","30-34 years","Female",23,17,17,29,33,119
"Horsham 002F","E01031650","35-39 years","Female",40,36,37,34,29,176
"Horsham 002F","E01031650","40-44 years","Female",51,44,50,52,50,247
"Horsham 002F","E01031650","45-49 years","Female",56,59,51,49,50,265
"Horsham 002F","E01031650","50-54 years","Female",70,64,64,62,64,324
"Horsham 002F","E01031650","55-59 years","Female",66,68,64,70,66,334
"Horsham 002F","E01031650","60-64 years","Female",45,51,60,55,54,265
"Horsham 002F","E01031650","65-69 years","Female",31,27,27,31,38,154
"Horsham 002F","E01031650","70-74 years","Female",42,48,53,50,44,237
"Horsham 002F","E01031650","75-79 years","Female",12,11,17,16,29,85
"Horsham 002F","E01031650","80-84 years","Female",14,13,9,12,12,60
"Horsham 002F","E01031650","85+ years","Female",12,12,11,11,11,57
"Horsham 002G","E01031666","0-4 years","Male",37,37,30,33,33,170
"Horsham 002G","E01031666","5-9 years","Male",50,54,57,48,46,255
"Horsham 002G","E01031666","10-14 years","Male",38,33,37,40,42,190
"Horsham 002G","E01031666","15-19 years","Male",34,35,34,35,39,177
"Horsham 002G","E01031666","20-24 years","Male",21,21,18,17,15,92
"Horsham 002G","E01031666","25-29 years","Male",30,28,23,20,19,120
"Horsham 002G","E01031666","30-34 years","Male",24,23,32,27,25,131
"Horsham 002G","E01031666","35-39 years","Male",42,43,34,34,35,188
"Horsham 002G","E01031666","40-44 years","Male",53,54,49,54,47,257
"Horsham 002G","E01031666","45-49 years","Male",45,45,44,45,46,225
"Horsham 002G","E01031666","50-54 years","Male",51,55,58,49,46,259
"Horsham 002G","E01031666","55-59 years","Male",58,57,52,57,58,282
"Horsham 002G","E01031666","60-64 years","Male",54,56,58,55,51,274
"Horsham 002G","E01031666","65-69 years","Male",60,48,47,50,57,262
"Horsham 002G","E01031666","70-74 years","Male",57,66,62,67,58,310
"Horsham 002G","E01031666","75-79 years","Male",42,34,37,41,50,204
"Horsham 002G","E01031666","80-84 years","Male",35,39,50,45,33,202
"Horsham 002G","E01031666","85+ years","Male",16,17,12,16,18,79
"Horsham 002G","E01031666","0-4 years","Female",40,39,32,27,26,164
"Horsham 002G","E01031666","5-9 years","Female",60,41,39,43,39,222
"Horsham 002G","E01031666","10-14 years","Female",41,53,57,56,53,260
"Horsham 002G","E01031666","15-19 years","Female",37,36,37,32,36,178
"Horsham 002G","E01031666","20-24 years","Female",34,28,34,34,31,161
"Horsham 002G","E01031666","25-29 years","Female",31,26,26,21,23,127
"Horsham 002G","E01031666","30-34 years","Female",23,22,28,33,33,139
"Horsham 002G","E01031666","35-39 years","Female",61,51,47,43,38,240
"Horsham 002G","E01031666","40-44 years","Female",60,67,64,63,71,325
"Horsham 002G","E01031666","45-49 years","Female",51,53,60,58,52,274
"Horsham 002G","E01031666","50-54 years","Female",65,64,60,59,57,305
"Horsham 002G","E01031666","55-59 years","Female",75,65,73,79,80,372
"Horsham 002G","E01031666","60-64 years","Female",45,49,51,54,62,261
"Horsham 002G","E01031666","65-69 years","Female",70,58,56,45,45,274
"Horsham 002G","E01031666","70-74 years","Female",74,78,73,84,82,391
"Horsham 002G","E01031666","75-79 years","Female",32,40,52,52,56,232
"Horsham 002G","E01031666","80-84 years","Female",29,28,30,28,23,138
"Horsham 002G","E01031666","85+ years","Female",22,28,30,35,33,148
"Horsham 002H","E01031668","0-4 years","Male",48,39,40,47,45,219
"Horsham 002H","E01031668","5-9 years","Male",48,57,60,64,54,283
"Horsham 002H","E01031668","10-14 years","Male",32,31,27,35,33,158
"Horsham 002H","E01031668","15-19 years","Male",46,47,48,46,40,227
"Horsham 002H","E01031668","20-24 years","Male",34,36,31,33,35,169
"Horsham 002H","E01031668","25-29 years","Male",55,53,49,50,48,255
"Horsham 002H","E01031668","30-34 years","Male",14,14,15,17,19,79
"Horsham 002H","E01031668","35-39 years","Male",50,51,51,49,41,242
"Horsham 002H","E01031668","40-44 years","Male",41,38,46,42,39,206
"Horsham 002H","E01031668","45-49 years","Male",43,36,32,36,36,183
"Horsham 002H","E01031668","50-54 years","Male",49,49,48,50,43,239
"Horsham 002H","E01031668","55-59 years","Male",57,57,53,46,52,265
"Horsham 002H","E01031668","60-64 years","Male",45,51,50,55,51,252
"Horsham 002H","E01031668","65-69 years","Male",61,63,66,58,52,300
"Horsham 002H","E01031668","70-74 years","Male",55,52,54,54,54,269
"Horsham 002H","E01031668","75-79 years","Male",34,37,42,37,41,191
"Horsham 002H","E01031668","80-84 years","Male",31,27,13,23,21,115
"Horsham 002H","E01031668","85+ years","Male",27,26,35,26,24,138
"Horsham 002H","E01031668","0-4 years","Female",31,38,40,30,37,176
"Horsham 002H","E01031668","5-9 years","Female",32,29,34,34,30,159
"Horsham 002H","E01031668","10-14 years","Female",36,39,39,34,41,189
"Horsham 002H","E01031668","15-19 years","Female",28,26,21,26,24,125
"Horsham 002H","E01031668","20-24 years","Female",34,31,24,27,23,139
"Horsham 002H","E01031668","25-29 years","Female",20,25,32,31,30,138
"Horsham 002H","E01031668","30-34 years","Female",45,40,38,38,42,203
"Horsham 002H","E01031668","35-39 years","Female",37,44,50,48,39,218
"Horsham 002H","E01031668","40-44 years","Female",50,42,40,42,43,217
"Horsham 002H","E01031668","45-49 years","Female",45,41,44,33,35,198
"Horsham 002H","E01031668","50-54 years","Female",66,73,57,64,61,321
"Horsham 002H","E01031668","55-59 years","Female",52,46,63,61,65,287
"Horsham 002H","E01031668","60-64 years","Female",41,40,42,42,45,210
"Horsham 002H","E01031668","65-69 years","Female",71,61,57,52,49,290
"Horsham 002H","E01031668","70-74 years","Female",47,66,73,75,71,332
"Horsham 002H","E01031668","75-79 years","Female",55,33,41,38,42,209
"Horsham 002H","E01031668","80-84 years","Female",40,48,40,44,43,215
"Horsham 002H","E01031668","85+ years","Female",47,50,56,54,64,271
"Horsham 003A","E01031620","0-4 years","Male",54,49,52,68,58,281
"Horsham 003A","E01031620","5-9 years","Male",56,51,60,75,87,329
"Horsham 003A","E01031620","10-14 years","Male",49,47,52,64,81,293
"Horsham 003A","E01031620","15-19 years","Male",50,51,47,43,42,233
"Horsham 003A","E01031620","20-24 years","Male",47,43,49,45,48,232
"Horsham 003A","E01031620","25-29 years","Male",62,66,59,77,81,345
"Horsham 003A","E01031620","30-34 years","Male",34,33,43,56,54,220
"Horsham 003A","E01031620","35-39 years","Male",48,49,51,64,67,279
"Horsham 003A","E01031620","40-44 years","Male",66,56,52,49,55,278
"Horsham 003A","E01031620","45-49 years","Male",69,72,77,75,80,373
"Horsham 003A","E01031620","50-54 years","Male",60,57,51,60,61,289
"Horsham 003A","E01031620","55-59 years","Male",62,65,66,73,68,334
"Horsham 003A","E01031620","60-64 years","Male",54,50,53,54,60,271
"Horsham 003A","E01031620","65-69 years","Male",33,37,38,37,41,186
"Horsham 003A","E01031620","70-74 years","Male",37,39,37,42,40,195
"Horsham 003A","E01031620","75-79 years","Male",16,20,23,26,30,115
"Horsham 003A","E01031620","80-84 years","Male",13,10,11,11,11,56
"Horsham 003A","E01031620","85+ years","Male",12,12,11,15,23,73
"Horsham 003A","E01031620","0-4 years","Female",45,48,50,55,66,264
"Horsham 003A","E01031620","5-9 years","Female",61,56,66,70,75,328
"Horsham 003A","E01031620","10-14 years","Female",43,48,53,65,78,287
"Horsham 003A","E01031620","15-19 years","Female",34,36,37,39,38,184
"Horsham 003A","E01031620","20-24 years","Female",49,50,52,51,51,253
"Horsham 003A","E01031620","25-29 years","Female",45,45,54,66,61,271
"Horsham 003A","E01031620","30-34 years","Female",54,51,61,69,81,316
"Horsham 003A","E01031620","35-39 years","Female",59,57,54,64,76,310
"Horsham 003A","E01031620","40-44 years","Female",55,51,58,64,66,294
"Horsham 003A","E01031620","45-49 years","Female",76,73,69,79,76,373
"Horsham 003A","E01031620","50-54 years","Female",71,73,71,76,78,369
"Horsham 003A","E01031620","55-59 years","Female",65,68,70,67,80,350
"Horsham 003A","E01031620","60-64 years","Female",45,49,55,64,69,282
"Horsham 003A","E01031620","65-69 years","Female",46,34,33,34,36,183
"Horsham 003A","E01031620","70-74 years","Female",24,26,24,33,36,143
"Horsham 003A","E01031620","75-79 years","Female",22,24,27,31,38,142
"Horsham 003A","E01031620","80-84 years","Female",15,15,14,13,17,74
"Horsham 003A","E01031620","85+ years","Female",22,20,27,26,50,145
"Horsham 003B","E01031648","0-4 years","Male",53,44,45,39,30,211
"Horsham 003B","E01031648","5-9 years","Male",47,52,48,49,47,243
"Horsham 003B","E01031648","10-14 years","Male",46,52,52,57,53,260
"Horsham 003B","E01031648","15-19 years","Male",38,42,42,39,39,200
"Horsham 003B","E01031648","20-24 years","Male",65,51,51,52,39,258
"Horsham 003B","E01031648","25-29 years","Male",45,56,62,52,49,264
"Horsham 003B","E01031648","30-34 years","Male",36,38,35,42,50,201
"Horsham 003B","E01031648","35-39 years","Male",52,53,48,44,35,232
"Horsham 003B","E01031648","40-44 years","Male",54,55,60,59,58,286
"Horsham 003B","E01031648","45-49 years","Male",46,47,50,55,56,254
"Horsham 003B","E01031648","50-54 years","Male",72,66,62,57,53,310
"Horsham 003B","E01031648","55-59 years","Male",59,62,65,76,75,337
"Horsham 003B","E01031648","60-64 years","Male",37,38,39,45,49,208
"Horsham 003B","E01031648","65-69 years","Male",50,45,47,46,44,232
"Horsham 003B","E01031648","70-74 years","Male",35,40,45,48,48,216
"Horsham 003B","E01031648","75-79 years","Male",22,23,24,32,35,136
"Horsham 003B","E01031648","80-84 years","Male",32,30,30,22,28,142
"Horsham 003B","E01031648","85+ years","Male",26,23,27,27,26,129
"Horsham 003B","E01031648","0-4 years","Female",59,56,66,50,44,275
"Horsham 003B","E01031648","5-9 years","Female",29,41,37,35,34,176
"Horsham 003B","E01031648","10-14 years","Female",37,32,30,34,34,167
"Horsham 003B","E01031648","15-19 years","Female",43,56,56,53,49,257
"Horsham 003B","E01031648","20-24 years","Female",57,56,44,44,50,251
"Horsham 003B","E01031648","25-29 years","Female",42,43,42,39,34,200
"Horsham 003B","E01031648","30-34 years","Female",63,70,66,63,62,324
"Horsham 003B","E01031648","35-39 years","Female",51,46,55,49,51,252
"Horsham 003B","E01031648","40-44 years","Female",57,58,68,65,62,310
"Horsham 003B","E01031648","45-49 years","Female",49,51,49,48,48,245
"Horsham 003B","E01031648","50-54 years","Female",63,60,68,63,54,308
"Horsham 003B","E01031648","55-59 years","Female",58,64,56,62,69,309
"Horsham 003B","E01031648","60-64 years","Female",35,40,41,45,38,199
"Horsham 003B","E01031648","65-69 years","Female",51,49,50,45,48,243
"Horsham 003B","E01031648","70-74 years","Female",42,47,43,49,48,229
"Horsham 003B","E01031648","75-79 years","Female",37,42,50,48,50,227
"Horsham 003B","E01031648","80-84 years","Female",41,44,37,30,24,176
"Horsham 003B","E01031648","85+ years","Female",35,30,32,35,38,170
"Horsham 003C","E01031651","0-4 years","Male",65,53,52,49,47,266
"Horsham 003C","E01031651","5-9 years","Male",58,67,64,50,48,287
"Horsham 003C","E01031651","10-14 years","Male",49,49,47,60,60,265
"Horsham 003C","E01031651","15-19 years","Male",51,48,44,36,36,215
"Horsham 003C","E01031651","20-24 years","Male",57,57,57,44,42,257
"Horsham 003C","E01031651","25-29 years","Male",48,39,36,44,41,208
"Horsham 003C","E01031651","30-34 years","Male",50,48,53,51,51,253
"Horsham 003C","E01031651","35-39 years","Male",46,47,43,38,40,214
"Horsham 003C","E01031651","40-44 years","Male",66,62,64,59,59,310
"Horsham 003C","E01031651","45-49 years","Male",67,70,74,75,66,352
"Horsham 003C","E01031651","50-54 years","Male",56,58,57,56,58,285
"Horsham 003C","E01031651","55-59 years","Male",65,66,60,63,55,309
"Horsham 003C","E01031651","60-64 years","Male",41,44,55,52,60,252
"Horsham 003C","E01031651","65-69 years","Male",37,38,29,38,33,175
"Horsham 003C","E01031651","70-74 years","Male",24,29,35,35,34,157
"Horsham 003C","E01031651","75-79 years","Male",19,20,21,19,27,106
"Horsham 003C","E01031651","80-84 years","Male",8,7,3,1,1,20
"Horsham 003C","E01031651","85+ years","Male",19,20,14,15,9,77
"Horsham 003C","E01031651","0-4 years","Female",56,45,33,34,40,208
"Horsham 003C","E01031651","5-9 years","Female",54,58,65,60,57,294
"Horsham 003C","E01031651","10-14 years","Female",63,65,51,54,49,282
"Horsham 003C","E01031651","15-19 years","Female",59,49,52,48,40,248
"Horsham 003C","E01031651","20-24 years","Female",51,51,63,47,48,260
"Horsham 003C","E01031651","25-29 years","Female",53,43,42,37,32,207
"Horsham 003C","E01031651","30-34 years","Female",46,55,46,47,46,240
"Horsham 003C","E01031651","35-39 years","Female",51,51,59,56,48,265
"Horsham 003C","E01031651","40-44 years","Female",86,75,73,67,67,368
"Horsham 003C","E01031651","45-49 years","Female",71,75,71,63,63,343
"Horsham 003C","E01031651","50-54 years","Female",76,67,63,59,63,328
"Horsham 003C","E01031651","55-59 years","Female",53,54,62,63,54,286
"Horsham 003C","E01031651","60-64 years","Female",46,47,41,42,53,229
"Horsham 003C","E01031651","65-69 years","Female",46,46,42,51,52,237
"Horsham 003C","E01031651","70-74 years","Female",39,38,39,39,41,196
"Horsham 003C","E01031651","75-79 years","Female",25,28,30,35,34,152
"Horsham 003C","E01031651","80-84 years","Female",20,20,17,16,19,92
"Horsham 003C","E01031651","85+ years","Female",35,41,39,43,33,191
"Horsham 003D","E01031658","0-4 years","Male",54,49,52,49,51,255
"Horsham 003D","E01031658","5-9 years","Male",66,59,51,51,53,280
"Horsham 003D","E01031658","10-14 years","Male",62,70,72,66,61,331
"Horsham 003D","E01031658","15-19 years","Male",51,42,44,48,52,237
"Horsham 003D","E01031658","20-24 years","Male",42,48,48,49,44,231
"Horsham 003D","E01031658","25-29 years","Male",55,49,37,41,50,232
"Horsham 003D","E01031658","30-34 years","Male",50,54,60,54,61,279
"Horsham 003D","E01031658","35-39 years","Male",35,38,40,39,39,191
"Horsham 003D","E01031658","40-44 years","Male",58,53,48,44,40,243
"Horsham 003D","E01031658","45-49 years","Male",95,81,61,61,59,357
"Horsham 003D","E01031658","50-54 years","Male",86,90,99,101,99,475
"Horsham 003D","E01031658","55-59 years","Male",70,81,86,87,91,415
"Horsham 003D","E01031658","60-64 years","Male",60,63,65,65,63,316
"Horsham 003D","E01031658","65-69 years","Male",78,66,67,67,65,343
"Horsham 003D","E01031658","70-74 years","Male",62,72,67,79,91,371
"Horsham 003D","E01031658","75-79 years","Male",37,39,51,47,45,219
"Horsham 003D","E01031658","80-84 years","Male",31,39,35,39,33,177
"Horsham 003D","E01031658","85+ years","Male",34,31,28,35,43,171
"Horsham 003D","E01031658","0-4 years","Female",48,45,42,37,31,203
"Horsham 003D","E01031658","5-9 years","Female",62,59,45,63,58,287
"Horsham 003D","E01031658","10-14 years","Female",72,79,94,89,88,422
"Horsham 003D","E01031658","15-19 years","Female",100,105,108,105,111,529
"Horsham 003D","E01031658","20-24 years","Female",52,44,54,55,50,255
"Horsham 003D","E01031658","25-29 years","Female",50,63,65,58,59,295
"Horsham 003D","E01031658","30-34 years","Female",30,26,33,39,46,174
"Horsham 003D","E01031658","35-39 years","Female",57,57,62,53,58,287
"Horsham 003D","E01031658","40-44 years","Female",65,66,62,57,55,305
"Horsham 003D","E01031658","45-49 years","Female",98,86,79,81,76,420
"Horsham 003D","E01031658","50-54 years","Female",82,97,102,95,96,472
"Horsham 003D","E01031658","55-59 years","Female",95,94,92,99,101,481
"Horsham 003D","E01031658","60-64 years","Female",69,75,86,95,92,417
"Horsham 003D","E01031658","65-69 years","Female",66,57,58,52,56,289
"Horsham 003D","E01031658","70-74 years","Female",81,94,95,94,89,453
"Horsham 003D","E01031658","75-79 years","Female",41,40,45,46,57,229
"Horsham 003D","E01031658","80-84 years","Female",39,40,39,41,35,194
"Horsham 003D","E01031658","85+ years","Female",49,49,55,55,57,265
"Horsham 003E","E01031689","0-4 years","Male",48,43,49,51,58,249
"Horsham 003E","E01031689","5-9 years","Male",59,69,65,63,57,313
"Horsham 003E","E01031689","10-14 years","Male",48,39,45,45,57,234
"Horsham 003E","E01031689","15-19 years","Male",43,40,41,47,34,205
"Horsham 003E","E01031689","20-24 years","Male",45,43,43,32,36,199
"Horsham 003E","E01031689","25-29 years","Male",52,49,41,39,38,219
"Horsham 003E","E01031689","30-34 years","Male",45,46,48,57,56,252
"Horsham 003E","E01031689","35-39 years","Male",72,69,74,70,66,351
"Horsham 003E","E01031689","40-44 years","Male",55,48,53,54,58,268
"Horsham 003E","E01031689","45-49 years","Male",68,64,65,59,58,314
"Horsham 003E","E01031689","50-54 years","Male",54,52,54,56,52,268
"Horsham 003E","E01031689","55-59 years","Male",44,54,53,56,61,268
"Horsham 003E","E01031689","60-64 years","Male",33,30,29,35,39,166
"Horsham 003E","E01031689","65-69 years","Male",48,50,43,38,33,212
"Horsham 003E","E01031689","70-74 years","Male",28,30,35,39,41,173
"Horsham 003E","E01031689","75-79 years","Male",16,19,27,24,30,116
"Horsham 003E","E01031689","80-84 years","Male",26,26,25,23,15,115
"Horsham 003E","E01031689","85+ years","Male",18,15,17,15,14,79
"Horsham 003E","E01031689","0-4 years","Female",58,40,47,48,48,241
"Horsham 003E","E01031689","5-9 years","Female",38,56,51,50,50,245
"Horsham 003E","E01031689","10-14 years","Female",44,43,53,50,44,234
"Horsham 003E","E01031689","15-19 years","Female",39,37,33,38,31,178
"Horsham 003E","E01031689","20-24 years","Female",37,35,39,40,36,187
"Horsham 003E","E01031689","25-29 years","Female",39,32,28,33,42,174
"Horsham 003E","E01031689","30-34 years","Female",47,48,50,54,51,250
"Horsham 003E","E01031689","35-39 years","Female",58,62,58,55,60,293
"Horsham 003E","E01031689","40-44 years","Female",66,67,67,62,64,326
"Horsham 003E","E01031689","45-49 years","Female",67,61,72,68,63,331
"Horsham 003E","E01031689","50-54 years","Female",72,75,66,57,59,329
"Horsham 003E","E01031689","55-59 years","Female",51,58,60,64,57,290
"Horsham 003E","E01031689","60-64 years","Female",31,28,39,39,54,191
"Horsham 003E","E01031689","65-69 years","Female",47,47,38,46,39,217
"Horsham 003E","E01031689","70-74 years","Female",28,33,38,40,46,185
"Horsham 003E","E01031689","75-79 years","Female",19,14,13,16,16,78
"Horsham 003E","E01031689","80-84 years","Female",30,30,36,35,28,159
"Horsham 003E","E01031689","85+ years","Female",24,25,22,26,26,123
"Horsham 004A","E01031654","0-4 years","Male",29,31,31,35,33,159
"Horsham 004A","E01031654","5-9 years","Male",44,40,38,40,42,204
"Horsham 004A","E01031654","10-14 years","Male",44,45,40,39,43,211
"Horsham 004A","E01031654","15-19 years","Male",69,62,70,65,50,316
"Horsham 004A","E01031654","20-24 years","Male",35,38,44,39,44,200
"Horsham 004A","E01031654","25-29 years","Male",31,30,24,23,20,128
"Horsham 004A","E01031654","30-34 years","Male",25,26,24,30,31,136
"Horsham 004A","E01031654","35-39 years","Male",48,47,50,45,44,234
"Horsham 004A","E01031654","40-44 years","Male",44,47,49,50,60,250
"Horsham 004A","E01031654","45-49 years","Male",57,52,54,59,55,277
"Horsham 004A","E01031654","50-54 years","Male",57,64,63,58,56,298
"Horsham 004A","E01031654","55-59 years","Male",73,71,73,70,70,357
"Horsham 004A","E01031654","60-64 years","Male",29,32,35,38,40,174
"Horsham 004A","E01031654","65-69 years","Male",47,49,48,42,48,234
"Horsham 004A","E01031654","70-74 years","Male",45,40,40,47,44,216
"Horsham 004A","E01031654","75-79 years","Male",28,31,35,34,35,163
"Horsham 004A","E01031654","80-84 years","Male",31,29,30,36,35,161
"Horsham 004A","E01031654","85+ years","Male",25,25,26,30,31,137
"Horsham 004A","E01031654","0-4 years","Female",25,26,21,20,22,114
"Horsham 004A","E01031654","5-9 years","Female",37,43,41,42,38,201
"Horsham 004A","E01031654","10-14 years","Female",57,54,54,61,48,274
"Horsham 004A","E01031654","15-19 years","Female",49,51,50,44,55,249
"Horsham 004A","E01031654","20-24 years","Female",16,17,17,20,17,87
"Horsham 004A","E01031654","25-29 years","Female",19,18,21,20,23,101
"Horsham 004A","E01031654","30-34 years","Female",28,32,30,24,23,137
"Horsham 004A","E01031654","35-39 years","Female",44,45,43,46,46,224
"Horsham 004A","E01031654","40-44 years","Female",52,51,43,44,40,230
"Horsham 004A","E01031654","45-49 years","Female",73,66,74,73,71,357
"Horsham 004A","E01031654","50-54 years","Female",72,77,71,79,79,378
"Horsham 004A","E01031654","55-59 years","Female",63,63,61,54,58,299
"Horsham 004A","E01031654","60-64 years","Female",42,40,47,51,51,231
"Horsham 004A","E01031654","65-69 years","Female",40,38,37,37,30,182
"Horsham 004A","E01031654","70-74 years","Female",42,44,37,41,51,215
"Horsham 004A","E01031654","75-79 years","Female",46,42,50,54,51,243
"Horsham 004A","E01031654","80-84 years","Female",38,47,45,47,40,217
"Horsham 004A","E01031654","85+ years","Female",53,51,55,57,57,273
"Horsham 004B","E01031655","0-4 years","Male",68,61,58,70,69,326
"Horsham 004B","E01031655","5-9 years","Male",90,86,84,79,77,416
"Horsham 004B","E01031655","10-14 years","Male",45,52,53,49,49,248
"Horsham 004B","E01031655","15-19 years","Male",37,35,43,44,42,201
"Horsham 004B","E01031655","20-24 years","Male",37,35,30,28,40,170
"Horsham 004B","E01031655","25-29 years","Male",50,63,62,65,62,302
"Horsham 004B","E01031655","30-34 years","Male",67,68,76,62,65,338
"Horsham 004B","E01031655","35-39 years","Male",79,69,72,79,83,382
"Horsham 004B","E01031655","40-44 years","Male",52,52,57,59,64,284
"Horsham 004B","E01031655","45-49 years","Male",80,72,61,59,53,325
"Horsham 004B","E01031655","50-54 years","Male",71,81,85,85,92,414
"Horsham 004B","E01031655","55-59 years","Male",34,37,36,38,45,190
"Horsham 004B","E01031655","60-64 years","Male",52,53,53,45,42,245
"Horsham 004B","E01031655","65-69 years","Male",27,33,36,38,40,174
"Horsham 004B","E01031655","70-74 years","Male",17,18,22,26,24,107
"Horsham 004B","E01031655","75-79 years","Male",8,9,8,11,12,48
"Horsham 004B","E01031655","80-84 years","Male",13,13,14,10,11,61
"Horsham 004B","E01031655","85+ years","Male",2,1,1,3,5,12
"Horsham 004B","E01031655","0-4 years","Female",43,42,51,50,48,234
"Horsham 004B","E01031655","5-9 years","Female",78,73,68,61,56,336
"Horsham 004B","E01031655","10-14 years","Female",53,51,53,57,64,278
"Horsham 004B","E01031655","15-19 years","Female",56,59,54,48,40,257
"Horsham 004B","E01031655","20-24 years","Female",27,34,34,37,31,163
"Horsham 004B","E01031655","25-29 years","Female",55,54,59,53,61,282
"Horsham 004B","E01031655","30-34 years","Female",80,72,72,66,59,349
"Horsham 004B","E01031655","35-39 years","Female",80,76,90,84,94,424
"Horsham 004B","E01031655","40-44 years","Female",67,66,57,63,56,309
"Horsham 004B","E01031655","45-49 years","Female",58,61,61,56,63,299
"Horsham 004B","E01031655","50-54 years","Female",53,60,70,71,67,321
"Horsham 004B","E01031655","55-59 years","Female",54,43,35,33,40,205
"Horsham 004B","E01031655","60-64 years","Female",37,46,53,58,54,248
"Horsham 004B","E01031655","65-69 years","Female",38,37,32,36,41,184
"Horsham 004B","E01031655","70-74 years","Female",12,13,15,13,11,64
"Horsham 004B","E01031655","75-79 years","Female",11,10,11,11,15,58
"Horsham 004B","E01031655","80-84 years","Female",16,18,18,16,13,81
"Horsham 004B","E01031655","85+ years","Female",19,19,16,17,15,86
"Horsham 004C","E01031667","0-4 years","Male",43,41,36,36,37,193
"Horsham 004C","E01031667","5-9 years","Male",47,41,49,40,39,216
"Horsham 004C","E01031667","10-14 years","Male",49,50,58,60,57,274
"Horsham 004C","E01031667","15-19 years","Male",38,33,26,27,33,157
"Horsham 004C","E01031667","20-24 years","Male",46,40,38,34,36,194
"Horsham 004C","E01031667","25-29 years","Male",34,35,38,30,34,171
"Horsham 004C","E01031667","30-34 years","Male",27,32,32,36,33,160
"Horsham 004C","E01031667","35-39 years","Male",42,36,36,43,37,194
"Horsham 004C","E01031667","40-44 years","Male",46,47,54,44,43,234
"Horsham 004C","E01031667","45-49 years","Male",62,62,57,56,54,291
"Horsham 004C","E01031667","50-54 years","Male",51,49,57,68,70,295
"Horsham 004C","E01031667","55-59 years","Male",41,49,47,45,45,227
"Horsham 004C","E01031667","60-64 years","Male",43,43,46,42,39,213
"Horsham 004C","E01031667","65-69 years","Male",62,52,49,45,48,256
"Horsham 004C","E01031667","70-74 years","Male",56,53,60,59,51,279
"Horsham 004C","E01031667","75-79 years","Male",27,34,31,35,38,165
"Horsham 004C","E01031667","80-84 years","Male",21,23,29,27,25,125
"Horsham 004C","E01031667","85+ years","Male",11,11,11,9,11,53
"Horsham 004C","E01031667","0-4 years","Female",37,39,31,29,30,166
"Horsham 004C","E01031667","5-9 years","Female",41,34,46,44,42,207
"Horsham 004C","E01031667","10-14 years","Female",35,31,29,32,36,163
"Horsham 004C","E01031667","15-19 years","Female",39,41,39,31,28,178
"Horsham 004C","E01031667","20-24 years","Female",27,25,23,27,26,128
"Horsham 004C","E01031667","25-29 years","Female",44,39,43,40,40,206
"Horsham 004C","E01031667","30-34 years","Female",41,53,50,45,52,241
"Horsham 004C","E01031667","35-39 years","Female",58,49,59,62,57,285
"Horsham 004C","E01031667","40-44 years","Female",55,51,42,44,48,240
"Horsham 004C","E01031667","45-49 years","Female",55,51,58,58,56,278
"Horsham 004C","E01031667","50-54 years","Female",45,53,46,42,40,226
"Horsham 004C","E01031667","55-59 years","Female",54,55,55,55,53,272
"Horsham 004C","E01031667","60-64 years","Female",44,45,49,48,46,232
"Horsham 004C","E01031667","65-69 years","Female",69,62,51,42,45,269
"Horsham 004C","E01031667","70-74 years","Female",49,57,68,65,64,303
"Horsham 004C","E01031667","75-79 years","Female",33,32,27,36,35,163
"Horsham 004C","E01031667","80-84 years","Female",32,33,35,36,36,172
"Horsham 004C","E01031667","85+ years","Female",19,25,28,26,27,125
"Horsham 004D","E01031669","0-4 years","Male",53,56,52,54,56,271
"Horsham 004D","E01031669","5-9 years","Male",50,52,53,53,65,273
"Horsham 004D","E01031669","10-14 years","Male",57,60,52,58,46,273
"Horsham 004D","E01031669","15-19 years","Male",43,45,46,40,45,219
"Horsham 004D","E01031669","20-24 years","Male",52,51,57,54,54,268
"Horsham 004D","E01031669","25-29 years","Male",43,41,42,44,42,212
"Horsham 004D","E01031669","30-34 years","Male",54,53,48,53,52,260
"Horsham 004D","E01031669","35-39 years","Male",59,78,68,60,61,326
"Horsham 004D","E01031669","40-44 years","Male",73,62,58,62,58,313
"Horsham 004D","E01031669","45-49 years","Male",54,57,56,59,62,288
"Horsham 004D","E01031669","50-54 years","Male",52,50,49,45,42,238
"Horsham 004D","E01031669","55-59 years","Male",53,50,50,57,63,273
"Horsham 004D","E01031669","60-64 years","Male",47,47,54,47,53,248
"Horsham 004D","E01031669","65-69 years","Male",37,37,42,50,48,214
"Horsham 004D","E01031669","70-74 years","Male",28,33,32,27,25,145
"Horsham 004D","E01031669","75-79 years","Male",15,15,13,18,18,79
"Horsham 004D","E01031669","80-84 years","Male",18,19,16,11,12,76
"Horsham 004D","E01031669","85+ years","Male",15,18,16,15,14,78
"Horsham 004D","E01031669","0-4 years","Female",64,69,65,64,64,326
"Horsham 004D","E01031669","5-9 years","Female",41,40,36,42,49,208
"Horsham 004D","E01031669","10-14 years","Female",54,55,51,51,58,269
"Horsham 004D","E01031669","15-19 years","Female",49,53,53,50,46,251
"Horsham 004D","E01031669","20-24 years","Female",40,43,40,34,35,192
"Horsham 004D","E01031669","25-29 years","Female",60,55,55,47,48,265
"Horsham 004D","E01031669","30-34 years","Female",67,75,72,79,71,364
"Horsham 004D","E01031669","35-39 years","Female",57,57,60,54,64,292
"Horsham 004D","E01031669","40-44 years","Female",55,59,54,56,52,276
"Horsham 004D","E01031669","45-49 years","Female",85,79,81,72,79,396
"Horsham 004D","E01031669","50-54 years","Female",70,71,66,67,71,345
"Horsham 004D","E01031669","55-59 years","Female",48,41,62,68,67,286
"Horsham 004D","E01031669","60-64 years","Female",44,45,42,30,29,190
"Horsham 004D","E01031669","65-69 years","Female",43,45,42,53,58,241
"Horsham 004D","E01031669","70-74 years","Female",19,23,20,23,22,107
"Horsham 004D","E01031669","75-79 years","Female",25,22,25,20,25,117
"Horsham 004D","E01031669","80-84 years","Female",30,34,29,32,25,150
"Horsham 004D","E01031669","85+ years","Female",33,29,34,32,32,160
"Horsham 004E","E01031672","0-4 years","Male",65,70,77,70,75,357
"Horsham 004E","E01031672","5-9 years","Male",42,41,43,46,52,224
"Horsham 004E","E01031672","10-14 years","Male",40,45,40,38,43,206
"Horsham 004E","E01031672","15-19 years","Male",30,31,29,36,41,167
"Horsham 004E","E01031672","20-24 years","Male",39,35,41,38,37,190
"Horsham 004E","E01031672","25-29 years","Male",91,106,107,105,102,511
"Horsham 004E","E01031672","30-34 years","Male",72,78,93,99,102,444
"Horsham 004E","E01031672","35-39 years","Male",56,57,67,77,76,333
"Horsham 004E","E01031672","40-44 years","Male",75,80,66,62,65,348
"Horsham 004E","E01031672","45-49 years","Male",99,103,111,111,102,526
"Horsham 004E","E01031672","50-54 years","Male",52,54,45,55,70,276
"Horsham 004E","E01031672","55-59 years","Male",53,59,75,68,66,321
"Horsham 004E","E01031672","60-64 years","Male",34,39,36,36,40,185
"Horsham 004E","E01031672","65-69 years","Male",32,27,33,33,33,158
"Horsham 004E","E01031672","70-74 years","Male",22,23,29,27,29,130
"Horsham 004E","E01031672","75-79 years","Male",22,29,23,28,33,135
"Horsham 004E","E01031672","80-84 years","Male",21,20,15,12,18,86
"Horsham 004E","E01031672","85+ years","Male",29,28,29,30,26,142
"Horsham 004E","E01031672","0-4 years","Female",36,40,46,47,49,218
"Horsham 004E","E01031672","5-9 years","Female",46,50,51,47,42,236
"Horsham 004E","E01031672","10-14 years","Female",32,37,40,39,46,194
"Horsham 004E","E01031672","15-19 years","Female",42,38,37,34,31,182
"Horsham 004E","E01031672","20-24 years","Female",56,52,62,61,62,293
"Horsham 004E","E01031672","25-29 years","Female",53,77,86,85,95,396
"Horsham 004E","E01031672","30-34 years","Female",80,83,87,98,96,444
"Horsham 004E","E01031672","35-39 years","Female",65,61,54,52,60,292
"Horsham 004E","E01031672","40-44 years","Female",71,77,77,76,79,380
"Horsham 004E","E01031672","45-49 years","Female",50,49,44,62,65,270
"Horsham 004E","E01031672","50-54 years","Female",51,53,54,49,43,250
"Horsham 004E","E01031672","55-59 years","Female",59,67,72,85,79,362
"Horsham 004E","E01031672","60-64 years","Female",37,38,37,37,40,189
"Horsham 004E","E01031672","65-69 years","Female",34,32,33,42,41,182
"Horsham 004E","E01031672","70-74 years","Female",44,50,44,33,33,204
"Horsham 004E","E01031672","75-79 years","Female",35,39,41,46,50,211
"Horsham 004E","E01031672","80-84 years","Female",42,40,42,37,36,197
"Horsham 004E","E01031672","85+ years","Female",49,47,51,61,46,254
"Horsham 005A","E01031657","0-4 years","Male",37,44,50,52,56,239
"Horsham 005A","E01031657","5-9 years","Male",66,65,49,50,47,277
"Horsham 005A","E01031657","10-14 years","Male",71,71,71,66,73,352
"Horsham 005A","E01031657","15-19 years","Male",60,68,56,57,58,299
"Horsham 005A","E01031657","20-24 years","Male",48,41,46,36,32,203
"Horsham 005A","E01031657","25-29 years","Male",56,58,52,55,50,271
"Horsham 005A","E01031657","30-34 years","Male",60,69,73,69,67,338
"Horsham 005A","E01031657","35-39 years","Male",48,60,62,58,62,290
"Horsham 005A","E01031657","40-44 years","Male",45,41,41,49,47,223
"Horsham 005A","E01031657","45-49 years","Male",82,87,78,74,73,394
"Horsham 005A","E01031657","50-54 years","Male",89,88,75,75,78,405
"Horsham 005A","E01031657","55-59 years","Male",78,78,79,74,82,391
"Horsham 005A","E01031657","60-64 years","Male",52,56,64,75,82,329
"Horsham 005A","E01031657","65-69 years","Male",77,70,60,69,59,335
"Horsham 005A","E01031657","70-74 years","Male",45,49,51,50,57,252
"Horsham 005A","E01031657","75-79 years","Male",31,28,32,34,31,156
"Horsham 005A","E01031657","80-84 years","Male",25,23,22,32,27,129
"Horsham 005A","E01031657","85+ years","Male",24,26,25,19,23,117
"Horsham 005A","E01031657","0-4 years","Female",26,29,31,28,32,146
"Horsham 005A","E01031657","5-9 years","Female",45,43,38,38,44,208
"Horsham 005A","E01031657","10-14 years","Female",46,49,44,48,49,236
"Horsham 005A","E01031657","15-19 years","Female",44,39,40,39,36,198
"Horsham 005A","E01031657","20-24 years","Female",59,52,45,41,38,235
"Horsham 005A","E01031657","25-29 years","Female",63,79,70,65,63,340
"Horsham 005A","E01031657","30-34 years","Female",58,66,69,67,65,325
"Horsham 005A","E01031657","35-39 years","Female",45,44,52,47,54,242
"Horsham 005A","E01031657","40-44 years","Female",57,61,57,63,66,304
"Horsham 005A","E01031657","45-49 years","Female",92,81,77,71,74,395
"Horsham 005A","E01031657","50-54 years","Female",93,99,93,97,86,468
"Horsham 005A","E01031657","55-59 years","Female",78,92,90,91,95,446
"Horsham 005A","E01031657","60-64 years","Female",65,74,72,79,77,367
"Horsham 005A","E01031657","65-69 years","Female",62,54,55,49,47,267
"Horsham 005A","E01031657","70-74 years","Female",60,66,61,65,71,323
"Horsham 005A","E01031657","75-79 years","Female",36,36,37,39,38,186
"Horsham 005A","E01031657","80-84 years","Female",17,18,18,16,20,89
"Horsham 005A","E01031657","85+ years","Female",51,46,44,28,30,199
"Horsham 005B","E01031659","0-4 years","Male",35,34,38,39,44,190
"Horsham 005B","E01031659","5-9 years","Male",59,61,57,54,51,282
"Horsham 005B","E01031659","10-14 years","Male",48,54,57,57,63,279
"Horsham 005B","E01031659","15-19 years","Male",67,60,62,52,52,293
"Horsham 005B","E01031659","20-24 years","Male",42,39,39,41,39,200
"Horsham 005B","E01031659","25-29 years","Male",30,41,45,42,48,206
"Horsham 005B","E01031659","30-34 years","Male",18,21,20,17,25,101
"Horsham 005B","E01031659","35-39 years","Male",39,32,38,43,36,188
"Horsham 005B","E01031659","40-44 years","Male",49,46,49,47,45,236
"Horsham 005B","E01031659","45-49 years","Male",64,64,62,65,58,313
"Horsham 005B","E01031659","50-54 years","Male",75,77,84,82,82,400
"Horsham 005B","E01031659","55-59 years","Male",63,60,65,70,76,334
"Horsham 005B","E01031659","60-64 years","Male",58,58,50,51,54,271
"Horsham 005B","E01031659","65-69 years","Male",56,58,59,55,51,279
"Horsham 005B","E01031659","70-74 years","Male",36,38,36,40,49,199
"Horsham 005B","E01031659","75-79 years","Male",30,32,34,35,31,162
"Horsham 005B","E01031659","80-84 years","Male",18,21,21,20,21,101
"Horsham 005B","E01031659","85+ years","Male",17,15,19,21,18,90
"Horsham 005B","E01031659","0-4 years","Female",29,37,37,38,34,175
"Horsham 005B","E01031659","5-9 years","Female",63,62,64,62,53,304
"Horsham 005B","E01031659","10-14 years","Female",59,55,55,53,54,276
"Horsham 005B","E01031659","15-19 years","Female",44,38,43,49,49,223
"Horsham 005B","E01031659","20-24 years","Female",31,45,40,43,34,193
"Horsham 005B","E01031659","25-29 years","Female",29,32,52,42,50,205
"Horsham 005B","E01031659","30-34 years","Female",45,54,50,52,52,253
"Horsham 005B","E01031659","35-39 years","Female",45,44,44,40,39,212
"Horsham 005B","E01031659","40-44 years","Female",46,49,51,58,62,266
"Horsham 005B","E01031659","45-49 years","Female",76,66,59,63,58,322
"Horsham 005B","E01031659","50-54 years","Female",78,86,84,81,86,415
"Horsham 005B","E01031659","55-59 years","Female",65,62,75,83,90,375
"Horsham 005B","E01031659","60-64 years","Female",61,63,60,59,54,297
"Horsham 005B","E01031659","65-69 years","Female",51,47,50,49,51,248
"Horsham 005B","E01031659","70-74 years","Female",51,57,53,58,50,269
"Horsham 005B","E01031659","75-79 years","Female",45,36,35,37,39,192
"Horsham 005B","E01031659","80-84 years","Female",18,17,18,14,15,82
"Horsham 005B","E01031659","85+ years","Female",49,53,45,48,38,233
"Horsham 005C","E01031674","0-4 years","Male",24,22,22,22,19,109
"Horsham 005C","E01031674","5-9 years","Male",38,39,39,36,39,191
"Horsham 005C","E01031674","10-14 years","Male",47,57,46,46,42,238
"Horsham 005C","E01031674","15-19 years","Male",88,94,99,91,94,466
"Horsham 005C","E01031674","20-24 years","Male",20,17,19,26,26,108
"Horsham 005C","E01031674","25-29 years","Male",16,17,16,14,18,81
"Horsham 005C","E01031674","30-34 years","Male",18,15,18,20,25,96
"Horsham 005C","E01031674","35-39 years","Male",32,33,26,22,20,133
"Horsham 005C","E01031674","40-44 years","Male",35,29,36,38,33,171
"Horsham 005C","E01031674","45-49 years","Male",50,49,46,45,47,237
"Horsham 005C","E01031674","50-54 years","Male",63,62,60,58,58,301
"Horsham 005C","E01031674","55-59 years","Male",55,58,60,65,65,303
"Horsham 005C","E01031674","60-64 years","Male",39,42,47,45,51,224
"Horsham 005C","E01031674","65-69 years","Male",43,40,39,39,38,199
"Horsham 005C","E01031674","70-74 years","Male",56,54,53,52,49,264
"Horsham 005C","E01031674","75-79 years","Male",26,23,23,30,35,137
"Horsham 005C","E01031674","80-84 years","Male",10,14,17,18,19,78
"Horsham 005C","E01031674","85+ years","Male",17,18,20,19,20,94
"Horsham 005C","E01031674","0-4 years","Female",40,36,33,41,39,189
"Horsham 005C","E01031674","5-9 years","Female",29,35,32,34,35,165
"Horsham 005C","E01031674","10-14 years","Female",41,47,43,39,34,204
"Horsham 005C","E01031674","15-19 years","Female",76,75,78,91,101,421
"Horsham 005C","E01031674","20-24 years","Female",23,23,22,24,24,116
"Horsham 005C","E01031674","25-29 years","Female",22,19,18,16,16,91
"Horsham 005C","E01031674","30-34 years","Female",23,23,28,29,34,137
"Horsham 005C","E01031674","35-39 years","Female",42,44,38,38,45,207
"Horsham 005C","E01031674","40-44 years","Female",38,36,37,41,32,184
"Horsham 005C","E01031674","45-49 years","Female",57,60,57,48,40,262
"Horsham 005C","E01031674","50-54 years","Female",63,58,61,67,65,314
"Horsham 005C","E01031674","55-59 years","Female",54,54,60,52,58,278
"Horsham 005C","E01031674","60-64 years","Female",47,53,48,53,57,258
"Horsham 005C","E01031674","65-69 years","Female",53,48,46,47,39,233
"Horsham 005C","E01031674","70-74 years","Female",38,45,53,49,57,242
"Horsham 005C","E01031674","75-79 years","Female",27,23,22,26,30,128
"Horsham 005C","E01031674","80-84 years","Female",21,24,23,29,27,124
"Horsham 005C","E01031674","85+ years","Female",36,28,31,33,34,162
"Horsham 005D","E01031675","0-4 years","Male",42,40,42,36,32,192
"Horsham 005D","E01031675","5-9 years","Male",38,43,53,61,57,252
"Horsham 005D","E01031675","10-14 years","Male",42,42,39,38,37,198
"Horsham 005D","E01031675","15-19 years","Male",44,43,42,42,41,212
"Horsham 005D","E01031675","20-24 years","Male",26,32,32,32,36,158
"Horsham 005D","E01031675","25-29 years","Male",32,37,33,33,31,166
"Horsham 005D","E01031675","30-34 years","Male",22,26,27,27,32,134
"Horsham 005D","E01031675","35-39 years","Male",40,38,35,37,33,183
"Horsham 005D","E01031675","40-44 years","Male",37,40,44,46,51,218
"Horsham 005D","E01031675","45-49 years","Male",37,37,37,38,41,190
"Horsham 005D","E01031675","50-54 years","Male",82,64,63,59,63,331
"Horsham 005D","E01031675","55-59 years","Male",49,59,57,58,51,274
"Horsham 005D","E01031675","60-64 years","Male",48,51,49,51,50,249
"Horsham 005D","E01031675","65-69 years","Male",54,56,58,48,52,268
"Horsham 005D","E01031675","70-74 years","Male",35,41,44,45,43,208
"Horsham 005D","E01031675","75-79 years","Male",38,26,27,33,39,163
"Horsham 005D","E01031675","80-84 years","Male",25,38,45,47,47,202
"Horsham 005D","E01031675","85+ years","Male",19,16,15,16,21,87
"Horsham 005D","E01031675","0-4 years","Female",37,40,50,40,40,207
"Horsham 005D","E01031675","5-9 years","Female",42,45,45,51,53,236
"Horsham 005D","E01031675","10-14 years","Female",37,33,40,45,47,202
"Horsham 005D","E01031675","15-19 years","Female",29,32,25,23,28,137
"Horsham 005D","E01031675","20-24 years","Female",16,14,14,17,17,78
"Horsham 005D","E01031675","25-29 years","Female",23,29,31,27,23,133
"Horsham 005D","E01031675","30-34 years","Female",21,19,23,22,25,110
"Horsham 005D","E01031675","35-39 years","Female",30,36,36,43,36,181
"Horsham 005D","E01031675","40-44 years","Female",57,59,60,57,53,286
"Horsham 005D","E01031675","45-49 years","Female",46,44,48,46,52,236
"Horsham 005D","E01031675","50-54 years","Female",75,72,64,58,57,326
"Horsham 005D","E01031675","55-59 years","Female",67,70,70,75,83,365
"Horsham 005D","E01031675","60-64 years","Female",60,59,60,61,56,296
"Horsham 005D","E01031675","65-69 years","Female",61,60,62,64,77,324
"Horsham 005D","E01031675","70-74 years","Female",34,48,52,54,50,238
"Horsham 005D","E01031675","75-79 years","Female",36,41,43,45,52,217
"Horsham 005D","E01031675","80-84 years","Female",28,29,29,34,34,154
"Horsham 005D","E01031675","85+ years","Female",26,24,25,21,21,117
"Horsham 006A","E01031636","0-4 years","Male",70,57,55,63,69,314
"Horsham 006A","E01031636","5-9 years","Male",52,48,57,56,47,260
"Horsham 006A","E01031636","10-14 years","Male",54,53,49,50,49,255
"Horsham 006A","E01031636","15-19 years","Male",47,46,50,52,57,252
"Horsham 006A","E01031636","20-24 years","Male",70,81,64,64,69,348
"Horsham 006A","E01031636","25-29 years","Male",116,127,128,122,128,621
"Horsham 006A","E01031636","30-34 years","Male",116,116,114,112,135,593
"Horsham 006A","E01031636","35-39 years","Male",90,82,101,113,106,492
"Horsham 006A","E01031636","40-44 years","Male",87,87,89,77,76,416
"Horsham 006A","E01031636","45-49 years","Male",110,105,98,110,105,528
"Horsham 006A","E01031636","50-54 years","Male",73,78,87,94,105,437
"Horsham 006A","E01031636","55-59 years","Male",80,81,73,80,81,395
"Horsham 006A","E01031636","60-64 years","Male",41,45,50,46,53,235
"Horsham 006A","E01031636","65-69 years","Male",47,43,48,41,38,217
"Horsham 006A","E01031636","70-74 years","Male",47,41,44,53,59,244
"Horsham 006A","E01031636","75-79 years","Male",37,41,35,38,43,194
"Horsham 006A","E01031636","80-84 years","Male",53,48,48,47,40,236
"Horsham 006A","E01031636","85+ years","Male",35,28,38,47,45,193
"Horsham 006A","E01031636","0-4 years","Female",69,72,71,69,69,350
"Horsham 006A","E01031636","5-9 years","Female",68,65,61,58,57,309
"Horsham 006A","E01031636","10-14 years","Female",51,52,62,65,63,293
"Horsham 006A","E01031636","15-19 years","Female",36,45,38,43,49,211
"Horsham 006A","E01031636","20-24 years","Female",90,80,90,90,96,446
"Horsham 006A","E01031636","25-29 years","Female",81,90,87,90,87,435
"Horsham 006A","E01031636","30-34 years","Female",89,94,110,117,135,545
"Horsham 006A","E01031636","35-39 years","Female",94,75,71,71,72,383
"Horsham 006A","E01031636","40-44 years","Female",75,80,82,79,76,392
"Horsham 006A","E01031636","45-49 years","Female",74,86,91,94,83,428
"Horsham 006A","E01031636","50-54 years","Female",73,78,74,86,93,404
"Horsham 006A","E01031636","55-59 years","Female",66,64,66,57,62,315
"Horsham 006A","E01031636","60-64 years","Female",45,45,46,57,58,251
"Horsham 006A","E01031636","65-69 years","Female",61,60,60,64,71,316
"Horsham 006A","E01031636","70-74 years","Female",48,58,55,56,63,280
"Horsham 006A","E01031636","75-79 years","Female",66,55,60,57,51,289
"Horsham 006A","E01031636","80-84 years","Female",91,86,73,77,77,404
"Horsham 006A","E01031636","85+ years","Female",101,113,118,122,119,573
"Horsham 006B","E01031652","0-4 years","Male",69,64,70,59,60,322
"Horsham 006B","E01031652","5-9 years","Male",93,88,87,90,77,435
"Horsham 006B","E01031652","10-14 years","Male",66,77,92,90,99,424
"Horsham 006B","E01031652","15-19 years","Male",58,59,57,60,61,295
"Horsham 006B","E01031652","20-24 years","Male",66,55,61,55,55,292
"Horsham 006B","E01031652","25-29 years","Male",59,51,51,45,44,250
"Horsham 006B","E01031652","30-34 years","Male",45,47,50,51,51,244
"Horsham 006B","E01031652","35-39 years","Male",89,96,88,86,79,438
"Horsham 006B","E01031652","40-44 years","Male",51,55,62,63,64,295
"Horsham 006B","E01031652","45-49 years","Male",68,63,58,59,63,311
"Horsham 006B","E01031652","50-54 years","Male",57,53,56,54,48,268
"Horsham 006B","E01031652","55-59 years","Male",54,62,60,60,63,299
"Horsham 006B","E01031652","60-64 years","Male",29,30,28,37,38,162
"Horsham 006B","E01031652","65-69 years","Male",36,35,38,33,33,175
"Horsham 006B","E01031652","70-74 years","Male",20,18,17,17,18,90
"Horsham 006B","E01031652","75-79 years","Male",19,19,12,14,17,81
"Horsham 006B","E01031652","80-84 years","Male",16,13,11,10,12,62
"Horsham 006B","E01031652","85+ years","Male",23,20,19,23,21,106
"Horsham 006B","E01031652","0-4 years","Female",57,67,69,62,61,316
"Horsham 006B","E01031652","5-9 years","Female",72,67,73,68,69,349
"Horsham 006B","E01031652","10-14 years","Female",64,70,64,68,68,334
"Horsham 006B","E01031652","15-19 years","Female",69,62,62,61,53,307
"Horsham 006B","E01031652","20-24 years","Female",43,40,36,36,40,195
"Horsham 006B","E01031652","25-29 years","Female",48,48,44,38,35,213
"Horsham 006B","E01031652","30-34 years","Female",59,63,75,72,66,335
"Horsham 006B","E01031652","35-39 years","Female",64,78,75,64,57,338
"Horsham 006B","E01031652","40-44 years","Female",76,63,67,74,82,362
"Horsham 006B","E01031652","45-49 years","Female",72,77,72,79,81,381
"Horsham 006B","E01031652","50-54 years","Female",65,65,66,57,56,309
"Horsham 006B","E01031652","55-59 years","Female",53,42,43,50,54,242
"Horsham 006B","E01031652","60-64 years","Female",35,44,41,44,43,207
"Horsham 006B","E01031652","65-69 years","Female",23,25,29,29,31,137
"Horsham 006B","E01031652","70-74 years","Female",29,35,32,28,29,153
"Horsham 006B","E01031652","75-79 years","Female",23,20,22,25,21,111
"Horsham 006B","E01031652","80-84 years","Female",22,16,19,16,18,91
"Horsham 006B","E01031652","85+ years","Female",33,41,30,29,29,162
"Horsham 006C","E01031653","0-4 years","Male",44,50,54,57,59,264
"Horsham 006C","E01031653","5-9 years","Male",43,33,31,30,32,169
"Horsham 006C","E01031653","10-14 years","Male",38,46,44,46,39,213
"Horsham 006C","E01031653","15-19 years","Male",49,44,35,35,39,202
"Horsham 006C","E01031653","20-24 years","Male",65,68,87,81,82,383
"Horsham 006C","E01031653","25-29 years","Male",75,69,87,101,95,427
"Horsham 006C","E01031653","30-34 years","Male",73,77,74,79,81,384
"Horsham 006C","E01031653","35-39 years","Male",55,54,72,69,70,320
"Horsham 006C","E01031653","40-44 years","Male",69,72,59,72,65,337
"Horsham 006C","E01031653","45-49 years","Male",73,79,89,79,74,394
"Horsham 006C","E01031653","50-54 years","Male",51,53,62,58,65,289
"Horsham 006C","E01031653","55-59 years","Male",50,52,55,58,53,268
"Horsham 006C","E01031653","60-64 years","Male",44,44,42,48,51,229
"Horsham 006C","E01031653","65-69 years","Male",34,43,54,60,57,248
"Horsham 006C","E01031653","70-74 years","Male",23,23,24,19,25,114
"Horsham 006C","E01031653","75-79 years","Male",24,27,21,28,28,128
"Horsham 006C","E01031653","80-84 years","Male",19,22,23,15,20,99
"Horsham 006C","E01031653","85+ years","Male",35,33,32,27,31,158
"Horsham 006C","E01031653","0-4 years","Female",55,58,58,54,48,273
"Horsham 006C","E01031653","5-9 years","Female",37,35,32,38,36,178
"Horsham 006C","E01031653","10-14 years","Female",46,45,59,56,52,258
"Horsham 006C","E01031653","15-19 years","Female",48,45,48,42,43,226
"Horsham 006C","E01031653","20-24 years","Female",41,49,52,59,46,247
"Horsham 006C","E01031653","25-29 years","Female",77,66,74,77,74,368
"Horsham 006C","E01031653","30-34 years","Female",68,73,70,69,72,352
"Horsham 006C","E01031653","35-39 years","Female",74,75,82,71,83,385
"Horsham 006C","E01031653","40-44 years","Female",49,54,53,52,49,257
"Horsham 006C","E01031653","45-49 years","Female",72,77,77,76,66,368
"Horsham 006C","E01031653","50-54 years","Female",75,83,82,75,85,400
"Horsham 006C","E01031653","55-59 years","Female",47,48,62,63,59,279
"Horsham 006C","E01031653","60-64 years","Female",54,48,43,36,49,230
"Horsham 006C","E01031653","65-69 years","Female",23,31,35,45,36,170
"Horsham 006C","E01031653","70-74 years","Female",34,34,36,36,30,170
"Horsham 006C","E01031653","75-79 years","Female",25,25,30,30,48,158
"Horsham 006C","E01031653","80-84 years","Female",47,42,39,37,34,199
"Horsham 006C","E01031653","85+ years","Female",111,109,106,107,90,523
"Horsham 006D","E01031656","0-4 years","Male",58,53,42,41,46,240
"Horsham 006D","E01031656","5-9 years","Male",41,55,55,62,58,271
"Horsham 006D","E01031656","10-14 years","Male",34,34,39,39,46,192
"Horsham 006D","E01031656","15-19 years","Male",28,29,25,26,28,136
"Horsham 006D","E01031656","20-24 years","Male",47,41,44,51,52,235
"Horsham 006D","E01031656","25-29 years","Male",70,76,65,70,83,364
"Horsham 006D","E01031656","30-34 years","Male",68,59,68,75,82,352
"Horsham 006D","E01031656","35-39 years","Male",70,74,68,72,75,359
"Horsham 006D","E01031656","40-44 years","Male",86,83,78,80,77,404
"Horsham 006D","E01031656","45-49 years","Male",61,57,66,61,65,310
"Horsham 006D","E01031656","50-54 years","Male",83,86,79,77,72,397
"Horsham 006D","E01031656","55-59 years","Male",43,48,46,53,58,248
"Horsham 006D","E01031656","60-64 years","Male",54,40,47,54,51,246
"Horsham 006D","E01031656","65-69 years","Male",23,30,35,32,37,157
"Horsham 006D","E01031656","70-74 years","Male",31,30,29,25,24,139
"Horsham 006D","E01031656","75-79 years","Male",29,24,30,25,21,129
"Horsham 006D","E01031656","80-84 years","Male",9,13,11,15,20,68
"Horsham 006D","E01031656","85+ years","Male",22,21,19,21,21,104
"Horsham 006D","E01031656","0-4 years","Female",55,56,58,59,55,283
"Horsham 006D","E01031656","5-9 years","Female",54,54,54,52,54,268
"Horsham 006D","E01031656","10-14 years","Female",44,61,65,66,70,306
"Horsham 006D","E01031656","15-19 years","Female",38,44,40,42,40,204
"Horsham 006D","E01031656","20-24 years","Female",54,55,46,59,53,267
"Horsham 006D","E01031656","25-29 years","Female",62,60,59,63,84,328
"Horsham 006D","E01031656","30-34 years","Female",62,63,64,63,78,330
"Horsham 006D","E01031656","35-39 years","Female",74,63,60,67,66,330
"Horsham 006D","E01031656","40-44 years","Female",53,57,60,68,74,312
"Horsham 006D","E01031656","45-49 years","Female",81,79,76,77,74,387
"Horsham 006D","E01031656","50-54 years","Female",55,61,71,77,79,343
"Horsham 006D","E01031656","55-59 years","Female",49,51,58,62,66,286
"Horsham 006D","E01031656","60-64 years","Female",42,41,43,49,44,219
"Horsham 006D","E01031656","65-69 years","Female",33,35,32,24,27,151
"Horsham 006D","E01031656","70-74 years","Female",26,29,32,34,31,152
"Horsham 006D","E01031656","75-79 years","Female",49,37,40,36,29,191
"Horsham 006D","E01031656","80-84 years","Female",26,29,34,32,43,164
"Horsham 006D","E01031656","85+ years","Female",59,58,44,43,37,241
"Horsham 006E","E01031688","0-4 years","Male",26,28,28,33,38,153
"Horsham 006E","E01031688","5-9 years","Male",67,57,60,54,50,288
"Horsham 006E","E01031688","10-14 years","Male",55,62,61,56,44,278
"Horsham 006E","E01031688","15-19 years","Male",41,35,38,37,38,189
"Horsham 006E","E01031688","20-24 years","Male",33,34,37,37,42,183
"Horsham 006E","E01031688","25-29 years","Male",23,25,25,25,31,129
"Horsham 006E","E01031688","30-34 years","Male",27,28,29,32,30,146
"Horsham 006E","E01031688","35-39 years","Male",30,29,32,33,36,160
"Horsham 006E","E01031688","40-44 years","Male",54,52,49,44,43,242
"Horsham 006E","E01031688","45-49 years","Male",38,36,35,43,45,197
"Horsham 006E","E01031688","50-54 years","Male",51,53,55,49,50,258
"Horsham 006E","E01031688","55-59 years","Male",41,41,39,44,52,217
"Horsham 006E","E01031688","60-64 years","Male",42,43,40,37,35,197
"Horsham 006E","E01031688","65-69 years","Male",41,46,46,43,34,210
"Horsham 006E","E01031688","70-74 years","Male",34,34,39,43,44,194
"Horsham 006E","E01031688","75-79 years","Male",24,27,21,22,24,118
"Horsham 006E","E01031688","80-84 years","Male",18,17,17,14,13,79
"Horsham 006E","E01031688","85+ years","Male",21,23,22,16,19,101
"Horsham 006E","E01031688","0-4 years","Female",20,23,19,21,23,106
"Horsham 006E","E01031688","5-9 years","Female",49,43,40,44,37,213
"Horsham 006E","E01031688","10-14 years","Female",24,29,39,35,39,166
"Horsham 006E","E01031688","15-19 years","Female",53,43,40,28,29,193
"Horsham 006E","E01031688","20-24 years","Female",21,25,21,22,25,114
"Horsham 006E","E01031688","25-29 years","Female",32,31,36,30,22,151
"Horsham 006E","E01031688","30-34 years","Female",39,40,37,36,34,186
"Horsham 006E","E01031688","35-39 years","Female",53,57,52,54,53,269
"Horsham 006E","E01031688","40-44 years","Female",46,39,41,42,37,205
"Horsham 006E","E01031688","45-49 years","Female",56,48,42,40,33,219
"Horsham 006E","E01031688","50-54 years","Female",50,60,72,74,78,334
"Horsham 006E","E01031688","55-59 years","Female",39,43,38,35,38,193
"Horsham 006E","E01031688","60-64 years","Female",46,44,47,45,39,221
"Horsham 006E","E01031688","65-69 years","Female",44,42,35,38,51,210
"Horsham 006E","E01031688","70-74 years","Female",37,36,36,38,34,181
"Horsham 006E","E01031688","75-79 years","Female",40,40,37,35,34,186
"Horsham 006E","E01031688","80-84 years","Female",37,33,40,37,38,185
"Horsham 006E","E01031688","85+ years","Female",56,51,51,56,55,269
"Horsham 006F","E01031691","0-4 years","Male",53,49,47,49,49,247
"Horsham 006F","E01031691","5-9 years","Male",77,81,76,76,63,373
"Horsham 006F","E01031691","10-14 years","Male",50,52,56,54,58,270
"Horsham 006F","E01031691","15-19 years","Male",41,30,29,36,40,176
"Horsham 006F","E01031691","20-24 years","Male",25,27,25,29,34,140
"Horsham 006F","E01031691","25-29 years","Male",40,47,48,40,39,214
"Horsham 006F","E01031691","30-34 years","Male",45,46,42,33,32,198
"Horsham 006F","E01031691","35-39 years","Male",72,72,77,68,63,352
"Horsham 006F","E01031691","40-44 years","Male",51,45,51,63,66,276
"Horsham 006F","E01031691","45-49 years","Male",75,66,64,61,65,331
"Horsham 006F","E01031691","50-54 years","Male",80,89,80,83,72,404
"Horsham 006F","E01031691","55-59 years","Male",54,59,61,73,74,321
"Horsham 006F","E01031691","60-64 years","Male",54,51,53,45,48,251
"Horsham 006F","E01031691","65-69 years","Male",36,47,46,44,48,221
"Horsham 006F","E01031691","70-74 years","Male",38,34,33,40,37,182
"Horsham 006F","E01031691","75-79 years","Male",35,35,37,32,30,169
"Horsham 006F","E01031691","80-84 years","Male",31,34,35,34,34,168
"Horsham 006F","E01031691","85+ years","Male",29,31,34,32,33,159
"Horsham 006F","E01031691","0-4 years","Female",59,53,53,56,43,264
"Horsham 006F","E01031691","5-9 years","Female",64,65,66,58,66,319
"Horsham 006F","E01031691","10-14 years","Female",38,39,40,52,56,225
"Horsham 006F","E01031691","15-19 years","Female",29,27,28,27,25,136
"Horsham 006F","E01031691","20-24 years","Female",24,29,29,34,32,148
"Horsham 006F","E01031691","25-29 years","Female",39,40,44,49,40,212
"Horsham 006F","E01031691","30-34 years","Female",62,47,39,38,45,231
"Horsham 006F","E01031691","35-39 years","Female",80,83,85,77,62,387
"Horsham 006F","E01031691","40-44 years","Female",61,55,59,65,81,321
"Horsham 006F","E01031691","45-49 years","Female",68,68,68,62,63,329
"Horsham 006F","E01031691","50-54 years","Female",62,58,56,59,55,290
"Horsham 006F","E01031691","55-59 years","Female",67,69,67,68,69,340
"Horsham 006F","E01031691","60-64 years","Female",46,53,56,51,50,256
"Horsham 006F","E01031691","65-69 years","Female",55,52,53,58,64,282
"Horsham 006F","E01031691","70-74 years","Female",61,63,61,66,64,315
"Horsham 006F","E01031691","75-79 years","Female",48,46,44,39,40,217
"Horsham 006F","E01031691","80-84 years","Female",41,43,46,42,41,213
"Horsham 006F","E01031691","85+ years","Female",40,37,41,36,44,198
"Horsham 007A","E01031619","0-4 years","Male",150,206,236,207,205,1004
"Horsham 007A","E01031619","5-9 years","Male",119,151,157,191,202,820
"Horsham 007A","E01031619","10-14 years","Male",87,110,143,163,165,668
"Horsham 007A","E01031619","15-19 years","Male",74,77,84,79,85,399
"Horsham 007A","E01031619","20-24 years","Male",84,101,103,100,92,480
"Horsham 007A","E01031619","25-29 years","Male",106,135,136,127,122,626
"Horsham 007A","E01031619","30-34 years","Male",150,174,196,192,195,907
"Horsham 007A","E01031619","35-39 years","Male",119,156,166,163,174,778
"Horsham 007A","E01031619","40-44 years","Male",126,143,174,192,203,838
"Horsham 007A","E01031619","45-49 years","Male",110,129,123,129,138,629
"Horsham 007A","E01031619","50-54 years","Male",95,102,116,118,124,555
"Horsham 007A","E01031619","55-59 years","Male",69,89,97,107,117,479
"Horsham 007A","E01031619","60-64 years","Male",55,65,62,53,67,302
"Horsham 007A","E01031619","65-69 years","Male",47,43,52,46,41,229
"Horsham 007A","E01031619","70-74 years","Male",27,41,39,45,52,204
"Horsham 007A","E01031619","75-79 years","Male",23,26,29,31,26,135
"Horsham 007A","E01031619","80-84 years","Male",10,11,11,11,11,54
"Horsham 007A","E01031619","85+ years","Male",7,8,11,10,11,47
"Horsham 007A","E01031619","0-4 years","Female",142,161,166,175,187,831
"Horsham 007A","E01031619","5-9 years","Female",110,148,163,150,172,743
"Horsham 007A","E01031619","10-14 years","Female",76,98,115,130,129,548
"Horsham 007A","E01031619","15-19 years","Female",93,97,97,100,99,486
"Horsham 007A","E01031619","20-24 years","Female",77,89,85,78,79,408
"Horsham 007A","E01031619","25-29 years","Female",156,172,194,165,176,863
"Horsham 007A","E01031619","30-34 years","Female",134,184,211,206,198,933
"Horsham 007A","E01031619","35-39 years","Female",141,172,187,194,198,892
"Horsham 007A","E01031619","40-44 years","Female",125,148,165,178,195,811
"Horsham 007A","E01031619","45-49 years","Female",126,142,139,150,152,709
"Horsham 007A","E01031619","50-54 years","Female",105,123,135,142,139,644
"Horsham 007A","E01031619","55-59 years","Female",77,88,95,88,96,444
"Horsham 007A","E01031619","60-64 years","Female",59,59,67,65,73,323
"Horsham 007A","E01031619","65-69 years","Female",50,62,61,68,68,309
"Horsham 007A","E01031619","70-74 years","Female",31,39,48,51,56,225
"Horsham 007A","E01031619","75-79 years","Female",29,31,28,35,36,159
"Horsham 007A","E01031619","80-84 years","Female",12,12,14,12,17,67
"Horsham 007A","E01031619","85+ years","Female",20,24,25,18,28,115
"Horsham 007B","E01031637","0-4 years","Male",106,114,101,108,93,522
"Horsham 007B","E01031637","5-9 years","Male",108,99,105,111,112,535
"Horsham 007B","E01031637","10-14 years","Male",91,117,103,108,110,529
"Horsham 007B","E01031637","15-19 years","Male",80,80,91,94,93,438
"Horsham 007B","E01031637","20-24 years","Male",49,44,53,56,57,259
"Horsham 007B","E01031637","25-29 years","Male",64,75,74,68,70,351
"Horsham 007B","E01031637","30-34 years","Male",67,71,84,97,90,409
"Horsham 007B","E01031637","35-39 years","Male",104,108,100,94,92,498
"Horsham 007B","E01031637","40-44 years","Male",96,94,100,110,120,520
"Horsham 007B","E01031637","45-49 years","Male",105,121,133,135,124,618
"Horsham 007B","E01031637","50-54 years","Male",89,89,86,102,117,483
"Horsham 007B","E01031637","55-59 years","Male",68,76,85,83,86,398
"Horsham 007B","E01031637","60-64 years","Male",66,64,63,67,64,324
"Horsham 007B","E01031637","65-69 years","Male",70,80,80,76,81,387
"Horsham 007B","E01031637","70-74 years","Male",44,54,58,62,59,277
"Horsham 007B","E01031637","75-79 years","Male",34,44,54,62,63,257
"Horsham 007B","E01031637","80-84 years","Male",25,34,32,34,33,158
"Horsham 007B","E01031637","85+ years","Male",25,30,33,32,28,148
"Horsham 007B","E01031637","0-4 years","Female",90,93,91,86,82,442
"Horsham 007B","E01031637","5-9 years","Female",87,88,91,88,86,440
"Horsham 007B","E01031637","10-14 years","Female",93,99,98,104,108,502
"Horsham 007B","E01031637","15-19 years","Female",71,67,72,73,81,364
"Horsham 007B","E01031637","20-24 years","Female",53,52,53,56,51,265
"Horsham 007B","E01031637","25-29 years","Female",66,78,93,85,92,414
"Horsham 007B","E01031637","30-34 years","Female",98,92,98,109,121,518
"Horsham 007B","E01031637","35-39 years","Female",119,139,143,125,129,655
"Horsham 007B","E01031637","40-44 years","Female",113,115,112,123,123,586
"Horsham 007B","E01031637","45-49 years","Female",116,116,122,127,139,620
"Horsham 007B","E01031637","50-54 years","Female",104,117,120,123,112,576
"Horsham 007B","E01031637","55-59 years","Female",86,92,100,107,113,498
"Horsham 007B","E01031637","60-64 years","Female",72,82,78,83,90,405
"Horsham 007B","E01031637","65-69 years","Female",98,105,113,102,103,521
"Horsham 007B","E01031637","70-74 years","Female",44,67,77,91,99,378
"Horsham 007B","E01031637","75-79 years","Female",36,37,42,44,47,206
"Horsham 007B","E01031637","80-84 years","Female",35,46,47,56,48,232
"Horsham 007B","E01031637","85+ years","Female",34,46,51,52,57,240
"Horsham 007C","E01031638","0-4 years","Male",67,60,57,45,49,278
"Horsham 007C","E01031638","5-9 years","Male",63,67,60,56,49,295
"Horsham 007C","E01031638","10-14 years","Male",54,61,66,83,92,356
"Horsham 007C","E01031638","15-19 years","Male",43,47,41,43,40,214
"Horsham 007C","E01031638","20-24 years","Male",42,43,49,51,49,234
"Horsham 007C","E01031638","25-29 years","Male",67,55,53,53,57,285
"Horsham 007C","E01031638","30-34 years","Male",67,63,54,56,68,308
"Horsham 007C","E01031638","35-39 years","Male",64,70,65,66,54,319
"Horsham 007C","E01031638","40-44 years","Male",50,49,56,55,58,268
"Horsham 007C","E01031638","45-49 years","Male",62,59,55,58,55,289
"Horsham 007C","E01031638","50-54 years","Male",69,73,72,72,69,355
"Horsham 007C","E01031638","55-59 years","Male",68,67,73,81,66,355
"Horsham 007C","E01031638","60-64 years","Male",51,53,50,50,54,258
"Horsham 007C","E01031638","65-69 years","Male",40,45,54,57,60,256
"Horsham 007C","E01031638","70-74 years","Male",30,34,36,35,38,173
"Horsham 007C","E01031638","75-79 years","Male",28,26,22,24,25,125
"Horsham 007C","E01031638","80-84 years","Male",7,13,21,30,30,101
"Horsham 007C","E01031638","85+ years","Male",17,14,13,14,9,67
"Horsham 007C","E01031638","0-4 years","Female",52,50,57,57,45,261
"Horsham 007C","E01031638","5-9 years","Female",60,64,54,53,52,283
"Horsham 007C","E01031638","10-14 years","Female",43,48,46,53,54,244
"Horsham 007C","E01031638","15-19 years","Female",28,24,28,31,31,142
"Horsham 007C","E01031638","20-24 years","Female",32,28,23,22,27,132
"Horsham 007C","E01031638","25-29 years","Female",73,67,63,67,63,333
"Horsham 007C","E01031638","30-34 years","Female",86,80,73,57,63,359
"Horsham 007C","E01031638","35-39 years","Female",57,63,59,60,52,291
"Horsham 007C","E01031638","40-44 years","Female",69,59,64,61,69,322
"Horsham 007C","E01031638","45-49 years","Female",71,69,64,69,67,340
"Horsham 007C","E01031638","50-54 years","Female",68,66,63,61,72,330
"Horsham 007C","E01031638","55-59 years","Female",62,63,61,56,61,303
"Horsham 007C","E01031638","60-64 years","Female",68,61,67,66,61,323
"Horsham 007C","E01031638","65-69 years","Female",44,52,50,61,63,270
"Horsham 007C","E01031638","70-74 years","Female",36,40,39,45,50,210
"Horsham 007C","E01031638","75-79 years","Female",29,26,27,30,23,135
"Horsham 007C","E01031638","80-84 years","Female",24,30,30,31,30,145
"Horsham 007C","E01031638","85+ years","Female",30,28,29,29,28,144
"Horsham 007D","E01031690","0-4 years","Male",56,54,36,36,33,215
"Horsham 007D","E01031690","5-9 years","Male",35,39,47,51,58,230
"Horsham 007D","E01031690","10-14 years","Male",37,39,45,43,40,204
"Horsham 007D","E01031690","15-19 years","Male",34,30,35,34,32,165
"Horsham 007D","E01031690","20-24 years","Male",44,36,33,37,30,180
"Horsham 007D","E01031690","25-29 years","Male",14,14,15,10,16,69
"Horsham 007D","E01031690","30-34 years","Male",21,24,24,25,24,118
"Horsham 007D","E01031690","35-39 years","Male",34,38,38,35,30,175
"Horsham 007D","E01031690","40-44 years","Male",37,36,35,37,37,182
"Horsham 007D","E01031690","45-49 years","Male",58,61,57,62,56,294
"Horsham 007D","E01031690","50-54 years","Male",52,48,53,51,54,258
"Horsham 007D","E01031690","55-59 years","Male",66,64,62,59,54,305
"Horsham 007D","E01031690","60-64 years","Male",70,72,71,71,78,362
"Horsham 007D","E01031690","65-69 years","Male",61,46,55,62,55,279
"Horsham 007D","E01031690","70-74 years","Male",42,47,44,44,46,223
"Horsham 007D","E01031690","75-79 years","Male",34,34,35,37,42,182
"Horsham 007D","E01031690","80-84 years","Male",24,23,27,23,22,119
"Horsham 007D","E01031690","85+ years","Male",27,23,24,28,30,132
"Horsham 007D","E01031690","0-4 years","Female",24,26,27,24,22,123
"Horsham 007D","E01031690","5-9 years","Female",52,57,53,55,49,266
"Horsham 007D","E01031690","10-14 years","Female",54,54,58,54,66,286
"Horsham 007D","E01031690","15-19 years","Female",31,33,29,33,30,156
"Horsham 007D","E01031690","20-24 years","Female",18,22,22,23,18,103
"Horsham 007D","E01031690","25-29 years","Female",13,9,8,11,13,54
"Horsham 007D","E01031690","30-34 years","Female",28,26,24,23,22,123
"Horsham 007D","E01031690","35-39 years","Female",42,45,40,34,29,190
"Horsham 007D","E01031690","40-44 years","Female",43,46,47,57,55,248
"Horsham 007D","E01031690","45-49 years","Female",49,49,49,47,49,243
"Horsham 007D","E01031690","50-54 years","Female",63,64,65,58,51,301
"Horsham 007D","E01031690","55-59 years","Female",58,52,57,56,62,285
"Horsham 007D","E01031690","60-64 years","Female",62,60,51,54,57,284
"Horsham 007D","E01031690","65-69 years","Female",63,56,55,56,49,279
"Horsham 007D","E01031690","70-74 years","Female",45,50,52,49,56,252
"Horsham 007D","E01031690","75-79 years","Female",39,43,44,44,41,211
"Horsham 007D","E01031690","80-84 years","Female",29,25,27,26,25,132
"Horsham 007D","E01031690","85+ years","Female",46,36,41,39,37,199
"Horsham 008A","E01031639","0-4 years","Male",55,63,61,60,41,280
"Horsham 008A","E01031639","5-9 years","Male",42,40,42,52,59,235
"Horsham 008A","E01031639","10-14 years","Male",52,53,41,49,56,251
"Horsham 008A","E01031639","15-19 years","Male",42,46,49,42,34,213
"Horsham 008A","E01031639","20-24 years","Male",26,29,34,34,36,159
"Horsham 008A","E01031639","25-29 years","Male",44,43,49,54,52,242
"Horsham 008A","E01031639","30-34 years","Male",75,71,81,90,84,401
"Horsham 008A","E01031639","35-39 years","Male",65,70,60,62,74,331
"Horsham 008A","E01031639","40-44 years","Male",56,61,65,68,69,319
"Horsham 008A","E01031639","45-49 years","Male",71,67,53,49,51,291
"Horsham 008A","E01031639","50-54 years","Male",101,95,102,98,92,488
"Horsham 008A","E01031639","55-59 years","Male",46,63,65,76,75,325
"Horsham 008A","E01031639","60-64 years","Male",68,67,62,58,65,320
"Horsham 008A","E01031639","65-69 years","Male",71,64,64,56,56,311
"Horsham 008A","E01031639","70-74 years","Male",44,46,53,63,70,276
"Horsham 008A","E01031639","75-79 years","Male",29,27,30,36,41,163
"Horsham 008A","E01031639","80-84 years","Male",24,26,26,25,23,124
"Horsham 008A","E01031639","85+ years","Male",25,28,25,22,14,114
"Horsham 008A","E01031639","0-4 years","Female",52,53,52,60,58,275
"Horsham 008A","E01031639","5-9 years","Female",56,62,59,62,64,303
"Horsham 008A","E01031639","10-14 years","Female",34,33,40,48,50,205
"Horsham 008A","E01031639","15-19 years","Female",44,40,37,33,31,185
"Horsham 008A","E01031639","20-24 years","Female",42,46,44,42,36,210
"Horsham 008A","E01031639","25-29 years","Female",34,44,54,54,62,248
"Horsham 008A","E01031639","30-34 years","Female",69,67,57,57,62,312
"Horsham 008A","E01031639","35-39 years","Female",50,58,61,66,65,300
"Horsham 008A","E01031639","40-44 years","Female",82,83,65,78,78,386
"Horsham 008A","E01031639","45-49 years","Female",64,62,59,61,68,314
"Horsham 008A","E01031639","50-54 years","Female",90,85,90,84,73,422
"Horsham 008A","E01031639","55-59 years","Female",68,77,75,75,88,383
"Horsham 008A","E01031639","60-64 years","Female",59,59,63,57,51,289
"Horsham 008A","E01031639","65-69 years","Female",75,64,63,65,71,338
"Horsham 008A","E01031639","70-74 years","Female",53,60,59,61,60,293
"Horsham 008A","E01031639","75-79 years","Female",41,40,46,51,53,231
"Horsham 008A","E01031639","80-84 years","Female",41,40,38,32,33,184
"Horsham 008A","E01031639","85+ years","Female",37,33,37,46,49,202
"Horsham 008B","E01031640","0-4 years","Male",45,42,33,28,36,184
"Horsham 008B","E01031640","5-9 years","Male",51,54,60,64,63,292
"Horsham 008B","E01031640","10-14 years","Male",48,43,44,48,51,234
"Horsham 008B","E01031640","15-19 years","Male",50,57,59,50,40,256
"Horsham 008B","E01031640","20-24 years","Male",35,32,31,38,32,168
"Horsham 008B","E01031640","25-29 years","Male",14,14,18,18,25,89
"Horsham 008B","E01031640","30-34 years","Male",19,17,15,15,16,82
"Horsham 008B","E01031640","35-39 years","Male",39,36,34,36,27,172
"Horsham 008B","E01031640","40-44 years","Male",45,56,65,63,60,289
"Horsham 008B","E01031640","45-49 years","Male",69,64,58,64,63,318
"Horsham 008B","E01031640","50-54 years","Male",66,66,65,71,62,330
"Horsham 008B","E01031640","55-59 years","Male",74,71,76,65,67,353
"Horsham 008B","E01031640","60-64 years","Male",56,61,58,70,68,313
"Horsham 008B","E01031640","65-69 years","Male",76,60,62,55,47,300
"Horsham 008B","E01031640","70-74 years","Male",70,81,81,75,82,389
"Horsham 008B","E01031640","75-79 years","Male",52,50,58,59,59,278
"Horsham 008B","E01031640","80-84 years","Male",45,38,42,47,45,217
"Horsham 008B","E01031640","85+ years","Male",27,33,30,36,31,157
"Horsham 008B","E01031640","0-4 years","Female",40,41,44,42,38,205
"Horsham 008B","E01031640","5-9 years","Female",56,49,55,55,51,266
"Horsham 008B","E01031640","10-14 years","Female",58,63,57,71,70,319
"Horsham 008B","E01031640","15-19 years","Female",59,59,51,49,55,273
"Horsham 008B","E01031640","20-24 years","Female",38,41,42,35,35,191
"Horsham 008B","E01031640","25-29 years","Female",23,28,34,36,28,149
"Horsham 008B","E01031640","30-34 years","Female",16,12,13,20,19,80
"Horsham 008B","E01031640","35-39 years","Female",48,50,47,49,52,246
"Horsham 008B","E01031640","40-44 years","Female",49,46,46,51,46,238
"Horsham 008B","E01031640","45-49 years","Female",68,67,66,65,64,330
"Horsham 008B","E01031640","50-54 years","Female",96,92,89,77,69,423
"Horsham 008B","E01031640","55-59 years","Female",60,70,81,87,88,386
"Horsham 008B","E01031640","60-64 years","Female",50,47,47,51,56,251
"Horsham 008B","E01031640","65-69 years","Female",85,82,70,67,60,364
"Horsham 008B","E01031640","70-74 years","Female",70,72,88,79,80,389
"Horsham 008B","E01031640","75-79 years","Female",61,62,49,50,56,278
"Horsham 008B","E01031640","80-84 years","Female",34,30,38,39,37,178
"Horsham 008B","E01031640","85+ years","Female",36,36,37,39,38,186
"Horsham 008C","E01031660","0-4 years","Male",20,14,18,19,21,92
"Horsham 008C","E01031660","5-9 years","Male",28,29,22,19,17,115
"Horsham 008C","E01031660","10-14 years","Male",32,33,29,27,28,149
"Horsham 008C","E01031660","15-19 years","Male",26,27,33,30,27,143
"Horsham 008C","E01031660","20-24 years","Male",19,14,14,15,13,75
"Horsham 008C","E01031660","25-29 years","Male",41,39,32,32,39,183
"Horsham 008C","E01031660","30-34 years","Male",11,15,19,22,19,86
"Horsham 008C","E01031660","35-39 years","Male",17,18,18,18,12,83
"Horsham 008C","E01031660","40-44 years","Male",33,28,27,22,25,135
"Horsham 008C","E01031660","45-49 years","Male",50,43,46,43,37,219
"Horsham 008C","E01031660","50-54 years","Male",68,70,66,63,57,324
"Horsham 008C","E01031660","55-59 years","Male",72,66,68,61,66,333
"Horsham 008C","E01031660","60-64 years","Male",43,53,58,68,65,287
"Horsham 008C","E01031660","65-69 years","Male",65,48,43,46,48,250
"Horsham 008C","E01031660","70-74 years","Male",43,57,54,51,55,260
"Horsham 008C","E01031660","75-79 years","Male",48,49,51,49,45,242
"Horsham 008C","E01031660","80-84 years","Male",16,20,23,28,30,117
"Horsham 008C","E01031660","85+ years","Male",22,21,20,17,18,98
"Horsham 008C","E01031660","0-4 years","Female",18,13,18,24,24,97
"Horsham 008C","E01031660","5-9 years","Female",47,47,47,34,26,201
"Horsham 008C","E01031660","10-14 years","Female",39,42,40,44,53,218
"Horsham 008C","E01031660","15-19 years","Female",31,33,30,29,23,146
"Horsham 008C","E01031660","20-24 years","Female",33,28,32,31,34,158
"Horsham 008C","E01031660","25-29 years","Female",21,18,16,19,16,90
"Horsham 008C","E01031660","30-34 years","Female",13,16,18,19,18,84
"Horsham 008C","E01031660","35-39 years","Female",25,24,18,20,24,111
"Horsham 008C","E01031660","40-44 years","Female",38,31,36,31,24,160
"Horsham 008C","E01031660","45-49 years","Female",52,45,49,41,40,227
"Horsham 008C","E01031660","50-54 years","Female",74,72,68,64,61,339
"Horsham 008C","E01031660","55-59 years","Female",67,73,73,76,73,362
"Horsham 008C","E01031660","60-64 years","Female",41,40,51,60,62,254
"Horsham 008C","E01031660","65-69 years","Female",58,53,47,45,42,245
"Horsham 008C","E01031660","70-74 years","Female",55,59,61,61,64,300
"Horsham 008C","E01031660","75-79 years","Female",25,28,39,44,39,175
"Horsham 008C","E01031660","80-84 years","Female",29,25,21,23,28,126
"Horsham 008C","E01031660","85+ years","Female",28,27,29,23,30,137
"Horsham 008D","E01031661","0-4 years","Male",25,25,31,30,28,139
"Horsham 008D","E01031661","5-9 years","Male",40,38,33,38,47,196
"Horsham 008D","E01031661","10-14 years","Male",44,50,51,49,46,240
"Horsham 008D","E01031661","15-19 years","Male",28,30,32,35,44,169
"Horsham 008D","E01031661","20-24 years","Male",35,31,25,27,22,140
"Horsham 008D","E01031661","25-29 years","Male",37,32,34,31,37,171
"Horsham 008D","E01031661","30-34 years","Male",24,34,38,41,34,171
"Horsham 008D","E01031661","35-39 years","Male",37,37,41,37,36,188
"Horsham 008D","E01031661","40-44 years","Male",52,44,49,45,45,235
"Horsham 008D","E01031661","45-49 years","Male",79,68,56,52,59,314
"Horsham 008D","E01031661","50-54 years","Male",78,92,95,98,97,460
"Horsham 008D","E01031661","55-59 years","Male",49,45,51,58,65,268
"Horsham 008D","E01031661","60-64 years","Male",70,67,66,60,60,323
"Horsham 008D","E01031661","65-69 years","Male",59,56,50,56,53,274
"Horsham 008D","E01031661","70-74 years","Male",45,53,56,58,61,273
"Horsham 008D","E01031661","75-79 years","Male",45,43,45,45,38,216
"Horsham 008D","E01031661","80-84 years","Male",31,33,29,25,31,149
"Horsham 008D","E01031661","85+ years","Male",14,12,14,18,17,75
"Horsham 008D","E01031661","0-4 years","Female",28,34,32,37,34,165
"Horsham 008D","E01031661","5-9 years","Female",46,40,38,42,43,209
"Horsham 008D","E01031661","10-14 years","Female",36,35,35,38,37,181
"Horsham 008D","E01031661","15-19 years","Female",47,54,48,47,42,238
"Horsham 008D","E01031661","20-24 years","Female",31,28,32,31,32,154
"Horsham 008D","E01031661","25-29 years","Female",35,31,28,26,24,144
"Horsham 008D","E01031661","30-34 years","Female",30,32,38,37,33,170
"Horsham 008D","E01031661","35-39 years","Female",40,38,37,45,44,204
"Horsham 008D","E01031661","40-44 years","Female",43,47,49,48,53,240
"Horsham 008D","E01031661","45-49 years","Female",90,83,71,62,56,362
"Horsham 008D","E01031661","50-54 years","Female",67,67,72,77,79,362
"Horsham 008D","E01031661","55-59 years","Female",69,67,75,69,68,348
"Horsham 008D","E01031661","60-64 years","Female",73,66,55,61,68,323
"Horsham 008D","E01031661","65-69 years","Female",55,57,53,57,55,277
"Horsham 008D","E01031661","70-74 years","Female",49,53,55,49,53,259
"Horsham 008D","E01031661","75-79 years","Female",43,44,45,43,41,216
"Horsham 008D","E01031661","80-84 years","Female",20,25,27,29,31,132
"Horsham 008D","E01031661","85+ years","Female",14,14,10,13,16,67
"Horsham 008E","E01031679","0-4 years","Male",32,28,29,30,32,151
"Horsham 008E","E01031679","5-9 years","Male",34,39,37,35,27,172
"Horsham 008E","E01031679","10-14 years","Male",196,140,170,179,177,862
"Horsham 008E","E01031679","15-19 years","Male",373,344,333,265,301,1616
"Horsham 008E","E01031679","20-24 years","Male",43,31,24,27,43,168
"Horsham 008E","E01031679","25-29 years","Male",24,27,27,30,26,134
"Horsham 008E","E01031679","30-34 years","Male",37,35,36,34,42,184
"Horsham 008E","E01031679","35-39 years","Male",37,42,36,34,31,180
"Horsham 008E","E01031679","40-44 years","Male",41,39,46,42,47,215
"Horsham 008E","E01031679","45-49 years","Male",64,61,54,49,51,279
"Horsham 008E","E01031679","50-54 years","Male",54,57,60,60,52,283
"Horsham 008E","E01031679","55-59 years","Male",58,55,62,72,78,325
"Horsham 008E","E01031679","60-64 years","Male",35,38,31,31,28,163
"Horsham 008E","E01031679","65-69 years","Male",32,37,35,25,26,155
"Horsham 008E","E01031679","70-74 years","Male",23,23,22,24,26,118
"Horsham 008E","E01031679","75-79 years","Male",10,10,14,15,18,67
"Horsham 008E","E01031679","80-84 years","Male",16,14,13,9,11,63
"Horsham 008E","E01031679","85+ years","Male",14,11,16,20,19,80
"Horsham 008E","E01031679","0-4 years","Female",32,31,37,34,35,169
"Horsham 008E","E01031679","5-9 years","Female",28,30,31,28,35,152
"Horsham 008E","E01031679","10-14 years","Female",213,163,179,180,155,890
"Horsham 008E","E01031679","15-19 years","Female",354,322,317,258,304,1555
"Horsham 008E","E01031679","20-24 years","Female",30,22,26,27,36,141
"Horsham 008E","E01031679","25-29 years","Female",28,25,28,27,24,132
"Horsham 008E","E01031679","30-34 years","Female",34,39,33,35,41,182
"Horsham 008E","E01031679","35-39 years","Female",28,30,30,31,30,149
"Horsham 008E","E01031679","40-44 years","Female",53,50,44,43,33,223
"Horsham 008E","E01031679","45-49 years","Female",68,70,69,63,77,347
"Horsham 008E","E01031679","50-54 years","Female",66,59,68,71,70,334
"Horsham 008E","E01031679","55-59 years","Female",49,57,51,53,58,268
"Horsham 008E","E01031679","60-64 years","Female",46,56,55,56,48,261
"Horsham 008E","E01031679","65-69 years","Female",19,18,21,22,24,104
"Horsham 008E","E01031679","70-74 years","Female",25,18,24,24,29,120
"Horsham 008E","E01031679","75-79 years","Female",13,16,19,20,18,86
"Horsham 008E","E01031679","80-84 years","Female",11,10,11,12,15,59
"Horsham 008E","E01031679","85+ years","Female",16,16,15,14,16,77
"Horsham 009A","E01031677","0-4 years","Male",47,52,49,51,47,246
"Horsham 009A","E01031677","5-9 years","Male",58,52,51,48,49,258
"Horsham 009A","E01031677","10-14 years","Male",49,61,50,54,59,273
"Horsham 009A","E01031677","15-19 years","Male",34,35,44,46,45,204
"Horsham 009A","E01031677","20-24 years","Male",27,22,21,19,22,111
"Horsham 009A","E01031677","25-29 years","Male",50,51,45,55,47,248
"Horsham 009A","E01031677","30-34 years","Male",30,34,37,39,37,177
"Horsham 009A","E01031677","35-39 years","Male",46,47,42,42,40,217
"Horsham 009A","E01031677","40-44 years","Male",56,52,46,47,56,257
"Horsham 009A","E01031677","45-49 years","Male",53,52,53,53,52,263
"Horsham 009A","E01031677","50-54 years","Male",53,49,51,51,49,253
"Horsham 009A","E01031677","55-59 years","Male",66,64,68,64,64,326
"Horsham 009A","E01031677","60-64 years","Male",56,63,61,71,78,329
"Horsham 009A","E01031677","65-69 years","Male",35,31,36,38,39,179
"Horsham 009A","E01031677","70-74 years","Male",23,29,24,24,26,126
"Horsham 009A","E01031677","75-79 years","Male",30,30,29,34,33,156
"Horsham 009A","E01031677","80-84 years","Male",22,20,24,25,30,121
"Horsham 009A","E01031677","85+ years","Male",12,13,12,10,9,56
"Horsham 009A","E01031677","0-4 years","Female",62,54,51,46,44,257
"Horsham 009A","E01031677","5-9 years","Female",48,60,63,60,59,290
"Horsham 009A","E01031677","10-14 years","Female",41,39,37,35,37,189
"Horsham 009A","E01031677","15-19 years","Female",41,36,40,37,38,192
"Horsham 009A","E01031677","20-24 years","Female",40,32,26,31,27,156
"Horsham 009A","E01031677","25-29 years","Female",37,43,26,26,32,164
"Horsham 009A","E01031677","30-34 years","Female",48,60,61,55,56,280
"Horsham 009A","E01031677","35-39 years","Female",45,42,47,49,50,233
"Horsham 009A","E01031677","40-44 years","Female",52,60,60,59,54,285
"Horsham 009A","E01031677","45-49 years","Female",53,48,49,44,51,245
"Horsham 009A","E01031677","50-54 years","Female",58,62,62,59,59,300
"Horsham 009A","E01031677","55-59 years","Female",55,55,58,66,64,298
"Horsham 009A","E01031677","60-64 years","Female",51,44,50,49,51,245
"Horsham 009A","E01031677","65-69 years","Female",45,47,49,51,50,242
"Horsham 009A","E01031677","70-74 years","Female",44,41,35,40,42,202
"Horsham 009A","E01031677","75-79 years","Female",35,38,39,40,42,194
"Horsham 009A","E01031677","80-84 years","Female",26,24,27,30,33,140
"Horsham 009A","E01031677","85+ years","Female",27,29,27,28,35,146
"Horsham 009B","E01031678","0-4 years","Male",60,57,53,63,54,287
"Horsham 009B","E01031678","5-9 years","Male",90,79,84,69,62,384
"Horsham 009B","E01031678","10-14 years","Male",73,85,85,96,98,437
"Horsham 009B","E01031678","15-19 years","Male",79,69,67,61,62,338
"Horsham 009B","E01031678","20-24 years","Male",40,50,46,46,41,223
"Horsham 009B","E01031678","25-29 years","Male",56,47,53,45,42,243
"Horsham 009B","E01031678","30-34 years","Male",55,51,56,49,44,255
"Horsham 009B","E01031678","35-39 years","Male",43,54,53,62,60,272
"Horsham 009B","E01031678","40-44 years","Male",59,55,44,48,49,255
"Horsham 009B","E01031678","45-49 years","Male",78,71,73,69,76,367
"Horsham 009B","E01031678","50-54 years","Male",92,99,88,88,83,450
"Horsham 009B","E01031678","55-59 years","Male",83,88,93,90,82,436
"Horsham 009B","E01031678","60-64 years","Male",63,64,68,62,71,328
"Horsham 009B","E01031678","65-69 years","Male",50,47,51,61,55,264
"Horsham 009B","E01031678","70-74 years","Male",32,40,36,31,34,173
"Horsham 009B","E01031678","75-79 years","Male",16,14,22,24,29,105
"Horsham 009B","E01031678","80-84 years","Male",12,14,13,13,22,74
"Horsham 009B","E01031678","85+ years","Male",10,11,8,6,7,42
"Horsham 009B","E01031678","0-4 years","Female",50,50,52,49,46,247
"Horsham 009B","E01031678","5-9 years","Female",68,69,65,68,84,354
"Horsham 009B","E01031678","10-14 years","Female",63,60,70,72,67,332
"Horsham 009B","E01031678","15-19 years","Female",75,68,65,62,60,330
"Horsham 009B","E01031678","20-24 years","Female",49,48,48,52,52,249
"Horsham 009B","E01031678","25-29 years","Female",51,47,45,38,42,223
"Horsham 009B","E01031678","30-34 years","Female",40,32,38,38,39,187
"Horsham 009B","E01031678","35-39 years","Female",51,60,58,57,58,284
"Horsham 009B","E01031678","40-44 years","Female",73,66,62,66,65,332
"Horsham 009B","E01031678","45-49 years","Female",82,84,88,74,71,399
"Horsham 009B","E01031678","50-54 years","Female",81,88,89,87,85,430
"Horsham 009B","E01031678","55-59 years","Female",75,69,66,68,78,356
"Horsham 009B","E01031678","60-64 years","Female",57,63,61,73,73,327
"Horsham 009B","E01031678","65-69 years","Female",47,50,54,50,48,249
"Horsham 009B","E01031678","70-74 years","Female",33,36,37,45,44,195
"Horsham 009B","E01031678","75-79 years","Female",12,12,18,18,21,81
"Horsham 009B","E01031678","80-84 years","Female",16,18,13,13,13,73
"Horsham 009B","E01031678","85+ years","Female",14,18,18,20,20,90
"Horsham 009C","E01031680","0-4 years","Male",42,44,48,39,36,209
"Horsham 009C","E01031680","5-9 years","Male",42,47,47,46,42,224
"Horsham 009C","E01031680","10-14 years","Male",54,49,43,43,42,231
"Horsham 009C","E01031680","15-19 years","Male",73,73,67,57,52,322
"Horsham 009C","E01031680","20-24 years","Male",55,60,66,62,58,301
"Horsham 009C","E01031680","25-29 years","Male",29,27,28,25,25,134
"Horsham 009C","E01031680","30-34 years","Male",21,24,29,33,40,147
"Horsham 009C","E01031680","35-39 years","Male",31,33,34,30,25,153
"Horsham 009C","E01031680","40-44 years","Male",52,45,40,47,44,228
"Horsham 009C","E01031680","45-49 years","Male",64,65,69,56,51,305
"Horsham 009C","E01031680","50-54 years","Male",84,89,82,82,72,409
"Horsham 009C","E01031680","55-59 years","Male",73,74,74,72,85,378
"Horsham 009C","E01031680","60-64 years","Male",49,54,57,61,65,286
"Horsham 009C","E01031680","65-69 years","Male",20,26,38,41,49,174
"Horsham 009C","E01031680","70-74 years","Male",26,23,25,25,24,123
"Horsham 009C","E01031680","75-79 years","Male",13,14,16,17,22,82
"Horsham 009C","E01031680","80-84 years","Male",11,13,19,17,8,68
"Horsham 009C","E01031680","85+ years","Male",14,13,13,13,15,68
"Horsham 009C","E01031680","0-4 years","Female",32,33,32,30,36,163
"Horsham 009C","E01031680","5-9 years","Female",48,49,44,39,35,215
"Horsham 009C","E01031680","10-14 years","Female",69,65,66,60,52,312
"Horsham 009C","E01031680","15-19 years","Female",34,38,43,46,46,207
"Horsham 009C","E01031680","20-24 years","Female",36,30,29,29,28,152
"Horsham 009C","E01031680","25-29 years","Female",42,52,47,41,49,231
"Horsham 009C","E01031680","30-34 years","Female",25,29,40,36,32,162
"Horsham 009C","E01031680","35-39 years","Female",56,47,47,50,42,242
"Horsham 009C","E01031680","40-44 years","Female",41,57,47,49,47,241
"Horsham 009C","E01031680","45-49 years","Female",70,60,56,53,45,284
"Horsham 009C","E01031680","50-54 years","Female",106,113,111,92,86,508
"Horsham 009C","E01031680","55-59 years","Female",69,77,81,85,100,412
"Horsham 009C","E01031680","60-64 years","Female",40,45,60,68,70,283
"Horsham 009C","E01031680","65-69 years","Female",42,37,41,42,39,201
"Horsham 009C","E01031680","70-74 years","Female",26,39,38,42,52,197
"Horsham 009C","E01031680","75-79 years","Female",22,26,26,33,28,135
"Horsham 009C","E01031680","80-84 years","Female",5,6,10,14,17,52
"Horsham 009C","E01031680","85+ years","Female",10,12,11,11,9,53
"Horsham 009D","E01031681","0-4 years","Male",40,34,37,36,48,195
"Horsham 009D","E01031681","5-9 years","Male",55,69,68,60,56,308
"Horsham 009D","E01031681","10-14 years","Male",56,42,50,58,57,263
"Horsham 009D","E01031681","15-19 years","Male",53,53,51,45,43,245
"Horsham 009D","E01031681","20-24 years","Male",51,51,48,53,53,256
"Horsham 009D","E01031681","25-29 years","Male",50,61,68,81,79,339
"Horsham 009D","E01031681","30-34 years","Male",23,25,34,37,45,164
"Horsham 009D","E01031681","35-39 years","Male",51,47,46,49,52,245
"Horsham 009D","E01031681","40-44 years","Male",39,38,38,39,37,191
"Horsham 009D","E01031681","45-49 years","Male",67,63,60,59,61,310
"Horsham 009D","E01031681","50-54 years","Male",59,54,60,63,59,295
"Horsham 009D","E01031681","55-59 years","Male",54,56,57,56,55,278
"Horsham 009D","E01031681","60-64 years","Male",34,36,37,39,45,191
"Horsham 009D","E01031681","65-69 years","Male",32,28,26,40,39,165
"Horsham 009D","E01031681","70-74 years","Male",17,21,20,25,32,115
"Horsham 009D","E01031681","75-79 years","Male",22,20,28,32,30,132
"Horsham 009D","E01031681","80-84 years","Male",9,9,9,8,12,47
"Horsham 009D","E01031681","85+ years","Male",21,17,18,14,11,81
"Horsham 009D","E01031681","0-4 years","Female",29,38,41,56,73,237
"Horsham 009D","E01031681","5-9 years","Female",52,44,43,50,46,235
"Horsham 009D","E01031681","10-14 years","Female",40,42,45,45,51,223
"Horsham 009D","E01031681","15-19 years","Female",44,41,39,43,38,205
"Horsham 009D","E01031681","20-24 years","Female",48,46,37,38,42,211
"Horsham 009D","E01031681","25-29 years","Female",31,30,34,35,45,175
"Horsham 009D","E01031681","30-34 years","Female",53,51,61,71,71,307
"Horsham 009D","E01031681","35-39 years","Female",44,43,40,45,52,224
"Horsham 009D","E01031681","40-44 years","Female",63,59,59,59,64,304
"Horsham 009D","E01031681","45-49 years","Female",74,66,66,61,62,329
"Horsham 009D","E01031681","50-54 years","Female",58,63,65,74,64,324
"Horsham 009D","E01031681","55-59 years","Female",42,49,46,56,70,263
"Horsham 009D","E01031681","60-64 years","Female",34,26,33,43,50,186
"Horsham 009D","E01031681","65-69 years","Female",32,28,27,30,30,147
"Horsham 009D","E01031681","70-74 years","Female",24,28,31,34,33,150
"Horsham 009D","E01031681","75-79 years","Female",17,19,20,25,33,114
"Horsham 009D","E01031681","80-84 years","Female",21,17,19,17,17,91
"Horsham 009D","E01031681","85+ years","Female",7,8,7,4,5,31
"Horsham 009E","E01031682","0-4 years","Male",33,34,26,23,20,136
"Horsham 009E","E01031682","5-9 years","Male",52,44,50,54,45,245
"Horsham 009E","E01031682","10-14 years","Male",44,45,40,42,45,216
"Horsham 009E","E01031682","15-19 years","Male",31,30,35,35,28,159
"Horsham 009E","E01031682","20-24 years","Male",20,20,23,22,25,110
"Horsham 009E","E01031682","25-29 years","Male",48,49,40,38,38,213
"Horsham 009E","E01031682","30-34 years","Male",23,27,25,28,31,134
"Horsham 009E","E01031682","35-39 years","Male",23,14,23,22,24,106
"Horsham 009E","E01031682","40-44 years","Male",54,54,43,38,33,222
"Horsham 009E","E01031682","45-49 years","Male",55,54,47,50,49,255
"Horsham 009E","E01031682","50-54 years","Male",58,60,61,59,56,294
"Horsham 009E","E01031682","55-59 years","Male",38,36,41,37,43,195
"Horsham 009E","E01031682","60-64 years","Male",22,28,32,36,37,155
"Horsham 009E","E01031682","65-69 years","Male",31,24,21,20,21,117
"Horsham 009E","E01031682","70-74 years","Male",8,13,20,22,24,87
"Horsham 009E","E01031682","75-79 years","Male",11,9,5,2,2,29
"Horsham 009E","E01031682","80-84 years","Male",7,5,10,10,14,46
"Horsham 009E","E01031682","85+ years","Male",5,6,5,5,7,28
"Horsham 009E","E01031682","0-4 years","Female",24,19,21,23,21,108
"Horsham 009E","E01031682","5-9 years","Female",44,33,34,29,27,167
"Horsham 009E","E01031682","10-14 years","Female",38,42,40,42,38,200
"Horsham 009E","E01031682","15-19 years","Female",35,42,36,45,42,200
"Horsham 009E","E01031682","20-24 years","Female",40,33,28,24,37,162
"Horsham 009E","E01031682","25-29 years","Female",22,26,30,30,32,140
"Horsham 009E","E01031682","30-34 years","Female",34,37,38,37,35,181
"Horsham 009E","E01031682","35-39 years","Female",40,35,37,31,31,174
"Horsham 009E","E01031682","40-44 years","Female",57,54,54,45,41,251
"Horsham 009E","E01031682","45-49 years","Female",81,72,59,64,64,340
"Horsham 009E","E01031682","50-54 years","Female",48,52,56,52,56,264
"Horsham 009E","E01031682","55-59 years","Female",48,58,55,67,71,299
"Horsham 009E","E01031682","60-64 years","Female",23,19,25,24,31,122
"Horsham 009E","E01031682","65-69 years","Female",33,35,27,29,33,157
"Horsham 009E","E01031682","70-74 years","Female",9,10,21,24,24,88
"Horsham 009E","E01031682","75-79 years","Female",7,7,7,5,4,30
"Horsham 009E","E01031682","80-84 years","Female",10,9,9,12,11,51
"Horsham 009E","E01031682","85+ years","Female",10,12,11,12,16,61
"Horsham 009F","E01031683","0-4 years","Male",53,58,49,49,47,256
"Horsham 009F","E01031683","5-9 years","Male",61,59,54,46,51,271
"Horsham 009F","E01031683","10-14 years","Male",43,42,47,47,51,230
"Horsham 009F","E01031683","15-19 years","Male",34,35,39,45,32,185
"Horsham 009F","E01031683","20-24 years","Male",45,41,38,29,32,185
"Horsham 009F","E01031683","25-29 years","Male",56,62,65,67,65,315
"Horsham 009F","E01031683","30-34 years","Male",53,51,52,60,59,275
"Horsham 009F","E01031683","35-39 years","Male",74,75,63,49,46,307
"Horsham 009F","E01031683","40-44 years","Male",50,51,53,49,51,254
"Horsham 009F","E01031683","45-49 years","Male",61,56,53,59,60,289
"Horsham 009F","E01031683","50-54 years","Male",59,66,67,62,54,308
"Horsham 009F","E01031683","55-59 years","Male",50,56,51,60,64,281
"Horsham 009F","E01031683","60-64 years","Male",47,42,41,38,40,208
"Horsham 009F","E01031683","65-69 years","Male",32,38,37,41,42,190
"Horsham 009F","E01031683","70-74 years","Male",26,26,31,30,35,148
"Horsham 009F","E01031683","75-79 years","Male",9,7,10,10,9,45
"Horsham 009F","E01031683","80-84 years","Male",8,9,11,12,12,52
"Horsham 009F","E01031683","85+ years","Male",12,14,10,8,11,55
"Horsham 009F","E01031683","0-4 years","Female",47,43,45,35,36,206
"Horsham 009F","E01031683","5-9 years","Female",56,61,59,56,50,282
"Horsham 009F","E01031683","10-14 years","Female",37,40,41,46,46,210
"Horsham 009F","E01031683","15-19 years","Female",35,25,25,22,26,133
"Horsham 009F","E01031683","20-24 years","Female",31,36,29,31,29,156
"Horsham 009F","E01031683","25-29 years","Female",55,49,44,39,39,226
"Horsham 009F","E01031683","30-34 years","Female",62,60,63,61,60,306
"Horsham 009F","E01031683","35-39 years","Female",82,69,64,64,60,339
"Horsham 009F","E01031683","40-44 years","Female",56,65,72,70,70,333
"Horsham 009F","E01031683","45-49 years","Female",57,58,53,44,44,256
"Horsham 009F","E01031683","50-54 years","Female",58,52,45,53,57,265
"Horsham 009F","E01031683","55-59 years","Female",48,51,59,60,58,276
"Horsham 009F","E01031683","60-64 years","Female",42,42,46,46,45,221
"Horsham 009F","E01031683","65-69 years","Female",38,33,31,27,33,162
"Horsham 009F","E01031683","70-74 years","Female",32,35,39,44,47,197
"Horsham 009F","E01031683","75-79 years","Female",11,14,10,14,13,62
"Horsham 009F","E01031683","80-84 years","Female",15,11,11,15,10,62
"Horsham 009F","E01031683","85+ years","Female",12,13,15,12,14,66
"Horsham 010A","E01031611","0-4 years","Male",25,22,25,40,59,171
"Horsham 010A","E01031611","5-9 years","Male",41,41,47,55,56,240
"Horsham 010A","E01031611","10-14 years","Male",46,62,64,64,82,318
"Horsham 010A","E01031611","15-19 years","Male",48,53,49,50,56,256
"Horsham 010A","E01031611","20-24 years","Male",48,50,56,55,55,264
"Horsham 010A","E01031611","25-29 years","Male",46,48,47,56,69,266
"Horsham 010A","E01031611","30-34 years","Male",20,24,22,35,44,145
"Horsham 010A","E01031611","35-39 years","Male",29,28,40,47,53,197
"Horsham 010A","E01031611","40-44 years","Male",41,40,35,48,61,225
"Horsham 010A","E01031611","45-49 years","Male",72,73,66,66,66,343
"Horsham 010A","E01031611","50-54 years","Male",89,97,88,87,89,450
"Horsham 010A","E01031611","55-59 years","Male",86,85,84,84,93,432
"Horsham 010A","E01031611","60-64 years","Male",70,67,76,86,104,403
"Horsham 010A","E01031611","65-69 years","Male",62,65,66,59,55,307
"Horsham 010A","E01031611","70-74 years","Male",67,72,88,102,102,431
"Horsham 010A","E01031611","75-79 years","Male",29,32,42,47,53,203
"Horsham 010A","E01031611","80-84 years","Male",21,23,24,26,27,121
"Horsham 010A","E01031611","85+ years","Male",10,9,10,11,15,55
"Horsham 010A","E01031611","0-4 years","Female",35,31,30,44,66,206
"Horsham 010A","E01031611","5-9 years","Female",39,32,37,52,57,217
"Horsham 010A","E01031611","10-14 years","Female",50,66,59,66,77,318
"Horsham 010A","E01031611","15-19 years","Female",47,44,44,47,48,230
"Horsham 010A","E01031611","20-24 years","Female",36,36,32,36,46,186
"Horsham 010A","E01031611","25-29 years","Female",23,23,25,29,40,140
"Horsham 010A","E01031611","30-34 years","Female",28,24,30,45,64,191
"Horsham 010A","E01031611","35-39 years","Female",49,50,51,65,82,297
"Horsham 010A","E01031611","40-44 years","Female",52,62,58,68,74,314
"Horsham 010A","E01031611","45-49 years","Female",75,71,67,70,79,362
"Horsham 010A","E01031611","50-54 years","Female",96,107,107,111,99,520
"Horsham 010A","E01031611","55-59 years","Female",70,79,74,73,93,389
"Horsham 010A","E01031611","60-64 years","Female",69,56,70,72,76,343
"Horsham 010A","E01031611","65-69 years","Female",59,71,70,75,87,362
"Horsham 010A","E01031611","70-74 years","Female",45,41,50,56,60,252
"Horsham 010A","E01031611","75-79 years","Female",45,50,57,62,62,276
"Horsham 010A","E01031611","80-84 years","Female",18,23,23,26,30,120
"Horsham 010A","E01031611","85+ years","Female",14,15,13,12,13,67
"Horsham 010B","E01031612","0-4 years","Male",64,58,57,49,53,281
"Horsham 010B","E01031612","5-9 years","Male",70,63,52,49,47,281
"Horsham 010B","E01031612","10-14 years","Male",77,74,75,76,82,384
"Horsham 010B","E01031612","15-19 years","Male",41,42,50,54,58,245
"Horsham 010B","E01031612","20-24 years","Male",26,33,29,30,27,145
"Horsham 010B","E01031612","25-29 years","Male",50,38,43,44,41,216
"Horsham 010B","E01031612","30-34 years","Male",48,47,45,38,38,216
"Horsham 010B","E01031612","35-39 years","Male",75,76,67,64,61,343
"Horsham 010B","E01031612","40-44 years","Male",72,56,55,55,52,290
"Horsham 010B","E01031612","45-49 years","Male",77,86,80,79,83,405
"Horsham 010B","E01031612","50-54 years","Male",88,92,100,95,98,473
"Horsham 010B","E01031612","55-59 years","Male",67,71,65,66,69,338
"Horsham 010B","E01031612","60-64 years","Male",56,54,56,59,66,291
"Horsham 010B","E01031612","65-69 years","Male",54,60,61,59,50,284
"Horsham 010B","E01031612","70-74 years","Male",52,49,52,56,57,266
"Horsham 010B","E01031612","75-79 years","Male",32,29,26,33,35,155
"Horsham 010B","E01031612","80-84 years","Male",32,39,42,35,30,178
"Horsham 010B","E01031612","85+ years","Male",11,12,11,12,17,63
"Horsham 010B","E01031612","0-4 years","Female",61,57,60,59,60,297
"Horsham 010B","E01031612","5-9 years","Female",75,75,66,56,53,325
"Horsham 010B","E01031612","10-14 years","Female",50,56,56,63,54,279
"Horsham 010B","E01031612","15-19 years","Female",62,58,55,44,50,269
"Horsham 010B","E01031612","20-24 years","Female",32,27,23,31,33,146
"Horsham 010B","E01031612","25-29 years","Female",22,25,28,29,33,137
"Horsham 010B","E01031612","30-34 years","Female",60,49,49,46,48,252
"Horsham 010B","E01031612","35-39 years","Female",93,91,93,83,71,431
"Horsham 010B","E01031612","40-44 years","Female",80,83,79,72,71,385
"Horsham 010B","E01031612","45-49 years","Female",87,78,66,76,90,397
"Horsham 010B","E01031612","50-54 years","Female",75,81,93,89,90,428
"Horsham 010B","E01031612","55-59 years","Female",54,64,63,67,68,316
"Horsham 010B","E01031612","60-64 years","Female",60,55,61,63,57,296
"Horsham 010B","E01031612","65-69 years","Female",64,62,55,53,53,287
"Horsham 010B","E01031612","70-74 years","Female",40,44,44,44,44,216
"Horsham 010B","E01031612","75-79 years","Female",37,35,37,33,32,174
"Horsham 010B","E01031612","80-84 years","Female",26,32,31,29,31,149
"Horsham 010B","E01031612","85+ years","Female",6,6,8,10,9,39
"Horsham 010C","E01031613","0-4 years","Male",94,104,118,124,141,581
"Horsham 010C","E01031613","5-9 years","Male",101,88,98,99,104,490
"Horsham 010C","E01031613","10-14 years","Male",88,102,108,113,120,531
"Horsham 010C","E01031613","15-19 years","Male",97,92,88,99,75,451
"Horsham 010C","E01031613","20-24 years","Male",45,38,46,39,45,213
"Horsham 010C","E01031613","25-29 years","Male",44,53,53,50,51,251
"Horsham 010C","E01031613","30-34 years","Male",58,78,80,77,74,367
"Horsham 010C","E01031613","35-39 years","Male",67,71,90,101,102,431
"Horsham 010C","E01031613","40-44 years","Male",109,106,94,89,91,489
"Horsham 010C","E01031613","45-49 years","Male",133,126,130,133,128,650
"Horsham 010C","E01031613","50-54 years","Male",81,96,102,106,112,497
"Horsham 010C","E01031613","55-59 years","Male",86,91,92,99,106,474
"Horsham 010C","E01031613","60-64 years","Male",58,64,57,64,66,309
"Horsham 010C","E01031613","65-69 years","Male",70,63,71,61,68,333
"Horsham 010C","E01031613","70-74 years","Male",57,68,69,67,57,318
"Horsham 010C","E01031613","75-79 years","Male",55,53,51,47,57,263
"Horsham 010C","E01031613","80-84 years","Male",18,16,19,24,24,101
"Horsham 010C","E01031613","85+ years","Male",25,28,23,29,34,139
"Horsham 010C","E01031613","0-4 years","Female",94,86,103,108,102,493
"Horsham 010C","E01031613","5-9 years","Female",103,118,120,123,120,584
"Horsham 010C","E01031613","10-14 years","Female",99,95,110,108,107,519
"Horsham 010C","E01031613","15-19 years","Female",54,67,67,66,70,324
"Horsham 010C","E01031613","20-24 years","Female",58,58,55,69,74,314
"Horsham 010C","E01031613","25-29 years","Female",61,65,74,72,73,345
"Horsham 010C","E01031613","30-34 years","Female",64,73,74,77,75,363
"Horsham 010C","E01031613","35-39 years","Female",93,98,105,112,102,510
"Horsham 010C","E01031613","40-44 years","Female",110,110,99,106,120,545
"Horsham 010C","E01031613","45-49 years","Female",134,121,124,122,113,614
"Horsham 010C","E01031613","50-54 years","Female",81,93,107,112,119,512
"Horsham 010C","E01031613","55-59 years","Female",97,103,110,107,110,527
"Horsham 010C","E01031613","60-64 years","Female",70,75,76,79,89,389
"Horsham 010C","E01031613","65-69 years","Female",56,56,63,65,71,311
"Horsham 010C","E01031613","70-74 years","Female",79,79,83,71,73,385
"Horsham 010C","E01031613","75-79 years","Female",37,36,34,55,48,210
"Horsham 010C","E01031613","80-84 years","Female",29,31,39,39,41,179
"Horsham 010C","E01031613","85+ years","Female",19,24,28,25,31,127
"Horsham 010D","E01031614","0-4 years","Male",69,77,63,65,78,352
"Horsham 010D","E01031614","5-9 years","Male",118,116,116,118,111,579
"Horsham 010D","E01031614","10-14 years","Male",93,93,88,88,78,440
"Horsham 010D","E01031614","15-19 years","Male",82,80,82,79,76,399
"Horsham 010D","E01031614","20-24 years","Male",56,58,56,58,52,280
"Horsham 010D","E01031614","25-29 years","Male",54,56,53,49,58,270
"Horsham 010D","E01031614","30-34 years","Male",58,62,68,75,80,343
"Horsham 010D","E01031614","35-39 years","Male",68,67,61,60,54,310
"Horsham 010D","E01031614","40-44 years","Male",104,94,87,82,81,448
"Horsham 010D","E01031614","45-49 years","Male",87,92,90,91,82,442
"Horsham 010D","E01031614","50-54 years","Male",76,75,79,94,104,428
"Horsham 010D","E01031614","55-59 years","Male",61,72,82,82,78,375
"Horsham 010D","E01031614","60-64 years","Male",55,50,46,52,58,261
"Horsham 010D","E01031614","65-69 years","Male",54,60,61,57,51,283
"Horsham 010D","E01031614","70-74 years","Male",27,24,26,36,45,158
"Horsham 010D","E01031614","75-79 years","Male",34,37,31,33,30,165
"Horsham 010D","E01031614","80-84 years","Male",19,26,22,24,24,115
"Horsham 010D","E01031614","85+ years","Male",42,39,39,40,37,197
"Horsham 010D","E01031614","0-4 years","Female",82,71,64,65,76,358
"Horsham 010D","E01031614","5-9 years","Female",57,66,67,68,66,324
"Horsham 010D","E01031614","10-14 years","Female",70,64,74,67,63,338
"Horsham 010D","E01031614","15-19 years","Female",76,70,52,60,59,317
"Horsham 010D","E01031614","20-24 years","Female",59,61,58,57,60,295
"Horsham 010D","E01031614","25-29 years","Female",50,60,61,66,69,306
"Horsham 010D","E01031614","30-34 years","Female",87,86,75,69,85,402
"Horsham 010D","E01031614","35-39 years","Female",90,84,88,94,93,449
"Horsham 010D","E01031614","40-44 years","Female",99,92,89,79,81,440
"Horsham 010D","E01031614","45-49 years","Female",97,108,103,105,104,517
"Horsham 010D","E01031614","50-54 years","Female",80,81,94,105,92,452
"Horsham 010D","E01031614","55-59 years","Female",47,52,57,57,76,289
"Horsham 010D","E01031614","60-64 years","Female",57,58,58,50,46,269
"Horsham 010D","E01031614","65-69 years","Female",53,47,47,52,56,255
"Horsham 010D","E01031614","70-74 years","Female",46,53,43,51,49,242
"Horsham 010D","E01031614","75-79 years","Female",55,46,50,58,72,281
"Horsham 010D","E01031614","80-84 years","Female",43,48,47,33,34,205
"Horsham 010D","E01031614","85+ years","Female",94,87,85,91,87,444
"Horsham 010E","E01031615","0-4 years","Male",55,61,51,43,50,260
"Horsham 010E","E01031615","5-9 years","Male",27,26,34,42,42,171
"Horsham 010E","E01031615","10-14 years","Male",44,47,46,41,35,213
"Horsham 010E","E01031615","15-19 years","Male",35,37,36,43,53,204
"Horsham 010E","E01031615","20-24 years","Male",33,41,43,35,32,184
"Horsham 010E","E01031615","25-29 years","Male",32,25,25,27,33,142
"Horsham 010E","E01031615","30-34 years","Male",33,33,34,35,35,170
"Horsham 010E","E01031615","35-39 years","Male",48,57,51,45,35,236
"Horsham 010E","E01031615","40-44 years","Male",47,51,55,56,51,260
"Horsham 010E","E01031615","45-49 years","Male",69,63,67,60,65,324
"Horsham 010E","E01031615","50-54 years","Male",68,62,58,63,72,323
"Horsham 010E","E01031615","55-59 years","Male",46,52,55,63,58,274
"Horsham 010E","E01031615","60-64 years","Male",46,50,51,49,53,249
"Horsham 010E","E01031615","65-69 years","Male",55,46,44,34,28,207
"Horsham 010E","E01031615","70-74 years","Male",41,49,50,65,66,271
"Horsham 010E","E01031615","75-79 years","Male",37,27,23,24,27,138
"Horsham 010E","E01031615","80-84 years","Male",35,33,34,32,32,166
"Horsham 010E","E01031615","85+ years","Male",28,33,34,37,37,169
"Horsham 010E","E01031615","0-4 years","Female",42,40,35,38,36,191
"Horsham 010E","E01031615","5-9 years","Female",50,52,51,55,54,262
"Horsham 010E","E01031615","10-14 years","Female",43,46,55,53,50,247
"Horsham 010E","E01031615","15-19 years","Female",32,35,29,26,25,147
"Horsham 010E","E01031615","20-24 years","Female",28,24,29,30,37,148
"Horsham 010E","E01031615","25-29 years","Female",23,23,25,23,25,119
"Horsham 010E","E01031615","30-34 years","Female",56,51,41,45,53,246
"Horsham 010E","E01031615","35-39 years","Female",39,43,44,40,42,208
"Horsham 010E","E01031615","40-44 years","Female",48,47,41,53,48,237
"Horsham 010E","E01031615","45-49 years","Female",61,63,69,63,70,326
"Horsham 010E","E01031615","50-54 years","Female",51,52,55,53,50,261
"Horsham 010E","E01031615","55-59 years","Female",49,51,52,55,59,266
"Horsham 010E","E01031615","60-64 years","Female",57,60,58,45,49,269
"Horsham 010E","E01031615","65-69 years","Female",63,68,55,61,57,304
"Horsham 010E","E01031615","70-74 years","Female",69,60,63,56,58,306
"Horsham 010E","E01031615","75-79 years","Female",34,41,47,54,59,235
"Horsham 010E","E01031615","80-84 years","Female",43,40,39,42,42,206
"Horsham 010E","E01031615","85+ years","Female",45,49,53,51,52,250
"Horsham 011A","E01031632","0-4 years","Male",29,19,23,25,21,117
"Horsham 011A","E01031632","5-9 years","Male",50,50,46,50,51,247
"Horsham 011A","E01031632","10-14 years","Male",43,47,52,47,42,231
"Horsham 011A","E01031632","15-19 years","Male",48,45,46,44,53,236
"Horsham 011A","E01031632","20-24 years","Male",41,45,42,39,37,204
"Horsham 011A","E01031632","25-29 years","Male",23,26,27,27,32,135
"Horsham 011A","E01031632","30-34 years","Male",20,21,25,27,27,120
"Horsham 011A","E01031632","35-39 years","Male",47,42,35,33,36,193
"Horsham 011A","E01031632","40-44 years","Male",58,50,58,49,44,259
"Horsham 011A","E01031632","45-49 years","Male",76,72,57,56,61,322
"Horsham 011A","E01031632","50-54 years","Male",77,83,78,88,77,403
"Horsham 011A","E01031632","55-59 years","Male",63,64,66,71,82,346
"Horsham 011A","E01031632","60-64 years","Male",71,75,76,71,70,363
"Horsham 011A","E01031632","65-69 years","Male",68,67,63,70,72,340
"Horsham 011A","E01031632","70-74 years","Male",52,49,57,51,56,265
"Horsham 011A","E01031632","75-79 years","Male",39,48,52,56,63,258
"Horsham 011A","E01031632","80-84 years","Male",18,13,20,24,25,100
"Horsham 011A","E01031632","85+ years","Male",5,7,7,7,8,34
"Horsham 011A","E01031632","0-4 years","Female",30,27,25,20,15,117
"Horsham 011A","E01031632","5-9 years","Female",41,42,45,45,40,213
"Horsham 011A","E01031632","10-14 years","Female",46,46,50,46,41,229
"Horsham 011A","E01031632","15-19 years","Female",42,42,39,39,35,197
"Horsham 011A","E01031632","20-24 years","Female",27,23,23,22,22,117
"Horsham 011A","E01031632","25-29 years","Female",30,27,32,31,26,146
"Horsham 011A","E01031632","30-34 years","Female",31,31,31,34,41,168
"Horsham 011A","E01031632","35-39 years","Female",30,26,30,32,38,156
"Horsham 011A","E01031632","40-44 years","Female",57,50,55,53,44,259
"Horsham 011A","E01031632","45-49 years","Female",71,69,69,67,62,338
"Horsham 011A","E01031632","50-54 years","Female",63,79,73,60,59,334
"Horsham 011A","E01031632","55-59 years","Female",75,80,78,85,79,397
"Horsham 011A","E01031632","60-64 years","Female",67,76,75,87,84,389
"Horsham 011A","E01031632","65-69 years","Female",64,64,58,48,59,293
"Horsham 011A","E01031632","70-74 years","Female",36,42,49,57,62,246
"Horsham 011A","E01031632","75-79 years","Female",18,16,20,25,24,103
"Horsham 011A","E01031632","80-84 years","Female",9,10,10,11,15,55
"Horsham 011A","E01031632","85+ years","Female",10,13,10,13,13,59
"Horsham 011B","E01031633","0-4 years","Male",26,23,23,23,22,117
"Horsham 011B","E01031633","5-9 years","Male",37,34,30,29,30,160
"Horsham 011B","E01031633","10-14 years","Male",42,43,46,43,43,217
"Horsham 011B","E01031633","15-19 years","Male",48,41,39,31,33,192
"Horsham 011B","E01031633","20-24 years","Male",23,25,30,28,25,131
"Horsham 011B","E01031633","25-29 years","Male",21,19,22,18,18,98
"Horsham 011B","E01031633","30-34 years","Male",19,20,17,17,21,94
"Horsham 011B","E01031633","35-39 years","Male",21,24,25,25,22,117
"Horsham 011B","E01031633","40-44 years","Male",32,23,24,21,23,123
"Horsham 011B","E01031633","45-49 years","Male",51,50,48,51,42,242
"Horsham 011B","E01031633","50-54 years","Male",73,58,57,51,62,301
"Horsham 011B","E01031633","55-59 years","Male",52,69,72,74,68,335
"Horsham 011B","E01031633","60-64 years","Male",42,45,45,54,56,242
"Horsham 011B","E01031633","65-69 years","Male",55,62,59,50,48,274
"Horsham 011B","E01031633","70-74 years","Male",57,51,62,67,62,299
"Horsham 011B","E01031633","75-79 years","Male",26,27,30,28,41,152
"Horsham 011B","E01031633","80-84 years","Male",20,19,21,24,19,103
"Horsham 011B","E01031633","85+ years","Male",16,20,21,22,26,105
"Horsham 011B","E01031633","0-4 years","Female",30,24,29,24,33,140
"Horsham 011B","E01031633","5-9 years","Female",47,54,51,54,48,254
"Horsham 011B","E01031633","10-14 years","Female",28,25,27,26,27,133
"Horsham 011B","E01031633","15-19 years","Female",28,21,18,10,14,91
"Horsham 011B","E01031633","20-24 years","Female",20,20,18,14,12,84
"Horsham 011B","E01031633","25-29 years","Female",19,22,21,20,20,102
"Horsham 011B","E01031633","30-34 years","Female",14,16,19,19,20,88
"Horsham 011B","E01031633","35-39 years","Female",37,30,30,27,24,148
"Horsham 011B","E01031633","40-44 years","Female",34,23,20,21,24,122
"Horsham 011B","E01031633","45-49 years","Female",56,66,64,66,63,315
"Horsham 011B","E01031633","50-54 years","Female",80,76,77,81,70,384
"Horsham 011B","E01031633","55-59 years","Female",51,51,48,48,61,259
"Horsham 011B","E01031633","60-64 years","Female",57,60,62,65,61,305
"Horsham 011B","E01031633","65-69 years","Female",51,52,49,51,49,252
"Horsham 011B","E01031633","70-74 years","Female",37,34,42,43,47,203
"Horsham 011B","E01031633","75-79 years","Female",42,41,47,49,46,225
"Horsham 011B","E01031633","80-84 years","Female",21,27,29,23,33,133
"Horsham 011B","E01031633","85+ years","Female",14,16,17,25,18,90
"Horsham 011C","E01031634","0-4 years","Male",40,36,35,28,26,165
"Horsham 011C","E01031634","5-9 years","Male",30,35,34,40,40,179
"Horsham 011C","E01031634","10-14 years","Male",37,35,34,32,38,176
"Horsham 011C","E01031634","15-19 years","Male",39,34,36,35,30,174
"Horsham 011C","E01031634","20-24 years","Male",21,21,23,24,24,113
"Horsham 011C","E01031634","25-29 years","Male",34,40,53,49,54,230
"Horsham 011C","E01031634","30-34 years","Male",28,24,29,29,32,142
"Horsham 011C","E01031634","35-39 years","Male",25,24,26,26,28,129
"Horsham 011C","E01031634","40-44 years","Male",35,37,28,29,32,161
"Horsham 011C","E01031634","45-49 years","Male",49,46,49,44,47,235
"Horsham 011C","E01031634","50-54 years","Male",56,54,60,56,46,272
"Horsham 011C","E01031634","55-59 years","Male",44,40,38,40,44,206
"Horsham 011C","E01031634","60-64 years","Male",33,38,43,39,44,197
"Horsham 011C","E01031634","65-69 years","Male",37,40,38,34,34,183
"Horsham 011C","E01031634","70-74 years","Male",32,35,36,43,40,186
"Horsham 011C","E01031634","75-79 years","Male",13,15,17,19,18,82
"Horsham 011C","E01031634","80-84 years","Male",17,16,18,12,10,73
"Horsham 011C","E01031634","85+ years","Male",14,14,13,14,13,68
"Horsham 011C","E01031634","0-4 years","Female",21,20,17,24,36,118
"Horsham 011C","E01031634","5-9 years","Female",29,25,32,29,27,142
"Horsham 011C","E01031634","10-14 years","Female",35,31,36,35,34,171
"Horsham 011C","E01031634","15-19 years","Female",38,41,44,44,42,209
"Horsham 011C","E01031634","20-24 years","Female",43,40,40,32,36,191
"Horsham 011C","E01031634","25-29 years","Female",27,27,35,35,40,164
"Horsham 011C","E01031634","30-34 years","Female",25,28,40,42,41,176
"Horsham 011C","E01031634","35-39 years","Female",43,33,25,28,25,154
"Horsham 011C","E01031634","40-44 years","Female",26,35,36,34,39,170
"Horsham 011C","E01031634","45-49 years","Female",48,43,38,39,38,206
"Horsham 011C","E01031634","50-54 years","Female",67,61,65,57,55,305
"Horsham 011C","E01031634","55-59 years","Female",44,51,51,49,52,247
"Horsham 011C","E01031634","60-64 years","Female",38,38,46,49,54,225
"Horsham 011C","E01031634","65-69 years","Female",32,29,31,33,42,167
"Horsham 011C","E01031634","70-74 years","Female",29,36,37,34,28,164
"Horsham 011C","E01031634","75-79 years","Female",27,23,18,25,31,124
"Horsham 011C","E01031634","80-84 years","Female",29,25,23,26,29,132
"Horsham 011C","E01031634","85+ years","Female",58,60,67,64,50,299
"Horsham 011D","E01031635","0-4 years","Male",34,36,32,34,30,166
"Horsham 011D","E01031635","5-9 years","Male",45,46,41,37,35,204
"Horsham 011D","E01031635","10-14 years","Male",50,53,58,54,54,269
"Horsham 011D","E01031635","15-19 years","Male",23,25,26,25,32,131
"Horsham 011D","E01031635","20-24 years","Male",34,33,26,23,21,137
"Horsham 011D","E01031635","25-29 years","Male",36,32,33,39,37,177
"Horsham 011D","E01031635","30-34 years","Male",46,41,44,36,38,205
"Horsham 011D","E01031635","35-39 years","Male",43,41,43,38,31,196
"Horsham 011D","E01031635","40-44 years","Male",45,40,33,26,26,170
"Horsham 011D","E01031635","45-49 years","Male",52,48,54,57,59,270
"Horsham 011D","E01031635","50-54 years","Male",64,68,57,52,45,286
"Horsham 011D","E01031635","55-59 years","Male",54,42,48,52,54,250
"Horsham 011D","E01031635","60-64 years","Male",44,52,50,50,53,249
"Horsham 011D","E01031635","65-69 years","Male",39,33,35,36,33,176
"Horsham 011D","E01031635","70-74 years","Male",39,37,34,42,48,200
"Horsham 011D","E01031635","75-79 years","Male",22,25,27,29,30,133
"Horsham 011D","E01031635","80-84 years","Male",13,16,18,18,15,80
"Horsham 011D","E01031635","85+ years","Male",9,11,13,9,12,54
"Horsham 011D","E01031635","0-4 years","Female",31,39,32,35,29,166
"Horsham 011D","E01031635","5-9 years","Female",30,33,37,30,32,162
"Horsham 011D","E01031635","10-14 years","Female",49,42,31,30,33,185
"Horsham 011D","E01031635","15-19 years","Female",39,38,40,41,35,193
"Horsham 011D","E01031635","20-24 years","Female",28,22,18,16,19,103
"Horsham 011D","E01031635","25-29 years","Female",41,35,49,46,41,212
"Horsham 011D","E01031635","30-34 years","Female",43,45,44,38,44,214
"Horsham 011D","E01031635","35-39 years","Female",42,43,38,36,33,192
"Horsham 011D","E01031635","40-44 years","Female",67,63,61,59,57,307
"Horsham 011D","E01031635","45-49 years","Female",42,35,32,35,44,188
"Horsham 011D","E01031635","50-54 years","Female",71,63,56,52,51,293
"Horsham 011D","E01031635","55-59 years","Female",62,62,70,71,65,330
"Horsham 011D","E01031635","60-64 years","Female",40,52,50,55,64,261
"Horsham 011D","E01031635","65-69 years","Female",37,40,39,32,31,179
"Horsham 011D","E01031635","70-74 years","Female",27,23,25,25,29,129
"Horsham 011D","E01031635","75-79 years","Female",22,22,18,27,31,120
"Horsham 011D","E01031635","80-84 years","Female",18,20,24,21,15,98
"Horsham 011D","E01031635","85+ years","Female",11,12,12,18,15,68
"Horsham 012A","E01031621","0-4 years","Male",10,9,8,6,6,39
"Horsham 012A","E01031621","5-9 years","Male",22,15,24,22,25,108
"Horsham 012A","E01031621","10-14 years","Male",23,25,23,21,23,115
"Horsham 012A","E01031621","15-19 years","Male",17,15,15,18,19,84
"Horsham 012A","E01031621","20-24 years","Male",19,15,17,17,12,80
"Horsham 012A","E01031621","25-29 years","Male",19,17,14,14,14,78
"Horsham 012A","E01031621","30-34 years","Male",17,17,15,15,12,76
"Horsham 012A","E01031621","35-39 years","Male",11,20,15,17,20,83
"Horsham 012A","E01031621","40-44 years","Male",11,12,15,15,7,60
"Horsham 012A","E01031621","45-49 years","Male",49,41,33,27,30,180
"Horsham 012A","E01031621","50-54 years","Male",60,61,65,62,56,304
"Horsham 012A","E01031621","55-59 years","Male",84,82,72,69,74,381
"Horsham 012A","E01031621","60-64 years","Male",74,72,72,81,73,372
"Horsham 012A","E01031621","65-69 years","Male",133,127,116,101,104,581
"Horsham 012A","E01031621","70-74 years","Male",102,102,116,121,118,559
"Horsham 012A","E01031621","75-79 years","Male",81,94,89,95,96,455
"Horsham 012A","E01031621","80-84 years","Male",45,54,61,61,72,293
"Horsham 012A","E01031621","85+ years","Male",53,54,57,56,61,281
"Horsham 012A","E01031621","0-4 years","Female",12,9,10,10,11,52
"Horsham 012A","E01031621","5-9 years","Female",15,20,18,13,9,75
"Horsham 012A","E01031621","10-14 years","Female",20,16,24,20,22,102
"Horsham 012A","E01031621","15-19 years","Female",28,32,32,33,22,147
"Horsham 012A","E01031621","20-24 years","Female",20,16,13,14,12,75
"Horsham 012A","E01031621","25-29 years","Female",9,9,8,6,5,37
"Horsham 012A","E01031621","30-34 years","Female",6,6,9,8,7,36
"Horsham 012A","E01031621","35-39 years","Female",18,16,14,12,15,75
"Horsham 012A","E01031621","40-44 years","Female",23,18,19,23,19,102
"Horsham 012A","E01031621","45-49 years","Female",38,42,48,34,38,200
"Horsham 012A","E01031621","50-54 years","Female",78,76,59,65,52,330
"Horsham 012A","E01031621","55-59 years","Female",71,67,66,67,72,343
"Horsham 012A","E01031621","60-64 years","Female",98,93,94,93,93,471
"Horsham 012A","E01031621","65-69 years","Female",122,118,127,130,116,613
"Horsham 012A","E01031621","70-74 years","Female",115,126,122,125,129,617
"Horsham 012A","E01031621","75-79 years","Female",84,89,94,89,104,460
"Horsham 012A","E01031621","80-84 years","Female",55,53,54,59,62,283
"Horsham 012A","E01031621","85+ years","Female",58,62,64,64,56,304
"Horsham 012B","E01031623","0-4 years","Male",25,23,19,23,19,109
"Horsham 012B","E01031623","5-9 years","Male",45,39,40,37,33,194
"Horsham 012B","E01031623","10-14 years","Male",46,49,47,43,47,232
"Horsham 012B","E01031623","15-19 years","Male",29,30,30,30,26,145
"Horsham 012B","E01031623","20-24 years","Male",34,28,29,30,34,155
"Horsham 012B","E01031623","25-29 years","Male",23,22,18,16,17,96
"Horsham 012B","E01031623","30-34 years","Male",27,23,23,21,20,114
"Horsham 012B","E01031623","35-39 years","Male",24,27,22,19,20,112
"Horsham 012B","E01031623","40-44 years","Male",41,34,34,33,29,171
"Horsham 012B","E01031623","45-49 years","Male",58,49,43,39,35,224
"Horsham 012B","E01031623","50-54 years","Male",69,62,67,71,80,349
"Horsham 012B","E01031623","55-59 years","Male",76,77,90,80,71,394
"Horsham 012B","E01031623","60-64 years","Male",75,74,78,86,91,404
"Horsham 012B","E01031623","65-69 years","Male",81,75,73,78,78,385
"Horsham 012B","E01031623","70-74 years","Male",87,99,89,93,85,453
"Horsham 012B","E01031623","75-79 years","Male",52,60,66,65,73,316
"Horsham 012B","E01031623","80-84 years","Male",31,30,33,40,42,176
"Horsham 012B","E01031623","85+ years","Male",35,41,34,35,36,181
"Horsham 012B","E01031623","0-4 years","Female",17,16,20,13,10,76
"Horsham 012B","E01031623","5-9 years","Female",28,24,22,23,29,126
"Horsham 012B","E01031623","10-14 years","Female",42,37,40,36,36,191
"Horsham 012B","E01031623","15-19 years","Female",40,36,36,37,37,186
"Horsham 012B","E01031623","20-24 years","Female",31,35,29,29,26,150
"Horsham 012B","E01031623","25-29 years","Female",19,19,21,14,13,86
"Horsham 012B","E01031623","30-34 years","Female",18,20,23,23,25,109
"Horsham 012B","E01031623","35-39 years","Female",35,26,26,28,22,137
"Horsham 012B","E01031623","40-44 years","Female",39,34,33,33,33,172
"Horsham 012B","E01031623","45-49 years","Female",52,54,53,47,44,250
"Horsham 012B","E01031623","50-54 years","Female",89,77,73,72,72,383
"Horsham 012B","E01031623","55-59 years","Female",73,82,89,95,90,429
"Horsham 012B","E01031623","60-64 years","Female",83,72,72,61,73,361
"Horsham 012B","E01031623","65-69 years","Female",83,80,69,84,79,395
"Horsham 012B","E01031623","70-74 years","Female",82,91,93,82,84,432
"Horsham 012B","E01031623","75-79 years","Female",57,56,63,66,60,302
"Horsham 012B","E01031623","80-84 years","Female",40,39,35,36,35,185
"Horsham 012B","E01031623","85+ years","Female",40,44,42,49,44,219
"Horsham 012C","E01031627","0-4 years","Male",31,38,37,34,30,170
"Horsham 012C","E01031627","5-9 years","Male",47,47,53,53,39,239
"Horsham 012C","E01031627","10-14 years","Male",36,44,46,51,51,228
"Horsham 012C","E01031627","15-19 years","Male",68,55,59,56,57,295
"Horsham 012C","E01031627","20-24 years","Male",39,44,41,29,34,187
"Horsham 012C","E01031627","25-29 years","Male",27,27,28,32,29,143
"Horsham 012C","E01031627","30-34 years","Male",19,23,15,23,26,106
"Horsham 012C","E01031627","35-39 years","Male",27,27,27,21,20,122
"Horsham 012C","E01031627","40-44 years","Male",33,28,33,42,41,177
"Horsham 012C","E01031627","45-49 years","Male",62,59,55,51,46,273
"Horsham 012C","E01031627","50-54 years","Male",81,84,70,78,80,393
"Horsham 012C","E01031627","55-59 years","Male",75,72,75,69,75,366
"Horsham 012C","E01031627","60-64 years","Male",66,67,73,69,68,343
"Horsham 012C","E01031627","65-69 years","Male",93,93,89,89,83,447
"Horsham 012C","E01031627","70-74 years","Male",83,93,95,95,104,470
"Horsham 012C","E01031627","75-79 years","Male",49,51,50,60,58,268
"Horsham 012C","E01031627","80-84 years","Male",36,35,39,39,34,183
"Horsham 012C","E01031627","85+ years","Male",41,40,46,45,49,221
"Horsham 012C","E01031627","0-4 years","Female",27,24,35,33,31,150
"Horsham 012C","E01031627","5-9 years","Female",33,34,34,34,32,167
"Horsham 012C","E01031627","10-14 years","Female",47,47,49,54,54,251
"Horsham 012C","E01031627","15-19 years","Female",59,58,51,45,47,260
"Horsham 012C","E01031627","20-24 years","Female",46,45,42,34,28,195
"Horsham 012C","E01031627","25-29 years","Female",18,21,27,23,28,117
"Horsham 012C","E01031627","30-34 years","Female",27,22,25,22,20,116
"Horsham 012C","E01031627","35-39 years","Female",30,42,40,39,34,185
"Horsham 012C","E01031627","40-44 years","Female",41,35,34,40,41,191
"Horsham 012C","E01031627","45-49 years","Female",76,69,68,63,58,334
"Horsham 012C","E01031627","50-54 years","Female",93,96,88,80,76,433
"Horsham 012C","E01031627","55-59 years","Female",64,68,68,85,91,376
"Horsham 012C","E01031627","60-64 years","Female",90,94,89,80,83,436
"Horsham 012C","E01031627","65-69 years","Female",100,94,85,94,87,460
"Horsham 012C","E01031627","70-74 years","Female",96,112,123,110,117,558
"Horsham 012C","E01031627","75-79 years","Female",55,57,60,62,66,300
"Horsham 012C","E01031627","80-84 years","Female",55,51,54,61,51,272
"Horsham 012C","E01031627","85+ years","Female",62,71,60,59,68,320
"Horsham 012D","E01031664","0-4 years","Male",26,24,24,26,20,120
"Horsham 012D","E01031664","5-9 years","Male",45,35,35,31,31,177
"Horsham 012D","E01031664","10-14 years","Male",43,54,51,57,58,263
"Horsham 012D","E01031664","15-19 years","Male",38,30,32,39,38,177
"Horsham 012D","E01031664","20-24 years","Male",22,25,27,28,27,129
"Horsham 012D","E01031664","25-29 years","Male",32,25,24,27,22,130
"Horsham 012D","E01031664","30-34 years","Male",20,21,20,18,18,97
"Horsham 012D","E01031664","35-39 years","Male",34,34,31,26,20,145
"Horsham 012D","E01031664","40-44 years","Male",40,40,39,44,38,201
"Horsham 012D","E01031664","45-49 years","Male",47,51,47,45,50,240
"Horsham 012D","E01031664","50-54 years","Male",62,65,62,63,59,311
"Horsham 012D","E01031664","55-59 years","Male",72,71,72,66,67,348
"Horsham 012D","E01031664","60-64 years","Male",63,69,67,63,76,338
"Horsham 012D","E01031664","65-69 years","Male",77,63,58,60,53,311
"Horsham 012D","E01031664","70-74 years","Male",66,79,88,78,80,391
"Horsham 012D","E01031664","75-79 years","Male",39,39,43,42,45,208
"Horsham 012D","E01031664","80-84 years","Male",33,31,31,34,30,159
"Horsham 012D","E01031664","85+ years","Male",32,35,32,31,29,159
"Horsham 012D","E01031664","0-4 years","Female",27,28,27,19,16,117
"Horsham 012D","E01031664","5-9 years","Female",30,31,28,37,37,163
"Horsham 012D","E01031664","10-14 years","Female",38,41,40,38,37,194
"Horsham 012D","E01031664","15-19 years","Female",28,24,23,22,24,121
"Horsham 012D","E01031664","20-24 years","Female",23,21,16,13,17,90
"Horsham 012D","E01031664","25-29 years","Female",20,21,28,27,24,120
"Horsham 012D","E01031664","30-34 years","Female",23,22,20,26,25,116
"Horsham 012D","E01031664","35-39 years","Female",25,22,28,28,23,126
"Horsham 012D","E01031664","40-44 years","Female",45,45,40,45,41,216
"Horsham 012D","E01031664","45-49 years","Female",59,52,57,47,45,260
"Horsham 012D","E01031664","50-54 years","Female",95,87,74,75,77,408
"Horsham 012D","E01031664","55-59 years","Female",68,73,81,80,84,386
"Horsham 012D","E01031664","60-64 years","Female",67,72,68,73,71,351
"Horsham 012D","E01031664","65-69 years","Female",71,73,67,55,66,332
"Horsham 012D","E01031664","70-74 years","Female",57,60,69,74,64,324
"Horsham 012D","E01031664","75-79 years","Female",43,39,43,44,51,220
"Horsham 012D","E01031664","80-84 years","Female",46,45,35,34,32,192
"Horsham 012D","E01031664","85+ years","Female",31,37,47,51,47,213
"Horsham 013A","E01031626","0-4 years","Male",40,39,36,36,31,182
"Horsham 013A","E01031626","5-9 years","Male",38,40,30,28,28,164
"Horsham 013A","E01031626","10-14 years","Male",41,40,38,31,36,186
"Horsham 013A","E01031626","15-19 years","Male",26,24,29,30,32,141
"Horsham 013A","E01031626","20-24 years","Male",35,32,29,27,27,150
"Horsham 013A","E01031626","25-29 years","Male",18,18,15,14,12,77
"Horsham 013A","E01031626","30-34 years","Male",15,20,26,29,31,121
"Horsham 013A","E01031626","35-39 years","Male",28,28,28,24,21,129
"Horsham 013A","E01031626","40-44 years","Male",46,39,37,37,37,196
"Horsham 013A","E01031626","45-49 years","Male",50,49,49,48,50,246
"Horsham 013A","E01031626","50-54 years","Male",44,50,52,54,51,251
"Horsham 013A","E01031626","55-59 years","Male",46,55,49,47,46,243
"Horsham 013A","E01031626","60-64 years","Male",64,53,47,47,53,264
"Horsham 013A","E01031626","65-69 years","Male",60,56,63,59,68,306
"Horsham 013A","E01031626","70-74 years","Male",78,89,87,91,74,419
"Horsham 013A","E01031626","75-79 years","Male",48,51,50,52,53,254
"Horsham 013A","E01031626","80-84 years","Male",34,38,45,43,51,211
"Horsham 013A","E01031626","85+ years","Male",23,27,31,35,38,154
"Horsham 013A","E01031626","0-4 years","Female",21,21,25,27,23,117
"Horsham 013A","E01031626","5-9 years","Female",52,52,40,37,34,215
"Horsham 013A","E01031626","10-14 years","Female",30,35,37,43,49,194
"Horsham 013A","E01031626","15-19 years","Female",34,29,24,20,24,131
"Horsham 013A","E01031626","20-24 years","Female",10,8,7,7,6,38
"Horsham 013A","E01031626","25-29 years","Female",30,31,33,26,15,135
"Horsham 013A","E01031626","30-34 years","Female",24,30,33,30,38,155
"Horsham 013A","E01031626","35-39 years","Female",62,65,60,49,35,271
"Horsham 013A","E01031626","40-44 years","Female",38,38,41,38,51,206
"Horsham 013A","E01031626","45-49 years","Female",47,46,41,42,42,218
"Horsham 013A","E01031626","50-54 years","Female",52,52,53,45,48,250
"Horsham 013A","E01031626","55-59 years","Female",71,83,80,90,73,397
"Horsham 013A","E01031626","60-64 years","Female",68,57,63,55,66,309
"Horsham 013A","E01031626","65-69 years","Female",78,78,73,78,76,383
"Horsham 013A","E01031626","70-74 years","Female",69,68,65,71,82,355
"Horsham 013A","E01031626","75-79 years","Female",47,46,57,56,53,259
"Horsham 013A","E01031626","80-84 years","Female",52,41,47,55,52,247
"Horsham 013A","E01031626","85+ years","Female",43,47,46,47,54,237
"Horsham 013B","E01031630","0-4 years","Male",30,33,41,38,34,176
"Horsham 013B","E01031630","5-9 years","Male",49,53,51,48,43,244
"Horsham 013B","E01031630","10-14 years","Male",39,34,38,43,49,203
"Horsham 013B","E01031630","15-19 years","Male",25,25,27,25,19,121
"Horsham 013B","E01031630","20-24 years","Male",31,27,29,32,26,145
"Horsham 013B","E01031630","25-29 years","Male",32,32,38,41,36,179
"Horsham 013B","E01031630","30-34 years","Male",30,20,20,23,23,116
"Horsham 013B","E01031630","35-39 years","Male",24,25,31,26,30,136
"Horsham 013B","E01031630","40-44 years","Male",47,49,47,47,42,232
"Horsham 013B","E01031630","45-49 years","Male",36,36,35,38,42,187
"Horsham 013B","E01031630","50-54 years","Male",41,43,40,45,46,215
"Horsham 013B","E01031630","55-59 years","Male",58,65,67,59,53,302
"Horsham 013B","E01031630","60-64 years","Male",68,66,63,66,57,320
"Horsham 013B","E01031630","65-69 years","Male",73,69,66,66,63,337
"Horsham 013B","E01031630","70-74 years","Male",56,67,78,82,92,375
"Horsham 013B","E01031630","75-79 years","Male",47,48,41,56,61,253
"Horsham 013B","E01031630","80-84 years","Male",40,42,46,42,47,217
"Horsham 013B","E01031630","85+ years","Male",30,27,27,28,36,148
"Horsham 013B","E01031630","0-4 years","Female",44,41,42,27,22,176
"Horsham 013B","E01031630","5-9 years","Female",40,36,29,37,34,176
"Horsham 013B","E01031630","10-14 years","Female",28,28,31,27,29,143
"Horsham 013B","E01031630","15-19 years","Female",39,34,32,27,27,159
"Horsham 013B","E01031630","20-24 years","Female",25,25,23,27,26,126
"Horsham 013B","E01031630","25-29 years","Female",24,28,30,28,28,138
"Horsham 013B","E01031630","30-34 years","Female",36,29,29,32,29,155
"Horsham 013B","E01031630","35-39 years","Female",36,48,49,44,52,229
"Horsham 013B","E01031630","40-44 years","Female",58,63,57,50,45,273
"Horsham 013B","E01031630","45-49 years","Female",43,41,43,49,51,227
"Horsham 013B","E01031630","50-54 years","Female",63,61,61,54,63,302
"Horsham 013B","E01031630","55-59 years","Female",43,47,51,53,57,251
"Horsham 013B","E01031630","60-64 years","Female",90,80,70,65,54,359
"Horsham 013B","E01031630","65-69 years","Female",88,92,97,90,94,461
"Horsham 013B","E01031630","70-74 years","Female",86,94,103,106,105,494
"Horsham 013B","E01031630","75-79 years","Female",71,71,71,79,90,382
"Horsham 013B","E01031630","80-84 years","Female",53,54,53,59,54,273
"Horsham 013B","E01031630","85+ years","Female",59,61,65,59,55,299
"Horsham 013C","E01031631","0-4 years","Male",48,49,49,52,58,256
"Horsham 013C","E01031631","5-9 years","Male",46,49,48,38,38,219
"Horsham 013C","E01031631","10-14 years","Male",49,49,45,54,49,246
"Horsham 013C","E01031631","15-19 years","Male",39,33,35,38,42,187
"Horsham 013C","E01031631","20-24 years","Male",35,37,41,25,30,168
"Horsham 013C","E01031631","25-29 years","Male",54,58,45,47,45,249
"Horsham 013C","E01031631","30-34 years","Male",34,37,40,33,38,182
"Horsham 013C","E01031631","35-39 years","Male",31,33,28,34,26,152
"Horsham 013C","E01031631","40-44 years","Male",31,29,36,37,47,180
"Horsham 013C","E01031631","45-49 years","Male",39,43,37,35,36,190
"Horsham 013C","E01031631","50-54 years","Male",57,61,53,52,48,271
"Horsham 013C","E01031631","55-59 years","Male",52,45,56,55,59,267
"Horsham 013C","E01031631","60-64 years","Male",39,46,52,53,46,236
"Horsham 013C","E01031631","65-69 years","Male",66,54,49,46,43,258
"Horsham 013C","E01031631","70-74 years","Male",36,45,48,51,51,231
"Horsham 013C","E01031631","75-79 years","Male",48,46,45,46,47,232
"Horsham 013C","E01031631","80-84 years","Male",42,44,44,42,44,216
"Horsham 013C","E01031631","85+ years","Male",43,42,43,52,54,234
"Horsham 013C","E01031631","0-4 years","Female",38,42,45,41,41,207
"Horsham 013C","E01031631","5-9 years","Female",41,37,40,44,41,203
"Horsham 013C","E01031631","10-14 years","Female",28,30,38,36,38,170
"Horsham 013C","E01031631","15-19 years","Female",20,25,27,25,26,123
"Horsham 013C","E01031631","20-24 years","Female",31,33,31,32,31,158
"Horsham 013C","E01031631","25-29 years","Female",49,40,43,41,39,212
"Horsham 013C","E01031631","30-34 years","Female",37,44,40,36,35,192
"Horsham 013C","E01031631","35-39 years","Female",46,44,48,50,49,237
"Horsham 013C","E01031631","40-44 years","Female",52,49,44,49,51,245
"Horsham 013C","E01031631","45-49 years","Female",47,44,48,52,57,248
"Horsham 013C","E01031631","50-54 years","Female",48,47,42,38,40,215
"Horsham 013C","E01031631","55-59 years","Female",40,49,54,56,58,257
"Horsham 013C","E01031631","60-64 years","Female",43,46,45,54,49,237
"Horsham 013C","E01031631","65-69 years","Female",70,61,54,53,57,295
"Horsham 013C","E01031631","70-74 years","Female",72,69,67,69,65,342
"Horsham 013C","E01031631","75-79 years","Female",59,61,62,66,67,315
"Horsham 013C","E01031631","80-84 years","Female",55,44,46,51,46,242
"Horsham 013C","E01031631","85+ years","Female",86,87,80,78,82,413
"Horsham 013D","E01031662","0-4 years","Male",31,53,47,46,43,220
"Horsham 013D","E01031662","5-9 years","Male",32,32,25,26,26,141
"Horsham 013D","E01031662","10-14 years","Male",33,28,26,25,25,137
"Horsham 013D","E01031662","15-19 years","Male",28,28,35,35,31,157
"Horsham 013D","E01031662","20-24 years","Male",40,30,29,24,37,160
"Horsham 013D","E01031662","25-29 years","Male",49,40,41,48,58,236
"Horsham 013D","E01031662","30-34 years","Male",34,37,38,40,49,198
"Horsham 013D","E01031662","35-39 years","Male",36,41,40,28,29,174
"Horsham 013D","E01031662","40-44 years","Male",47,40,43,46,52,228
"Horsham 013D","E01031662","45-49 years","Male",56,59,54,57,46,272
"Horsham 013D","E01031662","50-54 years","Male",63,64,54,45,55,281
"Horsham 013D","E01031662","55-59 years","Male",54,54,64,76,73,321
"Horsham 013D","E01031662","60-64 years","Male",49,48,45,46,48,236
"Horsham 013D","E01031662","65-69 years","Male",69,71,72,60,55,327
"Horsham 013D","E01031662","70-74 years","Male",42,44,50,55,58,249
"Horsham 013D","E01031662","75-79 years","Male",25,33,37,38,34,167
"Horsham 013D","E01031662","80-84 years","Male",21,15,18,20,25,99
"Horsham 013D","E01031662","85+ years","Male",32,33,37,31,33,166
"Horsham 013D","E01031662","0-4 years","Female",28,30,31,36,33,158
"Horsham 013D","E01031662","5-9 years","Female",36,30,20,22,19,127
"Horsham 013D","E01031662","10-14 years","Female",28,32,32,29,27,148
"Horsham 013D","E01031662","15-19 years","Female",34,29,29,25,27,144
"Horsham 013D","E01031662","20-24 years","Female",31,34,37,36,34,172
"Horsham 013D","E01031662","25-29 years","Female",43,49,51,47,48,238
"Horsham 013D","E01031662","30-34 years","Female",31,30,29,27,25,142
"Horsham 013D","E01031662","35-39 years","Female",30,28,39,33,31,161
"Horsham 013D","E01031662","40-44 years","Female",52,48,41,41,44,226
"Horsham 013D","E01031662","45-49 years","Female",67,67,63,54,61,312
"Horsham 013D","E01031662","50-54 years","Female",61,49,52,52,38,252
"Horsham 013D","E01031662","55-59 years","Female",69,67,63,73,79,351
"Horsham 013D","E01031662","60-64 years","Female",55,58,58,57,62,290
"Horsham 013D","E01031662","65-69 years","Female",65,61,64,60,60,310
"Horsham 013D","E01031662","70-74 years","Female",47,54,50,61,61,273
"Horsham 013D","E01031662","75-79 years","Female",50,60,57,56,43,266
"Horsham 013D","E01031662","80-84 years","Female",38,36,51,48,51,224
"Horsham 013D","E01031662","85+ years","Female",72,75,68,67,61,343
"Horsham 013E","E01031663","0-4 years","Male",91,87,79,74,68,399
"Horsham 013E","E01031663","5-9 years","Male",81,85,89,88,83,426
"Horsham 013E","E01031663","10-14 years","Male",55,56,58,67,77,313
"Horsham 013E","E01031663","15-19 years","Male",42,37,37,39,34,189
"Horsham 013E","E01031663","20-24 years","Male",52,49,43,34,37,215
"Horsham 013E","E01031663","25-29 years","Male",58,62,61,61,61,303
"Horsham 013E","E01031663","30-34 years","Male",66,57,65,66,61,315
"Horsham 013E","E01031663","35-39 years","Male",82,84,77,75,74,392
"Horsham 013E","E01031663","40-44 years","Male",66,54,53,53,63,289
"Horsham 013E","E01031663","45-49 years","Male",95,101,98,95,82,471
"Horsham 013E","E01031663","50-54 years","Male",72,81,71,75,73,372
"Horsham 013E","E01031663","55-59 years","Male",62,69,67,71,83,352
"Horsham 013E","E01031663","60-64 years","Male",39,38,45,45,47,214
"Horsham 013E","E01031663","65-69 years","Male",51,47,49,46,47,240
"Horsham 013E","E01031663","70-74 years","Male",49,46,46,46,55,242
"Horsham 013E","E01031663","75-79 years","Male",48,52,46,52,48,246
"Horsham 013E","E01031663","80-84 years","Male",21,28,31,25,26,131
"Horsham 013E","E01031663","85+ years","Male",13,12,10,11,10,56
"Horsham 013E","E01031663","0-4 years","Female",74,79,84,91,83,411
"Horsham 013E","E01031663","5-9 years","Female",58,58,66,73,83,338
"Horsham 013E","E01031663","10-14 years","Female",62,60,60,65,70,317
"Horsham 013E","E01031663","15-19 years","Female",51,46,43,45,43,228
"Horsham 013E","E01031663","20-24 years","Female",57,54,57,49,46,263
"Horsham 013E","E01031663","25-29 years","Female",56,71,68,70,65,330
"Horsham 013E","E01031663","30-34 years","Female",73,68,74,73,73,361
"Horsham 013E","E01031663","35-39 years","Female",91,93,89,94,98,465
"Horsham 013E","E01031663","40-44 years","Female",75,62,61,66,61,325
"Horsham 013E","E01031663","45-49 years","Female",69,75,76,77,81,378
"Horsham 013E","E01031663","50-54 years","Female",83,89,90,92,88,442
"Horsham 013E","E01031663","55-59 years","Female",61,58,61,58,71,309
"Horsham 013E","E01031663","60-64 years","Female",49,54,48,50,53,254
"Horsham 013E","E01031663","65-69 years","Female",64,55,55,58,59,291
"Horsham 013E","E01031663","70-74 years","Female",62,64,54,46,48,274
"Horsham 013E","E01031663","75-79 years","Female",47,44,53,53,57,254
"Horsham 013E","E01031663","80-84 years","Female",18,19,23,28,33,121
"Horsham 013E","E01031663","85+ years","Female",29,27,31,25,29,141
"Horsham 013F","E01031665","0-4 years","Male",28,29,27,26,24,134
"Horsham 013F","E01031665","5-9 years","Male",26,26,33,36,37,158
"Horsham 013F","E01031665","10-14 years","Male",28,26,24,28,25,131
"Horsham 013F","E01031665","15-19 years","Male",31,33,37,41,41,183
"Horsham 013F","E01031665","20-24 years","Male",17,16,13,19,11,76
"Horsham 013F","E01031665","25-29 years","Male",24,21,22,21,19,107
"Horsham 013F","E01031665","30-34 years","Male",24,23,21,25,27,120
"Horsham 013F","E01031665","35-39 years","Male",18,21,23,21,22,105
"Horsham 013F","E01031665","40-44 years","Male",28,25,26,36,40,155
"Horsham 013F","E01031665","45-49 years","Male",47,44,47,43,36,217
"Horsham 013F","E01031665","50-54 years","Male",66,54,50,44,46,260
"Horsham 013F","E01031665","55-59 years","Male",64,77,73,70,65,349
"Horsham 013F","E01031665","60-64 years","Male",47,44,42,49,51,233
"Horsham 013F","E01031665","65-69 years","Male",40,40,45,42,38,205
"Horsham 013F","E01031665","70-74 years","Male",51,64,64,56,64,299
"Horsham 013F","E01031665","75-79 years","Male",28,28,33,50,45,184
"Horsham 013F","E01031665","80-84 years","Male",16,15,14,13,16,74
"Horsham 013F","E01031665","85+ years","Male",15,19,15,13,10,72
"Horsham 013F","E01031665","0-4 years","Female",12,13,12,16,23,76
"Horsham 013F","E01031665","5-9 years","Female",22,21,18,15,17,93
"Horsham 013F","E01031665","10-14 years","Female",35,41,44,49,43,212
"Horsham 013F","E01031665","15-19 years","Female",23,23,21,22,20,109
"Horsham 013F","E01031665","20-24 years","Female",17,15,14,16,12,74
"Horsham 013F","E01031665","25-29 years","Female",17,22,19,15,15,88
"Horsham 013F","E01031665","30-34 years","Female",30,26,22,21,25,124
"Horsham 013F","E01031665","35-39 years","Female",25,29,34,38,34,160
"Horsham 013F","E01031665","40-44 years","Female",29,29,29,28,34,149
"Horsham 013F","E01031665","45-49 years","Female",44,39,41,49,39,212
"Horsham 013F","E01031665","50-54 years","Female",63,65,52,57,48,285
"Horsham 013F","E01031665","55-59 years","Female",57,58,65,57,65,302
"Horsham 013F","E01031665","60-64 years","Female",52,45,53,61,62,273
"Horsham 013F","E01031665","65-69 years","Female",51,58,50,55,57,271
"Horsham 013F","E01031665","70-74 years","Female",54,62,66,55,59,296
"Horsham 013F","E01031665","75-79 years","Female",29,31,31,37,37,165
"Horsham 013F","E01031665","80-84 years","Female",14,10,14,18,20,76
"Horsham 013F","E01031665","85+ years","Female",25,24,17,20,22,108
"Horsham 014A","E01031618","0-4 years","Male",28,26,34,39,39,166
"Horsham 014A","E01031618","5-9 years","Male",43,44,44,41,36,208
"Horsham 014A","E01031618","10-14 years","Male",40,29,32,30,36,167
"Horsham 014A","E01031618","15-19 years","Male",27,35,35,34,34,165
"Horsham 014A","E01031618","20-24 years","Male",32,24,23,21,20,120
"Horsham 014A","E01031618","25-29 years","Male",24,26,22,21,18,111
"Horsham 014A","E01031618","30-34 years","Male",8,10,15,21,17,71
"Horsham 014A","E01031618","35-39 years","Male",32,38,37,34,37,178
"Horsham 014A","E01031618","40-44 years","Male",19,16,16,14,13,78
"Horsham 014A","E01031618","45-49 years","Male",62,62,60,55,47,286
"Horsham 014A","E01031618","50-54 years","Male",64,60,56,56,58,294
"Horsham 014A","E01031618","55-59 years","Male",60,69,74,78,70,351
"Horsham 014A","E01031618","60-64 years","Male",48,55,45,56,67,271
"Horsham 014A","E01031618","65-69 years","Male",58,58,54,47,47,264
"Horsham 014A","E01031618","70-74 years","Male",44,49,50,49,51,243
"Horsham 014A","E01031618","75-79 years","Male",34,34,37,42,45,192
"Horsham 014A","E01031618","80-84 years","Male",29,31,32,33,31,156
"Horsham 014A","E01031618","85+ years","Male",25,25,26,30,29,135
"Horsham 014A","E01031618","0-4 years","Female",26,27,31,27,29,140
"Horsham 014A","E01031618","5-9 years","Female",33,30,26,30,31,150
"Horsham 014A","E01031618","10-14 years","Female",36,31,30,27,23,147
"Horsham 014A","E01031618","15-19 years","Female",32,29,35,31,20,147
"Horsham 014A","E01031618","20-24 years","Female",28,30,30,29,33,150
"Horsham 014A","E01031618","25-29 years","Female",21,15,18,16,18,88
"Horsham 014A","E01031618","30-34 years","Female",22,26,26,26,24,124
"Horsham 014A","E01031618","35-39 years","Female",36,40,38,36,38,188
"Horsham 014A","E01031618","40-44 years","Female",39,35,40,44,37,195
"Horsham 014A","E01031618","45-49 years","Female",59,47,44,39,48,237
"Horsham 014A","E01031618","50-54 years","Female",62,68,65,68,64,327
"Horsham 014A","E01031618","55-59 years","Female",70,66,68,65,57,326
"Horsham 014A","E01031618","60-64 years","Female",43,46,39,46,54,228
"Horsham 014A","E01031618","65-69 years","Female",58,54,55,55,56,278
"Horsham 014A","E01031618","70-74 years","Female",41,46,48,44,44,223
"Horsham 014A","E01031618","75-79 years","Female",36,32,33,43,45,189
"Horsham 014A","E01031618","80-84 years","Female",26,25,27,21,20,119
"Horsham 014A","E01031618","85+ years","Female",14,15,13,17,19,78
"Horsham 014B","E01031641","0-4 years","Male",19,14,15,14,9,71
"Horsham 014B","E01031641","5-9 years","Male",26,25,23,19,23,116
"Horsham 014B","E01031641","10-14 years","Male",27,29,30,30,28,144
"Horsham 014B","E01031641","15-19 years","Male",44,35,28,24,31,162
"Horsham 014B","E01031641","20-24 years","Male",21,21,26,30,27,125
"Horsham 014B","E01031641","25-29 years","Male",31,27,22,22,29,131
"Horsham 014B","E01031641","30-34 years","Male",22,25,26,24,22,119
"Horsham 014B","E01031641","35-39 years","Male",13,17,17,16,18,81
"Horsham 014B","E01031641","40-44 years","Male",35,33,26,23,15,132
"Horsham 014B","E01031641","45-49 years","Male",37,35,41,35,37,185
"Horsham 014B","E01031641","50-54 years","Male",52,52,47,47,48,246
"Horsham 014B","E01031641","55-59 years","Male",58,54,55,54,51,272
"Horsham 014B","E01031641","60-64 years","Male",52,60,65,61,66,304
"Horsham 014B","E01031641","65-69 years","Male",62,61,56,59,58,296
"Horsham 014B","E01031641","70-74 years","Male",57,58,61,67,62,305
"Horsham 014B","E01031641","75-79 years","Male",49,49,46,48,58,250
"Horsham 014B","E01031641","80-84 years","Male",52,55,53,46,44,250
"Horsham 014B","E01031641","85+ years","Male",39,40,48,55,43,225
"Horsham 014B","E01031641","0-4 years","Female",21,22,21,15,16,95
"Horsham 014B","E01031641","5-9 years","Female",34,31,24,23,28,140
"Horsham 014B","E01031641","10-14 years","Female",25,28,26,27,26,132
"Horsham 014B","E01031641","15-19 years","Female",32,32,30,24,31,149
"Horsham 014B","E01031641","20-24 years","Female",18,18,16,15,15,82
"Horsham 014B","E01031641","25-29 years","Female",28,26,24,21,29,128
"Horsham 014B","E01031641","30-34 years","Female",20,21,27,28,22,118
"Horsham 014B","E01031641","35-39 years","Female",22,24,22,15,22,105
"Horsham 014B","E01031641","40-44 years","Female",41,35,36,40,35,187
"Horsham 014B","E01031641","45-49 years","Female",63,53,53,47,53,269
"Horsham 014B","E01031641","50-54 years","Female",63,67,57,62,60,309
"Horsham 014B","E01031641","55-59 years","Female",60,62,61,51,59,293
"Horsham 014B","E01031641","60-64 years","Female",58,61,63,65,59,306
"Horsham 014B","E01031641","65-69 years","Female",74,72,76,60,62,344
"Horsham 014B","E01031641","70-74 years","Female",69,67,67,76,76,355
"Horsham 014B","E01031641","75-79 years","Female",64,69,75,83,77,368
"Horsham 014B","E01031641","80-84 years","Female",63,62,63,64,66,318
"Horsham 014B","E01031641","85+ years","Female",103,98,109,111,101,522
"Horsham 014C","E01031642","0-4 years","Male",40,41,70,85,78,314
"Horsham 014C","E01031642","5-9 years","Male",50,60,59,67,72,308
"Horsham 014C","E01031642","10-14 years","Male",62,62,70,69,78,341
"Horsham 014C","E01031642","15-19 years","Male",54,51,51,53,51,260
"Horsham 014C","E01031642","20-24 years","Male",28,24,27,31,31,141
"Horsham 014C","E01031642","25-29 years","Male",22,31,33,40,37,163
"Horsham 014C","E01031642","30-34 years","Male",28,21,39,53,53,194
"Horsham 014C","E01031642","35-39 years","Male",38,42,50,52,48,230
"Horsham 014C","E01031642","40-44 years","Male",45,42,54,63,66,270
"Horsham 014C","E01031642","45-49 years","Male",48,51,57,55,69,280
"Horsham 014C","E01031642","50-54 years","Male",89,82,81,89,82,423
"Horsham 014C","E01031642","55-59 years","Male",61,64,78,72,81,356
"Horsham 014C","E01031642","60-64 years","Male",66,71,65,75,79,356
"Horsham 014C","E01031642","65-69 years","Male",59,56,63,71,72,321
"Horsham 014C","E01031642","70-74 years","Male",80,87,87,76,79,409
"Horsham 014C","E01031642","75-79 years","Male",40,47,49,57,58,251
"Horsham 014C","E01031642","80-84 years","Male",32,29,31,37,49,178
"Horsham 014C","E01031642","85+ years","Male",31,34,36,32,31,164
"Horsham 014C","E01031642","0-4 years","Female",33,31,53,66,70,253
"Horsham 014C","E01031642","5-9 years","Female",43,45,63,60,65,276
"Horsham 014C","E01031642","10-14 years","Female",53,50,50,52,64,269
"Horsham 014C","E01031642","15-19 years","Female",41,44,47,56,57,245
"Horsham 014C","E01031642","20-24 years","Female",35,38,44,46,40,203
"Horsham 014C","E01031642","25-29 years","Female",25,28,41,46,53,193
"Horsham 014C","E01031642","30-34 years","Female",37,39,65,75,75,291
"Horsham 014C","E01031642","35-39 years","Female",44,47,58,69,78,296
"Horsham 014C","E01031642","40-44 years","Female",48,50,58,65,60,281
"Horsham 014C","E01031642","45-49 years","Female",69,71,77,69,74,360
"Horsham 014C","E01031642","50-54 years","Female",93,88,91,94,102,468
"Horsham 014C","E01031642","55-59 years","Female",77,83,84,88,94,426
"Horsham 014C","E01031642","60-64 years","Female",66,68,84,82,83,383
"Horsham 014C","E01031642","65-69 years","Female",69,68,72,80,81,370
"Horsham 014C","E01031642","70-74 years","Female",75,91,86,86,86,424
"Horsham 014C","E01031642","75-79 years","Female",48,46,56,59,56,265
"Horsham 014C","E01031642","80-84 years","Female",36,37,36,47,40,196
"Horsham 014C","E01031642","85+ years","Female",41,50,41,39,42,213
"Horsham 014D","E01031643","0-4 years","Male",101,86,95,71,62,415
"Horsham 014D","E01031643","5-9 years","Male",68,96,99,100,91,454
"Horsham 014D","E01031643","10-14 years","Male",42,38,45,54,61,240
"Horsham 014D","E01031643","15-19 years","Male",33,29,24,29,29,144
"Horsham 014D","E01031643","20-24 years","Male",53,52,45,38,31,219
"Horsham 014D","E01031643","25-29 years","Male",47,44,42,49,43,225
"Horsham 014D","E01031643","30-34 years","Male",44,42,43,40,55,224
"Horsham 014D","E01031643","35-39 years","Male",57,67,61,63,50,298
"Horsham 014D","E01031643","40-44 years","Male",52,40,42,46,44,224
"Horsham 014D","E01031643","45-49 years","Male",60,66,60,59,58,303
"Horsham 014D","E01031643","50-54 years","Male",58,63,71,65,63,320
"Horsham 014D","E01031643","55-59 years","Male",49,57,59,54,61,280
"Horsham 014D","E01031643","60-64 years","Male",53,48,54,64,56,275
"Horsham 014D","E01031643","65-69 years","Male",60,56,66,57,59,298
"Horsham 014D","E01031643","70-74 years","Male",48,48,42,43,53,234
"Horsham 014D","E01031643","75-79 years","Male",36,38,40,42,45,201
"Horsham 014D","E01031643","80-84 years","Male",30,28,28,33,37,156
"Horsham 014D","E01031643","85+ years","Male",24,21,22,19,19,105
"Horsham 014D","E01031643","0-4 years","Female",90,84,79,75,74,402
"Horsham 014D","E01031643","5-9 years","Female",58,55,55,56,58,282
"Horsham 014D","E01031643","10-14 years","Female",68,68,62,63,58,319
"Horsham 014D","E01031643","15-19 years","Female",33,42,42,47,49,213
"Horsham 014D","E01031643","20-24 years","Female",49,36,42,46,38,211
"Horsham 014D","E01031643","25-29 years","Female",54,58,54,58,60,284
"Horsham 014D","E01031643","30-34 years","Female",50,54,50,42,49,245
"Horsham 014D","E01031643","35-39 years","Female",57,65,64,68,62,316
"Horsham 014D","E01031643","40-44 years","Female",61,47,50,47,38,243
"Horsham 014D","E01031643","45-49 years","Female",74,79,77,70,75,375
"Horsham 014D","E01031643","50-54 years","Female",52,60,66,70,66,314
"Horsham 014D","E01031643","55-59 years","Female",77,71,68,70,74,360
"Horsham 014D","E01031643","60-64 years","Female",57,66,67,75,86,351
"Horsham 014D","E01031643","65-69 years","Female",49,39,45,45,43,221
"Horsham 014D","E01031643","70-74 years","Female",64,71,61,62,63,321
"Horsham 014D","E01031643","75-79 years","Female",52,52,59,63,60,286
"Horsham 014D","E01031643","80-84 years","Female",50,55,58,58,53,274
"Horsham 014D","E01031643","85+ years","Female",54,55,59,58,58,284
"Horsham 014E","E01031687","0-4 years","Male",38,38,43,35,32,186
"Horsham 014E","E01031687","5-9 years","Male",47,50,48,54,58,257
"Horsham 014E","E01031687","10-14 years","Male",40,42,42,36,37,197
"Horsham 014E","E01031687","15-19 years","Male",60,57,51,60,60,288
"Horsham 014E","E01031687","20-24 years","Male",56,56,59,48,47,266
"Horsham 014E","E01031687","25-29 years","Male",48,44,40,39,34,205
"Horsham 014E","E01031687","30-34 years","Male",37,40,47,48,51,223
"Horsham 014E","E01031687","35-39 years","Male",35,44,45,48,46,218
"Horsham 014E","E01031687","40-44 years","Male",56,49,53,48,49,255
"Horsham 014E","E01031687","45-49 years","Male",49,53,50,54,56,262
"Horsham 014E","E01031687","50-54 years","Male",63,62,65,67,65,322
"Horsham 014E","E01031687","55-59 years","Male",56,61,58,60,64,299
"Horsham 014E","E01031687","60-64 years","Male",45,39,40,44,42,210
"Horsham 014E","E01031687","65-69 years","Male",44,44,42,37,37,204
"Horsham 014E","E01031687","70-74 years","Male",30,37,43,42,44,196
"Horsham 014E","E01031687","75-79 years","Male",29,25,27,27,25,133
"Horsham 014E","E01031687","80-84 years","Male",18,20,25,27,32,122
"Horsham 014E","E01031687","85+ years","Male",19,14,14,11,11,69
"Horsham 014E","E01031687","0-4 years","Female",42,38,37,33,36,186
"Horsham 014E","E01031687","5-9 years","Female",75,76,72,67,60,350
"Horsham 014E","E01031687","10-14 years","Female",54,53,69,72,77,325
"Horsham 014E","E01031687","15-19 years","Female",59,62,60,63,64,308
"Horsham 014E","E01031687","20-24 years","Female",36,33,33,40,38,180
"Horsham 014E","E01031687","25-29 years","Female",40,48,55,45,46,234
"Horsham 014E","E01031687","30-34 years","Female",28,35,39,42,45,189
"Horsham 014E","E01031687","35-39 years","Female",37,37,33,41,40,188
"Horsham 014E","E01031687","40-44 years","Female",60,57,53,50,40,260
"Horsham 014E","E01031687","45-49 years","Female",70,64,64,66,75,339
"Horsham 014E","E01031687","50-54 years","Female",86,93,83,78,68,408
"Horsham 014E","E01031687","55-59 years","Female",67,64,69,73,76,349
"Horsham 014E","E01031687","60-64 years","Female",46,56,56,58,58,274
"Horsham 014E","E01031687","65-69 years","Female",73,70,57,52,47,299
"Horsham 014E","E01031687","70-74 years","Female",30,33,45,49,56,213
"Horsham 014E","E01031687","75-79 years","Female",45,40,45,44,42,216
"Horsham 014E","E01031687","80-84 years","Female",28,31,33,38,38,168
"Horsham 014E","E01031687","85+ years","Female",29,23,24,21,23,120
"Horsham 015A","E01031622","0-4 years","Male",41,37,34,27,27,166
"Horsham 015A","E01031622","5-9 years","Male",49,50,52,57,53,261
"Horsham 015A","E01031622","10-14 years","Male",51,52,45,42,43,233
"Horsham 015A","E01031622","15-19 years","Male",55,48,52,46,43,244
"Horsham 015A","E01031622","20-24 years","Male",38,37,40,48,50,213
"Horsham 015A","E01031622","25-29 years","Male",35,41,42,41,32,191
"Horsham 015A","E01031622","30-34 years","Male",40,34,44,44,58,220
"Horsham 015A","E01031622","35-39 years","Male",42,40,39,42,45,208
"Horsham 015A","E01031622","40-44 years","Male",40,41,38,40,39,198
"Horsham 015A","E01031622","45-49 years","Male",74,71,61,58,50,314
"Horsham 015A","E01031622","50-54 years","Male",71,73,78,79,79,380
"Horsham 015A","E01031622","55-59 years","Male",63,65,65,63,70,326
"Horsham 015A","E01031622","60-64 years","Male",34,33,34,34,39,174
"Horsham 015A","E01031622","65-69 years","Male",72,63,53,53,45,286
"Horsham 015A","E01031622","70-74 years","Male",34,46,52,51,53,236
"Horsham 015A","E01031622","75-79 years","Male",36,38,40,41,44,199
"Horsham 015A","E01031622","80-84 years","Male",26,26,28,33,31,144
"Horsham 015A","E01031622","85+ years","Male",8,13,13,15,14,63
"Horsham 015A","E01031622","0-4 years","Female",35,37,37,37,36,182
"Horsham 015A","E01031622","5-9 years","Female",55,49,50,43,46,243
"Horsham 015A","E01031622","10-14 years","Female",50,58,59,69,61,297
"Horsham 015A","E01031622","15-19 years","Female",43,38,35,30,29,175
"Horsham 015A","E01031622","20-24 years","Female",26,30,25,22,22,125
"Horsham 015A","E01031622","25-29 years","Female",30,24,27,34,31,146
"Horsham 015A","E01031622","30-34 years","Female",35,38,39,31,29,172
"Horsham 015A","E01031622","35-39 years","Female",50,46,50,44,36,226
"Horsham 015A","E01031622","40-44 years","Female",50,49,41,34,43,217
"Horsham 015A","E01031622","45-49 years","Female",86,77,73,73,68,377
"Horsham 015A","E01031622","50-54 years","Female",78,76,77,69,66,366
"Horsham 015A","E01031622","55-59 years","Female",52,53,57,72,73,307
"Horsham 015A","E01031622","60-64 years","Female",53,67,64,64,66,314
"Horsham 015A","E01031622","65-69 years","Female",55,55,50,52,49,261
"Horsham 015A","E01031622","70-74 years","Female",58,47,44,50,58,257
"Horsham 015A","E01031622","75-79 years","Female",18,26,35,36,36,151
"Horsham 015A","E01031622","80-84 years","Female",22,19,20,18,18,97
"Horsham 015A","E01031622","85+ years","Female",14,15,15,22,23,89
"Horsham 015B","E01031624","0-4 years","Male",43,38,43,41,35,200
"Horsham 015B","E01031624","5-9 years","Male",48,43,43,46,49,229
"Horsham 015B","E01031624","10-14 years","Male",53,60,58,54,50,275
"Horsham 015B","E01031624","15-19 years","Male",57,54,55,51,50,267
"Horsham 015B","E01031624","20-24 years","Male",38,36,37,38,40,189
"Horsham 015B","E01031624","25-29 years","Male",15,20,23,21,20,99
"Horsham 015B","E01031624","30-34 years","Male",29,19,17,22,27,114
"Horsham 015B","E01031624","35-39 years","Male",40,44,42,33,31,190
"Horsham 015B","E01031624","40-44 years","Male",49,39,44,48,44,224
"Horsham 015B","E01031624","45-49 years","Male",63,64,59,48,43,277
"Horsham 015B","E01031624","50-54 years","Male",75,85,82,84,85,411
"Horsham 015B","E01031624","55-59 years","Male",72,70,74,72,73,361
"Horsham 015B","E01031624","60-64 years","Male",54,66,72,70,78,340
"Horsham 015B","E01031624","65-69 years","Male",43,33,38,41,40,195
"Horsham 015B","E01031624","70-74 years","Male",45,54,56,52,54,261
"Horsham 015B","E01031624","75-79 years","Male",35,48,41,44,36,204
"Horsham 015B","E01031624","80-84 years","Male",15,15,23,24,29,106
"Horsham 015B","E01031624","85+ years","Male",15,20,19,19,13,86
"Horsham 015B","E01031624","0-4 years","Female",44,47,49,46,43,229
"Horsham 015B","E01031624","5-9 years","Female",64,65,75,74,72,350
"Horsham 015B","E01031624","10-14 years","Female",47,57,54,55,57,270
"Horsham 015B","E01031624","15-19 years","Female",44,36,37,33,33,183
"Horsham 015B","E01031624","20-24 years","Female",34,37,32,26,26,155
"Horsham 015B","E01031624","25-29 years","Female",27,27,31,25,29,139
"Horsham 015B","E01031624","30-34 years","Female",33,34,33,32,26,158
"Horsham 015B","E01031624","35-39 years","Female",53,46,46,47,50,242
"Horsham 015B","E01031624","40-44 years","Female",66,62,63,68,65,324
"Horsham 015B","E01031624","45-49 years","Female",69,75,66,58,62,330
"Horsham 015B","E01031624","50-54 years","Female",75,81,84,84,81,405
"Horsham 015B","E01031624","55-59 years","Female",67,69,68,70,65,339
"Horsham 015B","E01031624","60-64 years","Female",59,59,64,64,62,308
"Horsham 015B","E01031624","65-69 years","Female",59,59,57,56,61,292
"Horsham 015B","E01031624","70-74 years","Female",46,52,57,61,61,277
"Horsham 015B","E01031624","75-79 years","Female",29,34,39,40,44,186
"Horsham 015B","E01031624","80-84 years","Female",17,21,26,31,30,125
"Horsham 015B","E01031624","85+ years","Female",11,8,14,12,16,61
"Horsham 015C","E01031625","0-4 years","Male",27,29,44,44,45,189
"Horsham 015C","E01031625","5-9 years","Male",61,59,57,64,61,302
"Horsham 015C","E01031625","10-14 years","Male",53,58,62,65,82,320
"Horsham 015C","E01031625","15-19 years","Male",36,40,45,57,62,240
"Horsham 015C","E01031625","20-24 years","Male",43,41,43,34,23,184
"Horsham 015C","E01031625","25-29 years","Male",32,33,37,43,44,189
"Horsham 015C","E01031625","30-34 years","Male",30,36,41,41,42,190
"Horsham 015C","E01031625","35-39 years","Male",24,27,38,41,38,168
"Horsham 015C","E01031625","40-44 years","Male",59,57,54,55,48,273
"Horsham 015C","E01031625","45-49 years","Male",48,52,63,72,72,307
"Horsham 015C","E01031625","50-54 years","Male",68,78,77,68,60,351
"Horsham 015C","E01031625","55-59 years","Male",60,62,68,86,86,362
"Horsham 015C","E01031625","60-64 years","Male",45,45,52,51,58,251
"Horsham 015C","E01031625","65-69 years","Male",59,60,52,65,59,295
"Horsham 015C","E01031625","70-74 years","Male",49,51,58,53,63,274
"Horsham 015C","E01031625","75-79 years","Male",18,26,35,39,38,156
"Horsham 015C","E01031625","80-84 years","Male",22,23,24,22,27,118
"Horsham 015C","E01031625","85+ years","Male",7,6,7,7,7,34
"Horsham 015C","E01031625","0-4 years","Female",21,28,43,50,54,196
"Horsham 015C","E01031625","5-9 years","Female",48,50,53,57,55,263
"Horsham 015C","E01031625","10-14 years","Female",41,42,45,52,56,236
"Horsham 015C","E01031625","15-19 years","Female",49,43,34,43,41,210
"Horsham 015C","E01031625","20-24 years","Female",18,20,29,30,30,127
"Horsham 015C","E01031625","25-29 years","Female",22,22,28,34,28,134
"Horsham 015C","E01031625","30-34 years","Female",20,24,31,35,39,149
"Horsham 015C","E01031625","35-39 years","Female",55,55,59,65,62,296
"Horsham 015C","E01031625","40-44 years","Female",40,50,56,55,60,261
"Horsham 015C","E01031625","45-49 years","Female",82,81,65,59,62,349
"Horsham 015C","E01031625","50-54 years","Female",86,92,95,95,80,448
"Horsham 015C","E01031625","55-59 years","Female",37,46,61,71,84,299
"Horsham 015C","E01031625","60-64 years","Female",60,63,55,59,58,295
"Horsham 015C","E01031625","65-69 years","Female",50,45,61,76,81,313
"Horsham 015C","E01031625","70-74 years","Female",54,56,49,59,69,287
"Horsham 015C","E01031625","75-79 years","Female",27,32,41,42,42,184
"Horsham 015C","E01031625","80-84 years","Female",23,32,36,36,45,172
"Horsham 015C","E01031625","85+ years","Female",11,11,11,14,15,62
"Horsham 015D","E01031628","0-4 years","Male",42,53,47,55,47,244
"Horsham 015D","E01031628","5-9 years","Male",36,38,52,46,59,231
"Horsham 015D","E01031628","10-14 years","Male",132,127,128,125,102,614
"Horsham 015D","E01031628","15-19 years","Male",67,44,43,39,42,235
"Horsham 015D","E01031628","20-24 years","Male",38,30,28,32,30,158
"Horsham 015D","E01031628","25-29 years","Male",43,57,56,58,57,271
"Horsham 015D","E01031628","30-34 years","Male",27,25,28,37,46,163
"Horsham 015D","E01031628","35-39 years","Male",32,37,34,40,42,185
"Horsham 015D","E01031628","40-44 years","Male",27,36,44,41,43,191
"Horsham 015D","E01031628","45-49 years","Male",61,58,50,45,44,258
"Horsham 015D","E01031628","50-54 years","Male",44,43,48,52,47,234
"Horsham 015D","E01031628","55-59 years","Male",49,49,52,55,61,266
"Horsham 015D","E01031628","60-64 years","Male",45,55,49,48,52,249
"Horsham 015D","E01031628","65-69 years","Male",59,54,53,57,48,271
"Horsham 015D","E01031628","70-74 years","Male",38,49,51,58,61,257
"Horsham 015D","E01031628","75-79 years","Male",29,28,29,29,29,144
"Horsham 015D","E01031628","80-84 years","Male",34,26,28,31,36,155
"Horsham 015D","E01031628","85+ years","Male",21,27,27,29,23,127
"Horsham 015D","E01031628","0-4 years","Female",41,43,47,49,52,232
"Horsham 015D","E01031628","5-9 years","Female",41,44,47,45,54,231
"Horsham 015D","E01031628","10-14 years","Female",104,94,88,91,79,456
"Horsham 015D","E01031628","15-19 years","Female",50,28,35,35,29,177
"Horsham 015D","E01031628","20-24 years","Female",39,32,25,25,24,145
"Horsham 015D","E01031628","25-29 years","Female",46,47,52,57,67,269
"Horsham 015D","E01031628","30-34 years","Female",28,28,24,36,38,154
"Horsham 015D","E01031628","35-39 years","Female",39,46,56,57,62,260
"Horsham 015D","E01031628","40-44 years","Female",52,52,50,53,59,266
"Horsham 015D","E01031628","45-49 years","Female",56,56,50,55,46,263
"Horsham 015D","E01031628","50-54 years","Female",61,66,64,66,69,326
"Horsham 015D","E01031628","55-59 years","Female",57,57,63,74,79,330
"Horsham 015D","E01031628","60-64 years","Female",38,43,53,58,53,245
"Horsham 015D","E01031628","65-69 years","Female",54,51,45,46,51,247
"Horsham 015D","E01031628","70-74 years","Female",31,44,38,45,41,199
"Horsham 015D","E01031628","75-79 years","Female",32,29,42,37,37,177
"Horsham 015D","E01031628","80-84 years","Female",33,33,34,42,40,182
"Horsham 015D","E01031628","85+ years","Female",50,52,48,43,47,240
"Horsham 015E","E01031629","0-4 years","Male",31,33,31,29,29,153
"Horsham 015E","E01031629","5-9 years","Male",35,37,35,40,41,188
"Horsham 015E","E01031629","10-14 years","Male",36,37,44,47,50,214
"Horsham 015E","E01031629","15-19 years","Male",32,30,30,29,26,147
"Horsham 015E","E01031629","20-24 years","Male",21,25,25,30,34,135
"Horsham 015E","E01031629","25-29 years","Male",15,20,17,13,15,80
"Horsham 015E","E01031629","30-34 years","Male",17,14,19,27,20,97
"Horsham 015E","E01031629","35-39 years","Male",16,19,19,16,15,85
"Horsham 015E","E01031629","40-44 years","Male",45,40,42,41,37,205
"Horsham 015E","E01031629","45-49 years","Male",61,60,55,53,47,276
"Horsham 015E","E01031629","50-54 years","Male",50,47,48,54,58,257
"Horsham 015E","E01031629","55-59 years","Male",70,70,64,63,68,335
"Horsham 015E","E01031629","60-64 years","Male",53,63,66,61,69,312
"Horsham 015E","E01031629","65-69 years","Male",79,62,54,60,55,310
"Horsham 015E","E01031629","70-74 years","Male",59,64,69,66,65,323
"Horsham 015E","E01031629","75-79 years","Male",47,51,59,65,64,286
"Horsham 015E","E01031629","80-84 years","Male",23,24,25,26,33,131
"Horsham 015E","E01031629","85+ years","Male",25,25,22,23,23,118
"Horsham 015E","E01031629","0-4 years","Female",26,28,30,30,28,142
"Horsham 015E","E01031629","5-9 years","Female",32,28,35,31,29,155
"Horsham 015E","E01031629","10-14 years","Female",33,32,31,34,28,158
"Horsham 015E","E01031629","15-19 years","Female",32,31,29,35,36,163
"Horsham 015E","E01031629","20-24 years","Female",28,27,20,19,25,119
"Horsham 015E","E01031629","25-29 years","Female",13,12,13,16,13,67
"Horsham 015E","E01031629","30-34 years","Female",30,31,27,27,24,139
"Horsham 015E","E01031629","35-39 years","Female",35,32,30,29,30,156
"Horsham 015E","E01031629","40-44 years","Female",42,44,45,45,41,217
"Horsham 015E","E01031629","45-49 years","Female",52,52,45,47,49,245
"Horsham 015E","E01031629","50-54 years","Female",84,75,89,76,64,388
"Horsham 015E","E01031629","55-59 years","Female",56,63,61,65,73,318
"Horsham 015E","E01031629","60-64 years","Female",71,64,62,64,62,323
"Horsham 015E","E01031629","65-69 years","Female",71,69,67,64,64,335
"Horsham 015E","E01031629","70-74 years","Female",65,82,75,81,75,378
"Horsham 015E","E01031629","75-79 years","Female",36,42,51,45,62,236
"Horsham 015E","E01031629","80-84 years","Female",16,14,17,22,18,87
"Horsham 015E","E01031629","85+ years","Female",29,26,28,26,26,135
"Horsham 016A","E01031616","0-4 years","Male",49,56,49,41,45,240
"Horsham 016A","E01031616","5-9 years","Male",50,48,56,68,62,284
"Horsham 016A","E01031616","10-14 years","Male",35,39,37,36,39,186
"Horsham 016A","E01031616","15-19 years","Male",43,35,36,32,34,180
"Horsham 016A","E01031616","20-24 years","Male",44,45,41,42,37,209
"Horsham 016A","E01031616","25-29 years","Male",29,28,31,33,32,153
"Horsham 016A","E01031616","30-34 years","Male",39,41,41,41,43,205
"Horsham 016A","E01031616","35-39 years","Male",41,47,48,49,53,238
"Horsham 016A","E01031616","40-44 years","Male",58,53,53,48,45,257
"Horsham 016A","E01031616","45-49 years","Male",52,55,56,51,54,268
"Horsham 016A","E01031616","50-54 years","Male",59,61,53,49,48,270
"Horsham 016A","E01031616","55-59 years","Male",62,59,58,58,55,292
"Horsham 016A","E01031616","60-64 years","Male",58,53,57,59,60,287
"Horsham 016A","E01031616","65-69 years","Male",44,48,46,50,60,248
"Horsham 016A","E01031616","70-74 years","Male",46,43,41,41,38,209
"Horsham 016A","E01031616","75-79 years","Male",33,36,36,37,36,178
"Horsham 016A","E01031616","80-84 years","Male",25,23,21,16,18,103
"Horsham 016A","E01031616","85+ years","Male",18,22,18,27,22,107
"Horsham 016A","E01031616","0-4 years","Female",57,48,56,48,49,258
"Horsham 016A","E01031616","5-9 years","Female",53,54,66,73,78,324
"Horsham 016A","E01031616","10-14 years","Female",41,48,42,46,50,227
"Horsham 016A","E01031616","15-19 years","Female",45,41,36,37,34,193
"Horsham 016A","E01031616","20-24 years","Female",35,38,38,33,30,174
"Horsham 016A","E01031616","25-29 years","Female",36,39,42,47,44,208
"Horsham 016A","E01031616","30-34 years","Female",31,39,36,37,38,181
"Horsham 016A","E01031616","35-39 years","Female",55,53,55,52,47,262
"Horsham 016A","E01031616","40-44 years","Female",60,53,46,38,46,243
"Horsham 016A","E01031616","45-49 years","Female",56,61,64,67,67,315
"Horsham 016A","E01031616","50-54 years","Female",58,59,53,50,49,269
"Horsham 016A","E01031616","55-59 years","Female",75,67,65,66,65,338
"Horsham 016A","E01031616","60-64 years","Female",42,53,67,67,67,296
"Horsham 016A","E01031616","65-69 years","Female",50,42,37,38,35,202
"Horsham 016A","E01031616","70-74 years","Female",56,60,66,60,58,300
"Horsham 016A","E01031616","75-79 years","Female",50,47,45,46,45,233
"Horsham 016A","E01031616","80-84 years","Female",20,25,27,29,31,132
"Horsham 016A","E01031616","85+ years","Female",22,23,19,18,21,103
"Horsham 016B","E01031617","0-4 years","Male",43,36,41,42,50,212
"Horsham 016B","E01031617","5-9 years","Male",74,75,65,60,52,326
"Horsham 016B","E01031617","10-14 years","Male",60,65,75,75,75,350
"Horsham 016B","E01031617","15-19 years","Male",53,55,56,54,55,273
"Horsham 016B","E01031617","20-24 years","Male",39,38,42,38,36,193
"Horsham 016B","E01031617","25-29 years","Male",63,57,51,53,51,275
"Horsham 016B","E01031617","30-34 years","Male",39,38,45,45,39,206
"Horsham 016B","E01031617","35-39 years","Male",53,59,49,49,51,261
"Horsham 016B","E01031617","40-44 years","Male",66,58,54,53,53,284
"Horsham 016B","E01031617","45-49 years","Male",89,93,87,99,101,469
"Horsham 016B","E01031617","50-54 years","Male",90,95,100,91,92,468
"Horsham 016B","E01031617","55-59 years","Male",72,75,90,88,87,412
"Horsham 016B","E01031617","60-64 years","Male",85,84,81,71,67,388
"Horsham 016B","E01031617","65-69 years","Male",107,96,92,102,100,497
"Horsham 016B","E01031617","70-74 years","Male",97,109,106,90,90,492
"Horsham 016B","E01031617","75-79 years","Male",57,66,68,74,77,342
"Horsham 016B","E01031617","80-84 years","Male",45,39,43,53,55,235
"Horsham 016B","E01031617","85+ years","Male",42,42,42,43,48,217
"Horsham 016B","E01031617","0-4 years","Female",51,42,37,44,41,215
"Horsham 016B","E01031617","5-9 years","Female",54,58,47,47,48,254
"Horsham 016B","E01031617","10-14 years","Female",52,51,53,57,61,274
"Horsham 016B","E01031617","15-19 years","Female",78,56,50,56,56,296
"Horsham 016B","E01031617","20-24 years","Female",49,45,45,46,37,222
"Horsham 016B","E01031617","25-29 years","Female",38,32,34,34,34,172
"Horsham 016B","E01031617","30-34 years","Female",57,71,65,60,48,301
"Horsham 016B","E01031617","35-39 years","Female",45,48,45,47,60,245
"Horsham 016B","E01031617","40-44 years","Female",88,79,72,71,65,375
"Horsham 016B","E01031617","45-49 years","Female",96,106,108,104,96,510
"Horsham 016B","E01031617","50-54 years","Female",126,122,120,120,121,609
"Horsham 016B","E01031617","55-59 years","Female",73,84,89,89,87,422
"Horsham 016B","E01031617","60-64 years","Female",90,90,90,88,83,441
"Horsham 016B","E01031617","65-69 years","Female",128,113,108,104,107,560
"Horsham 016B","E01031617","70-74 years","Female",87,110,123,124,116,560
"Horsham 016B","E01031617","75-79 years","Female",64,62,56,58,63,303
"Horsham 016B","E01031617","80-84 years","Female",34,40,49,50,59,232
"Horsham 016B","E01031617","85+ years","Female",51,50,53,52,52,258
"Horsham 016C","E01031684","0-4 years","Male",29,26,23,25,25,128
"Horsham 016C","E01031684","5-9 years","Male",46,42,36,33,28,185
"Horsham 016C","E01031684","10-14 years","Male",40,49,58,48,55,250
"Horsham 016C","E01031684","15-19 years","Male",65,56,60,71,69,321
"Horsham 016C","E01031684","20-24 years","Male",18,18,17,19,21,93
"Horsham 016C","E01031684","25-29 years","Male",23,21,27,21,21,113
"Horsham 016C","E01031684","30-34 years","Male",16,20,14,21,22,93
"Horsham 016C","E01031684","35-39 years","Male",27,23,27,29,27,133
"Horsham 016C","E01031684","40-44 years","Male",45,30,31,27,29,162
"Horsham 016C","E01031684","45-49 years","Male",56,64,57,57,53,287
"Horsham 016C","E01031684","50-54 years","Male",66,65,62,67,64,324
"Horsham 016C","E01031684","55-59 years","Male",64,64,66,67,66,327
"Horsham 016C","E01031684","60-64 years","Male",40,44,43,38,45,210
"Horsham 016C","E01031684","65-69 years","Male",60,54,50,54,52,270
"Horsham 016C","E01031684","70-74 years","Male",33,39,46,52,56,226
"Horsham 016C","E01031684","75-79 years","Male",38,33,25,29,27,152
"Horsham 016C","E01031684","80-84 years","Male",25,19,25,22,23,114
"Horsham 016C","E01031684","85+ years","Male",22,27,27,29,25,130
"Horsham 016C","E01031684","0-4 years","Female",18,19,16,18,16,87
"Horsham 016C","E01031684","5-9 years","Female",35,28,32,32,25,152
"Horsham 016C","E01031684","10-14 years","Female",47,53,42,43,49,234
"Horsham 016C","E01031684","15-19 years","Female",47,42,46,49,48,232
"Horsham 016C","E01031684","20-24 years","Female",29,36,33,27,30,155
"Horsham 016C","E01031684","25-29 years","Female",30,32,40,36,30,168
"Horsham 016C","E01031684","30-34 years","Female",15,18,19,19,24,95
"Horsham 016C","E01031684","35-39 years","Female",33,31,30,22,29,145
"Horsham 016C","E01031684","40-44 years","Female",44,40,35,47,42,208
"Horsham 016C","E01031684","45-49 years","Female",69,71,67,62,64,333
"Horsham 016C","E01031684","50-54 years","Female",61,65,65,68,65,324
"Horsham 016C","E01031684","55-59 years","Female",66,59,61,64,69,319
"Horsham 016C","E01031684","60-64 years","Female",67,68,65,67,59,326
"Horsham 016C","E01031684","65-69 years","Female",55,46,49,51,64,265
"Horsham 016C","E01031684","70-74 years","Female",59,64,59,61,58,301
"Horsham 016C","E01031684","75-79 years","Female",36,43,44,49,53,225
"Horsham 016C","E01031684","80-84 years","Female",34,29,31,31,30,155
"Horsham 016C","E01031684","85+ years","Female",24,30,26,24,28,132
"Horsham 016D","E01031685","0-4 years","Male",31,36,33,25,23,148
"Horsham 016D","E01031685","5-9 years","Male",40,50,39,26,32,187
"Horsham 016D","E01031685","10-14 years","Male",35,36,39,38,35,183
"Horsham 016D","E01031685","15-19 years","Male",42,37,45,49,42,215
"Horsham 016D","E01031685","20-24 years","Male",15,19,20,14,16,84
"Horsham 016D","E01031685","25-29 years","Male",32,34,26,28,28,148
"Horsham 016D","E01031685","30-34 years","Male",32,30,23,26,30,141
"Horsham 016D","E01031685","35-39 years","Male",32,33,40,33,26,164
"Horsham 016D","E01031685","40-44 years","Male",41,45,43,41,41,211
"Horsham 016D","E01031685","45-49 years","Male",66,61,61,55,48,291
"Horsham 016D","E01031685","50-54 years","Male",54,61,65,61,61,302
"Horsham 016D","E01031685","55-59 years","Male",52,51,54,59,52,268
"Horsham 016D","E01031685","60-64 years","Male",53,53,49,50,54,259
"Horsham 016D","E01031685","65-69 years","Male",69,58,57,54,55,293
"Horsham 016D","E01031685","70-74 years","Male",53,68,77,78,83,359
"Horsham 016D","E01031685","75-79 years","Male",38,42,45,43,45,213
"Horsham 016D","E01031685","80-84 years","Male",37,43,48,44,42,214
"Horsham 016D","E01031685","85+ years","Male",23,23,22,28,30,126
"Horsham 016D","E01031685","0-4 years","Female",34,30,20,17,15,116
"Horsham 016D","E01031685","5-9 years","Female",33,34,36,34,29,166
"Horsham 016D","E01031685","10-14 years","Female",39,39,46,51,51,226
"Horsham 016D","E01031685","15-19 years","Female",33,43,51,48,43,218
"Horsham 016D","E01031685","20-24 years","Female",26,26,30,31,36,149
"Horsham 016D","E01031685","25-29 years","Female",23,20,24,22,19,108
"Horsham 016D","E01031685","30-34 years","Female",31,35,32,28,30,156
"Horsham 016D","E01031685","35-39 years","Female",38,35,35,29,34,171
"Horsham 016D","E01031685","40-44 years","Female",52,47,49,50,42,240
"Horsham 016D","E01031685","45-49 years","Female",73,73,67,52,61,326
"Horsham 016D","E01031685","50-54 years","Female",60,67,67,76,82,352
"Horsham 016D","E01031685","55-59 years","Female",52,45,51,54,50,252
"Horsham 016D","E01031685","60-64 years","Female",69,70,62,51,41,293
"Horsham 016D","E01031685","65-69 years","Female",69,68,71,79,87,374
"Horsham 016D","E01031685","70-74 years","Female",92,104,110,104,91,501
"Horsham 016D","E01031685","75-79 years","Female",71,71,82,82,86,392
"Horsham 016D","E01031685","80-84 years","Female",42,42,50,49,55,238
"Horsham 016D","E01031685","85+ years","Female",98,93,87,86,85,449
"Horsham 016E","E01031686","0-4 years","Male",16,12,14,13,13,68
"Horsham 016E","E01031686","5-9 years","Male",39,39,41,37,34,190
"Horsham 016E","E01031686","10-14 years","Male",40,37,34,44,41,196
"Horsham 016E","E01031686","15-19 years","Male",44,38,40,28,31,181
"Horsham 016E","E01031686","20-24 years","Male",23,25,24,24,26,122
"Horsham 016E","E01031686","25-29 years","Male",17,15,18,18,16,84
"Horsham 016E","E01031686","30-34 years","Male",21,20,23,24,27,115
"Horsham 016E","E01031686","35-39 years","Male",15,15,17,22,20,89
"Horsham 016E","E01031686","40-44 years","Male",26,24,23,20,22,115
"Horsham 016E","E01031686","45-49 years","Male",36,37,32,28,27,160
"Horsham 016E","E01031686","50-54 years","Male",56,51,59,59,48,273
"Horsham 016E","E01031686","55-59 years","Male",52,59,59,67,80,317
"Horsham 016E","E01031686","60-64 years","Male",43,41,37,38,45,204
"Horsham 016E","E01031686","65-69 years","Male",68,61,58,48,44,279
"Horsham 016E","E01031686","70-74 years","Male",48,60,56,65,67,296
"Horsham 016E","E01031686","75-79 years","Male",70,63,67,62,61,323
"Horsham 016E","E01031686","80-84 years","Male",32,41,40,37,43,193
"Horsham 016E","E01031686","85+ years","Male",26,22,21,22,19,110
"Horsham 016E","E01031686","0-4 years","Female",24,19,22,15,16,96
"Horsham 016E","E01031686","5-9 years","Female",32,31,27,29,33,152
"Horsham 016E","E01031686","10-14 years","Female",32,35,36,40,42,185
"Horsham 016E","E01031686","15-19 years","Female",36,31,30,34,39,170
"Horsham 016E","E01031686","20-24 years","Female",35,28,26,21,24,134
"Horsham 016E","E01031686","25-29 years","Female",10,10,9,7,6,42
"Horsham 016E","E01031686","30-34 years","Female",23,23,21,23,26,116
"Horsham 016E","E01031686","35-39 years","Female",17,17,19,20,13,86
"Horsham 016E","E01031686","40-44 years","Female",47,36,35,32,32,182
"Horsham 016E","E01031686","45-49 years","Female",46,45,49,50,51,241
"Horsham 016E","E01031686","50-54 years","Female",54,49,48,47,45,243
"Horsham 016E","E01031686","55-59 years","Female",49,56,64,71,72,312
"Horsham 016E","E01031686","60-64 years","Female",57,56,46,45,52,256
"Horsham 016E","E01031686","65-69 years","Female",68,65,58,61,55,307
"Horsham 016E","E01031686","70-74 years","Female",67,71,74,68,67,347
"Horsham 016E","E01031686","75-79 years","Female",56,60,68,69,77,330
"Horsham 016E","E01031686","80-84 years","Female",52,55,54,54,49,264
"Horsham 016E","E01031686","85+ years","Female",39,30,31,40,41,181
"Mid Sussex 001A","E01031731","0-4 years","Male",66,58,61,50,52,287
"Mid Sussex 001A","E01031731","5-9 years","Male",94,95,97,95,85,466
"Mid Sussex 001A","E01031731","10-14 years","Male",53,55,52,61,67,288
"Mid Sussex 001A","E01031731","15-19 years","Male",50,47,47,46,46,236
"Mid Sussex 001A","E01031731","20-24 years","Male",57,63,64,55,51,290
"Mid Sussex 001A","E01031731","25-29 years","Male",52,48,51,51,50,252
"Mid Sussex 001A","E01031731","30-34 years","Male",53,52,57,66,67,295
"Mid Sussex 001A","E01031731","35-39 years","Male",63,73,75,60,66,337
"Mid Sussex 001A","E01031731","40-44 years","Male",69,53,63,66,57,308
"Mid Sussex 001A","E01031731","45-49 years","Male",63,70,76,79,79,367
"Mid Sussex 001A","E01031731","50-54 years","Male",59,58,62,64,68,311
"Mid Sussex 001A","E01031731","55-59 years","Male",66,62,66,66,65,325
"Mid Sussex 001A","E01031731","60-64 years","Male",50,53,54,60,66,283
"Mid Sussex 001A","E01031731","65-69 years","Male",44,50,57,62,62,275
"Mid Sussex 001A","E01031731","70-74 years","Male",33,31,28,25,25,142
"Mid Sussex 001A","E01031731","75-79 years","Male",31,27,29,30,27,144
"Mid Sussex 001A","E01031731","80-84 years","Male",13,16,20,17,17,83
"Mid Sussex 001A","E01031731","85+ years","Male",39,40,35,26,34,174
"Mid Sussex 001A","E01031731","0-4 years","Female",82,63,71,51,53,320
"Mid Sussex 001A","E01031731","5-9 years","Female",69,67,56,69,68,329
"Mid Sussex 001A","E01031731","10-14 years","Female",61,67,76,78,78,360
"Mid Sussex 001A","E01031731","15-19 years","Female",61,63,69,62,61,316
"Mid Sussex 001A","E01031731","20-24 years","Female",39,37,36,41,38,191
"Mid Sussex 001A","E01031731","25-29 years","Female",77,62,57,46,46,288
"Mid Sussex 001A","E01031731","30-34 years","Female",74,73,68,73,70,358
"Mid Sussex 001A","E01031731","35-39 years","Female",63,71,81,77,78,370
"Mid Sussex 001A","E01031731","40-44 years","Female",71,60,60,61,59,311
"Mid Sussex 001A","E01031731","45-49 years","Female",68,78,81,83,81,391
"Mid Sussex 001A","E01031731","50-54 years","Female",68,68,71,72,71,350
"Mid Sussex 001A","E01031731","55-59 years","Female",62,67,68,70,70,337
"Mid Sussex 001A","E01031731","60-64 years","Female",52,47,48,41,48,236
"Mid Sussex 001A","E01031731","65-69 years","Female",39,42,45,48,53,227
"Mid Sussex 001A","E01031731","70-74 years","Female",53,58,58,54,45,268
"Mid Sussex 001A","E01031731","75-79 years","Female",27,27,31,38,33,156
"Mid Sussex 001A","E01031731","80-84 years","Female",28,32,28,20,21,129
"Mid Sussex 001A","E01031731","85+ years","Female",44,43,37,34,34,192
"Mid Sussex 001B","E01031732","0-4 years","Male",63,56,58,63,68,308
"Mid Sussex 001B","E01031732","5-9 years","Male",74,81,83,73,67,378
"Mid Sussex 001B","E01031732","10-14 years","Male",70,70,57,52,58,307
"Mid Sussex 001B","E01031732","15-19 years","Male",70,59,68,67,71,335
"Mid Sussex 001B","E01031732","20-24 years","Male",37,39,36,42,41,195
"Mid Sussex 001B","E01031732","25-29 years","Male",45,41,45,30,32,193
"Mid Sussex 001B","E01031732","30-34 years","Male",51,48,48,58,55,260
"Mid Sussex 001B","E01031732","35-39 years","Male",65,71,55,49,45,285
"Mid Sussex 001B","E01031732","40-44 years","Male",54,49,60,60,64,287
"Mid Sussex 001B","E01031732","45-49 years","Male",74,72,75,64,65,350
"Mid Sussex 001B","E01031732","50-54 years","Male",62,64,60,65,65,316
"Mid Sussex 001B","E01031732","55-59 years","Male",61,59,57,63,65,305
"Mid Sussex 001B","E01031732","60-64 years","Male",44,51,50,54,58,257
"Mid Sussex 001B","E01031732","65-69 years","Male",59,51,47,39,36,232
"Mid Sussex 001B","E01031732","70-74 years","Male",36,48,51,54,56,245
"Mid Sussex 001B","E01031732","75-79 years","Male",21,20,19,22,28,110
"Mid Sussex 001B","E01031732","80-84 years","Male",19,24,23,14,16,96
"Mid Sussex 001B","E01031732","85+ years","Male",23,19,24,24,22,112
"Mid Sussex 001B","E01031732","0-4 years","Female",57,51,50,62,53,273
"Mid Sussex 001B","E01031732","5-9 years","Female",81,77,77,75,76,386
"Mid Sussex 001B","E01031732","10-14 years","Female",71,74,70,69,80,364
"Mid Sussex 001B","E01031732","15-19 years","Female",47,44,57,53,51,252
"Mid Sussex 001B","E01031732","20-24 years","Female",34,34,32,35,28,163
"Mid Sussex 001B","E01031732","25-29 years","Female",49,54,48,45,43,239
"Mid Sussex 001B","E01031732","30-34 years","Female",66,58,55,56,61,296
"Mid Sussex 001B","E01031732","35-39 years","Female",70,74,74,75,78,371
"Mid Sussex 001B","E01031732","40-44 years","Female",67,68,69,64,64,332
"Mid Sussex 001B","E01031732","45-49 years","Female",75,72,60,69,68,344
"Mid Sussex 001B","E01031732","50-54 years","Female",74,67,79,71,71,362
"Mid Sussex 001B","E01031732","55-59 years","Female",63,72,68,72,66,341
"Mid Sussex 001B","E01031732","60-64 years","Female",57,56,56,50,64,283
"Mid Sussex 001B","E01031732","65-69 years","Female",54,46,46,49,53,248
"Mid Sussex 001B","E01031732","70-74 years","Female",36,40,46,41,37,200
"Mid Sussex 001B","E01031732","75-79 years","Female",24,22,25,36,40,147
"Mid Sussex 001B","E01031732","80-84 years","Female",34,31,30,24,24,143
"Mid Sussex 001B","E01031732","85+ years","Female",49,55,54,62,63,283
"Mid Sussex 001C","E01031733","0-4 years","Male",56,47,49,40,39,231
"Mid Sussex 001C","E01031733","5-9 years","Male",50,60,55,57,58,280
"Mid Sussex 001C","E01031733","10-14 years","Male",33,37,41,44,46,201
"Mid Sussex 001C","E01031733","15-19 years","Male",45,38,36,36,35,190
"Mid Sussex 001C","E01031733","20-24 years","Male",33,32,33,41,38,177
"Mid Sussex 001C","E01031733","25-29 years","Male",48,49,51,50,51,249
"Mid Sussex 001C","E01031733","30-34 years","Male",65,64,56,63,52,300
"Mid Sussex 001C","E01031733","35-39 years","Male",64,61,55,63,71,314
"Mid Sussex 001C","E01031733","40-44 years","Male",46,49,56,55,49,255
"Mid Sussex 001C","E01031733","45-49 years","Male",81,75,59,60,66,341
"Mid Sussex 001C","E01031733","50-54 years","Male",63,63,68,72,75,341
"Mid Sussex 001C","E01031733","55-59 years","Male",71,68,68,75,79,361
"Mid Sussex 001C","E01031733","60-64 years","Male",41,40,45,49,50,225
"Mid Sussex 001C","E01031733","65-69 years","Male",43,41,39,43,38,204
"Mid Sussex 001C","E01031733","70-74 years","Male",35,37,45,36,35,188
"Mid Sussex 001C","E01031733","75-79 years","Male",17,16,16,27,27,103
"Mid Sussex 001C","E01031733","80-84 years","Male",12,13,12,11,8,56
"Mid Sussex 001C","E01031733","85+ years","Male",13,11,12,12,12,60
"Mid Sussex 001C","E01031733","0-4 years","Female",62,76,57,55,46,296
"Mid Sussex 001C","E01031733","5-9 years","Female",55,66,65,67,62,315
"Mid Sussex 001C","E01031733","10-14 years","Female",47,39,38,44,62,230
"Mid Sussex 001C","E01031733","15-19 years","Female",43,41,38,32,37,191
"Mid Sussex 001C","E01031733","20-24 years","Female",33,36,40,43,34,186
"Mid Sussex 001C","E01031733","25-29 years","Female",58,69,66,49,53,295
"Mid Sussex 001C","E01031733","30-34 years","Female",53,51,48,50,46,248
"Mid Sussex 001C","E01031733","35-39 years","Female",69,72,54,58,46,299
"Mid Sussex 001C","E01031733","40-44 years","Female",66,67,75,69,77,354
"Mid Sussex 001C","E01031733","45-49 years","Female",68,63,67,65,62,325
"Mid Sussex 001C","E01031733","50-54 years","Female",68,73,72,77,76,366
"Mid Sussex 001C","E01031733","55-59 years","Female",47,40,49,47,58,241
"Mid Sussex 001C","E01031733","60-64 years","Female",71,63,63,58,52,307
"Mid Sussex 001C","E01031733","65-69 years","Female",65,62,62,59,63,311
"Mid Sussex 001C","E01031733","70-74 years","Female",35,37,40,48,53,213
"Mid Sussex 001C","E01031733","75-79 years","Female",18,19,22,21,23,103
"Mid Sussex 001C","E01031733","80-84 years","Female",30,28,28,33,33,152
"Mid Sussex 001C","E01031733","85+ years","Female",40,38,30,30,25,163
"Mid Sussex 001D","E01031734","0-4 years","Male",52,46,38,29,26,191
"Mid Sussex 001D","E01031734","5-9 years","Male",47,56,57,59,58,277
"Mid Sussex 001D","E01031734","10-14 years","Male",56,59,58,58,56,287
"Mid Sussex 001D","E01031734","15-19 years","Male",47,45,45,43,45,225
"Mid Sussex 001D","E01031734","20-24 years","Male",53,43,39,38,35,208
"Mid Sussex 001D","E01031734","25-29 years","Male",40,34,38,35,42,189
"Mid Sussex 001D","E01031734","30-34 years","Male",34,31,30,27,24,146
"Mid Sussex 001D","E01031734","35-39 years","Male",51,53,42,45,43,234
"Mid Sussex 001D","E01031734","40-44 years","Male",34,34,45,46,49,208
"Mid Sussex 001D","E01031734","45-49 years","Male",74,67,64,68,60,333
"Mid Sussex 001D","E01031734","50-54 years","Male",56,53,54,55,61,279
"Mid Sussex 001D","E01031734","55-59 years","Male",69,67,63,60,58,317
"Mid Sussex 001D","E01031734","60-64 years","Male",63,65,66,61,61,316
"Mid Sussex 001D","E01031734","65-69 years","Male",62,58,55,57,55,287
"Mid Sussex 001D","E01031734","70-74 years","Male",38,38,33,37,44,190
"Mid Sussex 001D","E01031734","75-79 years","Male",24,26,30,29,26,135
"Mid Sussex 001D","E01031734","80-84 years","Male",21,17,20,18,20,96
"Mid Sussex 001D","E01031734","85+ years","Male",20,22,19,29,29,119
"Mid Sussex 001D","E01031734","0-4 years","Female",43,35,35,29,29,171
"Mid Sussex 001D","E01031734","5-9 years","Female",33,34,35,39,38,179
"Mid Sussex 001D","E01031734","10-14 years","Female",35,29,33,35,35,167
"Mid Sussex 001D","E01031734","15-19 years","Female",53,49,52,54,50,258
"Mid Sussex 001D","E01031734","20-24 years","Female",32,35,35,32,25,159
"Mid Sussex 001D","E01031734","25-29 years","Female",41,34,33,32,46,186
"Mid Sussex 001D","E01031734","30-34 years","Female",51,45,47,51,44,238
"Mid Sussex 001D","E01031734","35-39 years","Female",46,42,43,46,38,215
"Mid Sussex 001D","E01031734","40-44 years","Female",59,60,54,51,51,275
"Mid Sussex 001D","E01031734","45-49 years","Female",66,74,67,70,69,346
"Mid Sussex 001D","E01031734","50-54 years","Female",59,61,54,52,53,279
"Mid Sussex 001D","E01031734","55-59 years","Female",75,70,72,71,73,361
"Mid Sussex 001D","E01031734","60-64 years","Female",55,52,57,52,52,268
"Mid Sussex 001D","E01031734","65-69 years","Female",41,40,41,43,41,206
"Mid Sussex 001D","E01031734","70-74 years","Female",54,53,53,48,52,260
"Mid Sussex 001D","E01031734","75-79 years","Female",18,27,27,41,38,151
"Mid Sussex 001D","E01031734","80-84 years","Female",17,21,18,14,15,85
"Mid Sussex 001D","E01031734","85+ years","Female",15,16,17,16,16,80
"Mid Sussex 001E","E01031741","0-4 years","Male",43,67,71,82,82,345
"Mid Sussex 001E","E01031741","5-9 years","Male",26,35,36,40,39,176
"Mid Sussex 001E","E01031741","10-14 years","Male",45,50,53,55,61,264
"Mid Sussex 001E","E01031741","15-19 years","Male",39,34,38,38,43,192
"Mid Sussex 001E","E01031741","20-24 years","Male",27,32,39,44,36,178
"Mid Sussex 001E","E01031741","25-29 years","Male",56,63,81,87,85,372
"Mid Sussex 001E","E01031741","30-34 years","Male",74,81,77,76,81,389
"Mid Sussex 001E","E01031741","35-39 years","Male",83,83,84,92,92,434
"Mid Sussex 001E","E01031741","40-44 years","Male",77,86,93,91,100,447
"Mid Sussex 001E","E01031741","45-49 years","Male",55,49,57,68,63,292
"Mid Sussex 001E","E01031741","50-54 years","Male",68,69,69,75,84,365
"Mid Sussex 001E","E01031741","55-59 years","Male",35,49,57,46,51,238
"Mid Sussex 001E","E01031741","60-64 years","Male",53,50,47,39,46,235
"Mid Sussex 001E","E01031741","65-69 years","Male",45,46,48,54,47,240
"Mid Sussex 001E","E01031741","70-74 years","Male",44,39,42,45,43,213
"Mid Sussex 001E","E01031741","75-79 years","Male",20,26,30,32,39,147
"Mid Sussex 001E","E01031741","80-84 years","Male",18,19,19,21,18,95
"Mid Sussex 001E","E01031741","85+ years","Male",18,18,20,16,15,87
"Mid Sussex 001E","E01031741","0-4 years","Female",56,60,61,68,76,321
"Mid Sussex 001E","E01031741","5-9 years","Female",61,84,74,65,59,343
"Mid Sussex 001E","E01031741","10-14 years","Female",24,20,29,39,46,158
"Mid Sussex 001E","E01031741","15-19 years","Female",38,41,35,41,37,192
"Mid Sussex 001E","E01031741","20-24 years","Female",28,34,41,42,45,190
"Mid Sussex 001E","E01031741","25-29 years","Female",75,86,86,89,94,430
"Mid Sussex 001E","E01031741","30-34 years","Female",71,83,80,93,96,423
"Mid Sussex 001E","E01031741","35-39 years","Female",56,74,81,83,85,379
"Mid Sussex 001E","E01031741","40-44 years","Female",83,76,71,80,86,396
"Mid Sussex 001E","E01031741","45-49 years","Female",37,37,47,53,52,226
"Mid Sussex 001E","E01031741","50-54 years","Female",60,59,52,45,54,270
"Mid Sussex 001E","E01031741","55-59 years","Female",43,38,52,53,55,241
"Mid Sussex 001E","E01031741","60-64 years","Female",52,55,53,58,57,275
"Mid Sussex 001E","E01031741","65-69 years","Female",35,37,44,50,52,218
"Mid Sussex 001E","E01031741","70-74 years","Female",47,46,43,45,42,223
"Mid Sussex 001E","E01031741","75-79 years","Female",37,36,34,42,53,202
"Mid Sussex 001E","E01031741","80-84 years","Female",26,31,34,32,36,159
"Mid Sussex 001E","E01031741","85+ years","Female",56,55,55,59,55,280
"Mid Sussex 001F","E01031742","0-4 years","Male",59,59,52,62,63,295
"Mid Sussex 001F","E01031742","5-9 years","Male",35,38,42,48,44,207
"Mid Sussex 001F","E01031742","10-14 years","Male",57,59,64,70,76,326
"Mid Sussex 001F","E01031742","15-19 years","Male",55,55,59,66,56,291
"Mid Sussex 001F","E01031742","20-24 years","Male",55,63,60,54,77,309
"Mid Sussex 001F","E01031742","25-29 years","Male",63,51,49,76,69,308
"Mid Sussex 001F","E01031742","30-34 years","Male",65,61,61,68,68,323
"Mid Sussex 001F","E01031742","35-39 years","Male",76,68,78,73,75,370
"Mid Sussex 001F","E01031742","40-44 years","Male",63,67,74,79,86,369
"Mid Sussex 001F","E01031742","45-49 years","Male",64,54,52,54,65,289
"Mid Sussex 001F","E01031742","50-54 years","Male",71,92,91,87,80,421
"Mid Sussex 001F","E01031742","55-59 years","Male",55,56,49,64,66,290
"Mid Sussex 001F","E01031742","60-64 years","Male",61,54,58,51,58,282
"Mid Sussex 001F","E01031742","65-69 years","Male",51,49,48,49,49,246
"Mid Sussex 001F","E01031742","70-74 years","Male",42,38,43,48,50,221
"Mid Sussex 001F","E01031742","75-79 years","Male",29,36,45,39,49,198
"Mid Sussex 001F","E01031742","80-84 years","Male",29,22,22,22,24,119
"Mid Sussex 001F","E01031742","85+ years","Male",37,43,41,38,30,189
"Mid Sussex 001F","E01031742","0-4 years","Female",48,46,42,38,35,209
"Mid Sussex 001F","E01031742","5-9 years","Female",23,32,35,35,35,160
"Mid Sussex 001F","E01031742","10-14 years","Female",32,32,36,36,38,174
"Mid Sussex 001F","E01031742","15-19 years","Female",36,38,38,40,43,195
"Mid Sussex 001F","E01031742","20-24 years","Female",41,45,36,41,34,197
"Mid Sussex 001F","E01031742","25-29 years","Female",63,69,69,71,65,337
"Mid Sussex 001F","E01031742","30-34 years","Female",64,68,78,77,82,369
"Mid Sussex 001F","E01031742","35-39 years","Female",62,62,56,63,69,312
"Mid Sussex 001F","E01031742","40-44 years","Female",63,75,79,73,70,360
"Mid Sussex 001F","E01031742","45-49 years","Female",71,76,70,89,93,399
"Mid Sussex 001F","E01031742","50-54 years","Female",55,52,58,61,70,296
"Mid Sussex 001F","E01031742","55-59 years","Female",43,47,49,49,47,235
"Mid Sussex 001F","E01031742","60-64 years","Female",48,42,42,49,49,230
"Mid Sussex 001F","E01031742","65-69 years","Female",64,63,62,55,53,297
"Mid Sussex 001F","E01031742","70-74 years","Female",57,55,62,61,60,295
"Mid Sussex 001F","E01031742","75-79 years","Female",48,67,65,67,75,322
"Mid Sussex 001F","E01031742","80-84 years","Female",66,59,52,51,53,281
"Mid Sussex 001F","E01031742","85+ years","Female",137,131,135,136,124,663
"Mid Sussex 001G","E01031743","0-4 years","Male",63,61,53,51,47,275
"Mid Sussex 001G","E01031743","5-9 years","Male",48,57,59,61,57,282
"Mid Sussex 001G","E01031743","10-14 years","Male",24,29,32,29,35,149
"Mid Sussex 001G","E01031743","15-19 years","Male",40,35,35,44,43,197
"Mid Sussex 001G","E01031743","20-24 years","Male",22,26,32,30,37,147
"Mid Sussex 001G","E01031743","25-29 years","Male",62,53,49,43,36,243
"Mid Sussex 001G","E01031743","30-34 years","Male",70,49,49,53,53,274
"Mid Sussex 001G","E01031743","35-39 years","Male",54,64,61,66,56,301
"Mid Sussex 001G","E01031743","40-44 years","Male",63,62,67,62,78,332
"Mid Sussex 001G","E01031743","45-49 years","Male",91,92,85,95,93,456
"Mid Sussex 001G","E01031743","50-54 years","Male",74,70,65,69,71,349
"Mid Sussex 001G","E01031743","55-59 years","Male",57,63,68,73,79,340
"Mid Sussex 001G","E01031743","60-64 years","Male",47,43,41,30,37,198
"Mid Sussex 001G","E01031743","65-69 years","Male",28,34,33,33,30,158
"Mid Sussex 001G","E01031743","70-74 years","Male",37,35,31,37,37,177
"Mid Sussex 001G","E01031743","75-79 years","Male",21,20,22,24,19,106
"Mid Sussex 001G","E01031743","80-84 years","Male",17,18,25,22,22,104
"Mid Sussex 001G","E01031743","85+ years","Male",7,6,12,9,12,46
"Mid Sussex 001G","E01031743","0-4 years","Female",61,62,58,52,46,279
"Mid Sussex 001G","E01031743","5-9 years","Female",53,48,53,52,57,263
"Mid Sussex 001G","E01031743","10-14 years","Female",37,48,51,53,57,246
"Mid Sussex 001G","E01031743","15-19 years","Female",28,24,24,23,28,127
"Mid Sussex 001G","E01031743","20-24 years","Female",38,36,36,26,22,158
"Mid Sussex 001G","E01031743","25-29 years","Female",65,67,72,70,69,343
"Mid Sussex 001G","E01031743","30-34 years","Female",69,69,77,74,73,362
"Mid Sussex 001G","E01031743","35-39 years","Female",66,59,56,60,57,298
"Mid Sussex 001G","E01031743","40-44 years","Female",55,68,72,75,68,338
"Mid Sussex 001G","E01031743","45-49 years","Female",51,53,66,72,76,318
"Mid Sussex 001G","E01031743","50-54 years","Female",55,53,42,43,48,241
"Mid Sussex 001G","E01031743","55-59 years","Female",58,60,65,61,72,316
"Mid Sussex 001G","E01031743","60-64 years","Female",29,28,33,35,35,160
"Mid Sussex 001G","E01031743","65-69 years","Female",41,38,35,38,35,187
"Mid Sussex 001G","E01031743","70-74 years","Female",37,48,46,48,47,226
"Mid Sussex 001G","E01031743","75-79 years","Female",22,20,23,28,28,121
"Mid Sussex 001G","E01031743","80-84 years","Female",12,12,13,11,12,60
"Mid Sussex 001G","E01031743","85+ years","Female",11,14,14,10,10,59
"Mid Sussex 002A","E01031718","0-4 years","Male",41,54,48,60,63,266
"Mid Sussex 002A","E01031718","5-9 years","Male",62,51,61,61,62,297
"Mid Sussex 002A","E01031718","10-14 years","Male",43,47,50,47,46,233
"Mid Sussex 002A","E01031718","15-19 years","Male",45,35,35,37,36,188
"Mid Sussex 002A","E01031718","20-24 years","Male",65,77,65,60,54,321
"Mid Sussex 002A","E01031718","25-29 years","Male",60,54,56,60,66,296
"Mid Sussex 002A","E01031718","30-34 years","Male",38,40,44,37,36,195
"Mid Sussex 002A","E01031718","35-39 years","Male",41,42,42,50,61,236
"Mid Sussex 002A","E01031718","40-44 years","Male",50,52,59,54,55,270
"Mid Sussex 002A","E01031718","45-49 years","Male",87,78,74,70,60,369
"Mid Sussex 002A","E01031718","50-54 years","Male",66,74,70,65,72,347
"Mid Sussex 002A","E01031718","55-59 years","Male",70,72,73,69,68,352
"Mid Sussex 002A","E01031718","60-64 years","Male",60,61,60,65,68,314
"Mid Sussex 002A","E01031718","65-69 years","Male",75,61,61,61,59,317
"Mid Sussex 002A","E01031718","70-74 years","Male",37,37,42,47,56,219
"Mid Sussex 002A","E01031718","75-79 years","Male",25,30,34,34,31,154
"Mid Sussex 002A","E01031718","80-84 years","Male",13,14,10,13,16,66
"Mid Sussex 002A","E01031718","85+ years","Male",15,16,13,16,24,84
"Mid Sussex 002A","E01031718","0-4 years","Female",49,57,54,53,59,272
"Mid Sussex 002A","E01031718","5-9 years","Female",45,50,49,47,52,243
"Mid Sussex 002A","E01031718","10-14 years","Female",48,47,50,51,60,256
"Mid Sussex 002A","E01031718","15-19 years","Female",50,46,50,56,49,251
"Mid Sussex 002A","E01031718","20-24 years","Female",43,42,45,41,40,211
"Mid Sussex 002A","E01031718","25-29 years","Female",52,40,44,43,46,225
"Mid Sussex 002A","E01031718","30-34 years","Female",51,56,48,48,45,248
"Mid Sussex 002A","E01031718","35-39 years","Female",69,63,73,69,82,356
"Mid Sussex 002A","E01031718","40-44 years","Female",53,65,65,70,67,320
"Mid Sussex 002A","E01031718","45-49 years","Female",78,71,68,66,61,344
"Mid Sussex 002A","E01031718","50-54 years","Female",76,73,63,70,73,355
"Mid Sussex 002A","E01031718","55-59 years","Female",76,80,75,66,61,358
"Mid Sussex 002A","E01031718","60-64 years","Female",62,64,72,80,84,362
"Mid Sussex 002A","E01031718","65-69 years","Female",57,49,51,51,55,263
"Mid Sussex 002A","E01031718","70-74 years","Female",50,57,59,56,57,279
"Mid Sussex 002A","E01031718","75-79 years","Female",28,23,21,29,30,131
"Mid Sussex 002A","E01031718","80-84 years","Female",26,29,33,30,30,148
"Mid Sussex 002A","E01031718","85+ years","Female",32,33,31,31,30,157
"Mid Sussex 002B","E01031719","0-4 years","Male",34,36,35,41,49,195
"Mid Sussex 002B","E01031719","5-9 years","Male",42,37,35,33,32,179
"Mid Sussex 002B","E01031719","10-14 years","Male",50,44,44,45,39,222
"Mid Sussex 002B","E01031719","15-19 years","Male",62,66,59,51,53,291
"Mid Sussex 002B","E01031719","20-24 years","Male",31,30,40,42,43,186
"Mid Sussex 002B","E01031719","25-29 years","Male",33,32,34,32,29,160
"Mid Sussex 002B","E01031719","30-34 years","Male",77,70,55,51,61,314
"Mid Sussex 002B","E01031719","35-39 years","Male",58,52,53,49,51,263
"Mid Sussex 002B","E01031719","40-44 years","Male",47,45,42,46,52,232
"Mid Sussex 002B","E01031719","45-49 years","Male",61,64,60,56,53,294
"Mid Sussex 002B","E01031719","50-54 years","Male",87,79,79,76,68,389
"Mid Sussex 002B","E01031719","55-59 years","Male",63,70,78,71,75,357
"Mid Sussex 002B","E01031719","60-64 years","Male",49,52,48,55,59,263
"Mid Sussex 002B","E01031719","65-69 years","Male",60,54,45,42,41,242
"Mid Sussex 002B","E01031719","70-74 years","Male",33,36,43,47,48,207
"Mid Sussex 002B","E01031719","75-79 years","Male",25,22,24,23,27,121
"Mid Sussex 002B","E01031719","80-84 years","Male",15,23,21,23,15,97
"Mid Sussex 002B","E01031719","85+ years","Male",17,13,10,10,17,67
"Mid Sussex 002B","E01031719","0-4 years","Female",49,59,54,59,58,279
"Mid Sussex 002B","E01031719","5-9 years","Female",44,43,47,53,56,243
"Mid Sussex 002B","E01031719","10-14 years","Female",64,70,59,48,45,286
"Mid Sussex 002B","E01031719","15-19 years","Female",49,38,43,46,50,226
"Mid Sussex 002B","E01031719","20-24 years","Female",70,66,74,70,57,337
"Mid Sussex 002B","E01031719","25-29 years","Female",43,46,48,43,45,225
"Mid Sussex 002B","E01031719","30-34 years","Female",51,50,43,45,49,238
"Mid Sussex 002B","E01031719","35-39 years","Female",46,56,57,50,50,259
"Mid Sussex 002B","E01031719","40-44 years","Female",60,50,54,64,63,291
"Mid Sussex 002B","E01031719","45-49 years","Female",69,63,66,55,53,306
"Mid Sussex 002B","E01031719","50-54 years","Female",68,73,72,77,75,365
"Mid Sussex 002B","E01031719","55-59 years","Female",57,63,63,59,69,311
"Mid Sussex 002B","E01031719","60-64 years","Female",61,63,66,65,67,322
"Mid Sussex 002B","E01031719","65-69 years","Female",53,46,46,46,45,236
"Mid Sussex 002B","E01031719","70-74 years","Female",51,56,55,51,46,259
"Mid Sussex 002B","E01031719","75-79 years","Female",25,28,36,45,53,187
"Mid Sussex 002B","E01031719","80-84 years","Female",28,27,32,25,19,131
"Mid Sussex 002B","E01031719","85+ years","Female",23,26,27,31,31,138
"Mid Sussex 002C","E01031720","0-4 years","Male",33,27,29,25,29,143
"Mid Sussex 002C","E01031720","5-9 years","Male",46,47,48,62,50,253
"Mid Sussex 002C","E01031720","10-14 years","Male",54,54,48,45,42,243
"Mid Sussex 002C","E01031720","15-19 years","Male",46,45,54,50,44,239
"Mid Sussex 002C","E01031720","20-24 years","Male",32,37,35,37,42,183
"Mid Sussex 002C","E01031720","25-29 years","Male",28,24,30,27,28,137
"Mid Sussex 002C","E01031720","30-34 years","Male",18,19,21,20,21,99
"Mid Sussex 002C","E01031720","35-39 years","Male",38,31,28,32,33,162
"Mid Sussex 002C","E01031720","40-44 years","Male",53,51,52,57,63,276
"Mid Sussex 002C","E01031720","45-49 years","Male",56,55,56,57,56,280
"Mid Sussex 002C","E01031720","50-54 years","Male",62,56,53,53,47,271
"Mid Sussex 002C","E01031720","55-59 years","Male",60,63,62,53,57,295
"Mid Sussex 002C","E01031720","60-64 years","Male",51,49,56,65,64,285
"Mid Sussex 002C","E01031720","65-69 years","Male",53,48,49,38,34,222
"Mid Sussex 002C","E01031720","70-74 years","Male",39,49,56,58,55,257
"Mid Sussex 002C","E01031720","75-79 years","Male",32,29,30,34,42,167
"Mid Sussex 002C","E01031720","80-84 years","Male",26,28,25,26,22,127
"Mid Sussex 002C","E01031720","85+ years","Male",22,22,20,23,16,103
"Mid Sussex 002C","E01031720","0-4 years","Female",23,24,30,34,33,144
"Mid Sussex 002C","E01031720","5-9 years","Female",40,36,42,40,34,192
"Mid Sussex 002C","E01031720","10-14 years","Female",43,32,28,31,31,165
"Mid Sussex 002C","E01031720","15-19 years","Female",44,41,51,48,48,232
"Mid Sussex 002C","E01031720","20-24 years","Female",24,20,19,23,21,107
"Mid Sussex 002C","E01031720","25-29 years","Female",23,18,24,27,29,121
"Mid Sussex 002C","E01031720","30-34 years","Female",29,28,36,34,37,164
"Mid Sussex 002C","E01031720","35-39 years","Female",55,50,29,31,35,200
"Mid Sussex 002C","E01031720","40-44 years","Female",36,33,47,47,45,208
"Mid Sussex 002C","E01031720","45-49 years","Female",62,58,47,40,43,250
"Mid Sussex 002C","E01031720","50-54 years","Female",52,51,57,64,63,287
"Mid Sussex 002C","E01031720","55-59 years","Female",58,65,68,62,53,306
"Mid Sussex 002C","E01031720","60-64 years","Female",47,48,47,47,58,247
"Mid Sussex 002C","E01031720","65-69 years","Female",52,39,37,36,34,198
"Mid Sussex 002C","E01031720","70-74 years","Female",39,45,50,52,50,236
"Mid Sussex 002C","E01031720","75-79 years","Female",38,38,35,42,39,192
"Mid Sussex 002C","E01031720","80-84 years","Female",28,34,39,37,33,171
"Mid Sussex 002C","E01031720","85+ years","Female",48,43,43,47,37,218
"Mid Sussex 002D","E01031722","0-4 years","Male",37,39,32,32,28,168
"Mid Sussex 002D","E01031722","5-9 years","Male",44,52,51,48,50,245
"Mid Sussex 002D","E01031722","10-14 years","Male",67,75,83,83,62,370
"Mid Sussex 002D","E01031722","15-19 years","Male",133,148,157,179,140,757
"Mid Sussex 002D","E01031722","20-24 years","Male",23,27,35,44,61,190
"Mid Sussex 002D","E01031722","25-29 years","Male",20,21,23,25,26,115
"Mid Sussex 002D","E01031722","30-34 years","Male",31,27,32,31,27,148
"Mid Sussex 002D","E01031722","35-39 years","Male",41,44,33,36,50,204
"Mid Sussex 002D","E01031722","40-44 years","Male",52,42,42,41,35,212
"Mid Sussex 002D","E01031722","45-49 years","Male",35,36,32,32,36,171
"Mid Sussex 002D","E01031722","50-54 years","Male",59,58,54,51,42,264
"Mid Sussex 002D","E01031722","55-59 years","Male",50,45,56,51,52,254
"Mid Sussex 002D","E01031722","60-64 years","Male",39,33,31,28,30,161
"Mid Sussex 002D","E01031722","65-69 years","Male",41,42,31,26,31,171
"Mid Sussex 002D","E01031722","70-74 years","Male",24,28,35,38,36,161
"Mid Sussex 002D","E01031722","75-79 years","Male",20,25,25,30,26,126
"Mid Sussex 002D","E01031722","80-84 years","Male",10,9,12,10,10,51
"Mid Sussex 002D","E01031722","85+ years","Male",20,18,19,18,17,92
"Mid Sussex 002D","E01031722","0-4 years","Female",30,34,35,36,41,176
"Mid Sussex 002D","E01031722","5-9 years","Female",28,30,33,34,30,155
"Mid Sussex 002D","E01031722","10-14 years","Female",41,38,32,39,42,192
"Mid Sussex 002D","E01031722","15-19 years","Female",80,87,87,97,79,430
"Mid Sussex 002D","E01031722","20-24 years","Female",16,15,21,26,24,102
"Mid Sussex 002D","E01031722","25-29 years","Female",30,37,26,27,25,145
"Mid Sussex 002D","E01031722","30-34 years","Female",31,38,40,41,37,187
"Mid Sussex 002D","E01031722","35-39 years","Female",40,39,34,33,36,182
"Mid Sussex 002D","E01031722","40-44 years","Female",46,39,37,41,40,203
"Mid Sussex 002D","E01031722","45-49 years","Female",31,38,37,36,37,179
"Mid Sussex 002D","E01031722","50-54 years","Female",46,40,40,37,37,200
"Mid Sussex 002D","E01031722","55-59 years","Female",46,49,44,46,45,230
"Mid Sussex 002D","E01031722","60-64 years","Female",30,32,36,34,35,167
"Mid Sussex 002D","E01031722","65-69 years","Female",33,32,26,22,21,134
"Mid Sussex 002D","E01031722","70-74 years","Female",22,28,38,44,42,174
"Mid Sussex 002D","E01031722","75-79 years","Female",16,12,12,13,14,67
"Mid Sussex 002D","E01031722","80-84 years","Female",8,10,14,13,8,53
"Mid Sussex 002D","E01031722","85+ years","Female",7,6,4,5,4,26
"Mid Sussex 003A","E01031695","0-4 years","Male",35,31,37,35,26,164
"Mid Sussex 003A","E01031695","5-9 years","Male",49,44,36,43,44,216
"Mid Sussex 003A","E01031695","10-14 years","Male",70,78,72,81,75,376
"Mid Sussex 003A","E01031695","15-19 years","Male",44,50,42,45,40,221
"Mid Sussex 003A","E01031695","20-24 years","Male",39,31,33,25,27,155
"Mid Sussex 003A","E01031695","25-29 years","Male",28,22,25,29,26,130
"Mid Sussex 003A","E01031695","30-34 years","Male",33,35,37,36,39,180
"Mid Sussex 003A","E01031695","35-39 years","Male",44,43,35,35,31,188
"Mid Sussex 003A","E01031695","40-44 years","Male",46,41,38,40,45,210
"Mid Sussex 003A","E01031695","45-49 years","Male",62,66,68,64,53,313
"Mid Sussex 003A","E01031695","50-54 years","Male",42,37,45,47,54,225
"Mid Sussex 003A","E01031695","55-59 years","Male",46,41,41,46,41,215
"Mid Sussex 003A","E01031695","60-64 years","Male",41,40,35,39,34,189
"Mid Sussex 003A","E01031695","65-69 years","Male",54,53,47,41,42,237
"Mid Sussex 003A","E01031695","70-74 years","Male",36,36,40,41,45,198
"Mid Sussex 003A","E01031695","75-79 years","Male",20,24,23,23,24,114
"Mid Sussex 003A","E01031695","80-84 years","Male",21,18,20,19,13,91
"Mid Sussex 003A","E01031695","85+ years","Male",16,12,16,17,25,86
"Mid Sussex 003A","E01031695","0-4 years","Female",25,23,20,23,26,117
"Mid Sussex 003A","E01031695","5-9 years","Female",43,51,47,43,43,227
"Mid Sussex 003A","E01031695","10-14 years","Female",60,78,78,86,59,361
"Mid Sussex 003A","E01031695","15-19 years","Female",33,36,28,31,45,173
"Mid Sussex 003A","E01031695","20-24 years","Female",34,25,24,23,21,127
"Mid Sussex 003A","E01031695","25-29 years","Female",42,39,33,32,23,169
"Mid Sussex 003A","E01031695","30-34 years","Female",24,26,32,30,34,146
"Mid Sussex 003A","E01031695","35-39 years","Female",45,41,39,40,37,202
"Mid Sussex 003A","E01031695","40-44 years","Female",42,47,39,41,42,211
"Mid Sussex 003A","E01031695","45-49 years","Female",78,68,65,57,60,328
"Mid Sussex 003A","E01031695","50-54 years","Female",59,63,68,70,70,330
"Mid Sussex 003A","E01031695","55-59 years","Female",66,60,56,61,57,300
"Mid Sussex 003A","E01031695","60-64 years","Female",52,51,49,50,50,252
"Mid Sussex 003A","E01031695","65-69 years","Female",57,50,55,52,52,266
"Mid Sussex 003A","E01031695","70-74 years","Female",54,58,61,66,62,301
"Mid Sussex 003A","E01031695","75-79 years","Female",32,38,39,39,46,194
"Mid Sussex 003A","E01031695","80-84 years","Female",20,21,24,21,16,102
"Mid Sussex 003A","E01031695","85+ years","Female",28,27,33,29,27,144
"Mid Sussex 003B","E01031696","0-4 years","Male",38,37,44,39,31,189
"Mid Sussex 003B","E01031696","5-9 years","Male",40,44,39,45,47,215
"Mid Sussex 003B","E01031696","10-14 years","Male",42,37,32,34,40,185
"Mid Sussex 003B","E01031696","15-19 years","Male",35,36,41,34,34,180
"Mid Sussex 003B","E01031696","20-24 years","Male",32,34,32,31,27,156
"Mid Sussex 003B","E01031696","25-29 years","Male",27,21,24,27,25,124
"Mid Sussex 003B","E01031696","30-34 years","Male",36,37,30,25,27,155
"Mid Sussex 003B","E01031696","35-39 years","Male",34,34,34,38,36,176
"Mid Sussex 003B","E01031696","40-44 years","Male",45,43,44,44,42,218
"Mid Sussex 003B","E01031696","45-49 years","Male",46,47,43,54,49,239
"Mid Sussex 003B","E01031696","50-54 years","Male",82,64,71,60,61,338
"Mid Sussex 003B","E01031696","55-59 years","Male",47,61,62,69,71,310
"Mid Sussex 003B","E01031696","60-64 years","Male",52,47,46,48,54,247
"Mid Sussex 003B","E01031696","65-69 years","Male",24,24,28,29,32,137
"Mid Sussex 003B","E01031696","70-74 years","Male",40,44,38,32,29,183
"Mid Sussex 003B","E01031696","75-79 years","Male",19,22,31,34,36,142
"Mid Sussex 003B","E01031696","80-84 years","Male",12,10,13,11,10,56
"Mid Sussex 003B","E01031696","85+ years","Male",18,19,19,19,17,92
"Mid Sussex 003B","E01031696","0-4 years","Female",53,47,49,39,35,223
"Mid Sussex 003B","E01031696","5-9 years","Female",51,55,48,50,54,258
"Mid Sussex 003B","E01031696","10-14 years","Female",32,29,37,40,37,175
"Mid Sussex 003B","E01031696","15-19 years","Female",29,27,24,21,21,122
"Mid Sussex 003B","E01031696","20-24 years","Female",21,23,22,20,12,98
"Mid Sussex 003B","E01031696","25-29 years","Female",40,32,24,24,23,143
"Mid Sussex 003B","E01031696","30-34 years","Female",44,43,41,45,52,225
"Mid Sussex 003B","E01031696","35-39 years","Female",51,60,57,51,46,265
"Mid Sussex 003B","E01031696","40-44 years","Female",39,35,39,40,43,196
"Mid Sussex 003B","E01031696","45-49 years","Female",55,48,38,41,37,219
"Mid Sussex 003B","E01031696","50-54 years","Female",79,77,78,68,67,369
"Mid Sussex 003B","E01031696","55-59 years","Female",47,53,59,65,70,294
"Mid Sussex 003B","E01031696","60-64 years","Female",48,50,50,47,48,243
"Mid Sussex 003B","E01031696","65-69 years","Female",43,41,43,49,55,231
"Mid Sussex 003B","E01031696","70-74 years","Female",46,44,41,44,42,217
"Mid Sussex 003B","E01031696","75-79 years","Female",32,32,32,27,31,154
"Mid Sussex 003B","E01031696","80-84 years","Female",24,25,32,30,30,141
"Mid Sussex 003B","E01031696","85+ years","Female",15,18,20,22,16,91
"Mid Sussex 003C","E01031729","0-4 years","Male",76,73,68,60,63,340
"Mid Sussex 003C","E01031729","5-9 years","Male",79,86,83,90,86,424
"Mid Sussex 003C","E01031729","10-14 years","Male",37,40,48,58,65,248
"Mid Sussex 003C","E01031729","15-19 years","Male",61,60,51,47,38,257
"Mid Sussex 003C","E01031729","20-24 years","Male",41,41,42,40,40,204
"Mid Sussex 003C","E01031729","25-29 years","Male",57,57,53,57,47,271
"Mid Sussex 003C","E01031729","30-34 years","Male",60,52,61,65,61,299
"Mid Sussex 003C","E01031729","35-39 years","Male",67,69,72,66,67,341
"Mid Sussex 003C","E01031729","40-44 years","Male",59,62,56,63,58,298
"Mid Sussex 003C","E01031729","45-49 years","Male",79,75,75,74,84,387
"Mid Sussex 003C","E01031729","50-54 years","Male",99,101,110,102,95,507
"Mid Sussex 003C","E01031729","55-59 years","Male",78,82,75,87,92,414
"Mid Sussex 003C","E01031729","60-64 years","Male",60,76,76,73,71,356
"Mid Sussex 003C","E01031729","65-69 years","Male",89,75,75,64,71,374
"Mid Sussex 003C","E01031729","70-74 years","Male",66,76,73,85,70,370
"Mid Sussex 003C","E01031729","75-79 years","Male",35,35,40,39,48,197
"Mid Sussex 003C","E01031729","80-84 years","Male",23,29,32,41,32,157
"Mid Sussex 003C","E01031729","85+ years","Male",7,6,4,5,3,25
"Mid Sussex 003C","E01031729","0-4 years","Female",63,60,54,57,64,298
"Mid Sussex 003C","E01031729","5-9 years","Female",74,78,90,90,87,419
"Mid Sussex 003C","E01031729","10-14 years","Female",76,77,87,91,91,422
"Mid Sussex 003C","E01031729","15-19 years","Female",53,55,52,55,61,276
"Mid Sussex 003C","E01031729","20-24 years","Female",42,43,43,43,44,215
"Mid Sussex 003C","E01031729","25-29 years","Female",44,42,45,37,40,208
"Mid Sussex 003C","E01031729","30-34 years","Female",69,59,55,59,56,298
"Mid Sussex 003C","E01031729","35-39 years","Female",63,69,70,79,84,365
"Mid Sussex 003C","E01031729","40-44 years","Female",69,68,71,79,75,362
"Mid Sussex 003C","E01031729","45-49 years","Female",76,84,84,79,77,400
"Mid Sussex 003C","E01031729","50-54 years","Female",82,89,89,94,93,447
"Mid Sussex 003C","E01031729","55-59 years","Female",100,94,87,82,84,447
"Mid Sussex 003C","E01031729","60-64 years","Female",67,69,74,75,73,358
"Mid Sussex 003C","E01031729","65-69 years","Female",67,63,65,55,62,312
"Mid Sussex 003C","E01031729","70-74 years","Female",71,74,76,79,72,372
"Mid Sussex 003C","E01031729","75-79 years","Female",28,29,33,38,40,168
"Mid Sussex 003C","E01031729","80-84 years","Female",22,23,26,29,32,132
"Mid Sussex 003C","E01031729","85+ years","Female",28,27,38,38,37,168
"Mid Sussex 003D","E01031730","0-4 years","Male",77,79,60,75,58,349
"Mid Sussex 003D","E01031730","5-9 years","Male",77,74,67,65,72,355
"Mid Sussex 003D","E01031730","10-14 years","Male",58,59,52,56,55,280
"Mid Sussex 003D","E01031730","15-19 years","Male",47,48,52,53,47,247
"Mid Sussex 003D","E01031730","20-24 years","Male",28,30,28,28,33,147
"Mid Sussex 003D","E01031730","25-29 years","Male",65,54,57,59,56,291
"Mid Sussex 003D","E01031730","30-34 years","Male",75,84,67,68,63,357
"Mid Sussex 003D","E01031730","35-39 years","Male",77,73,69,70,70,359
"Mid Sussex 003D","E01031730","40-44 years","Male",67,56,73,74,74,344
"Mid Sussex 003D","E01031730","45-49 years","Male",81,81,76,66,69,373
"Mid Sussex 003D","E01031730","50-54 years","Male",76,78,82,75,70,381
"Mid Sussex 003D","E01031730","55-59 years","Male",71,73,70,75,83,372
"Mid Sussex 003D","E01031730","60-64 years","Male",40,41,49,59,58,247
"Mid Sussex 003D","E01031730","65-69 years","Male",33,35,28,28,31,155
"Mid Sussex 003D","E01031730","70-74 years","Male",12,14,19,22,19,86
"Mid Sussex 003D","E01031730","75-79 years","Male",14,12,16,13,18,73
"Mid Sussex 003D","E01031730","80-84 years","Male",5,7,6,8,11,37
"Mid Sussex 003D","E01031730","85+ years","Male",4,4,4,4,8,24
"Mid Sussex 003D","E01031730","0-4 years","Female",61,65,65,64,60,315
"Mid Sussex 003D","E01031730","5-9 years","Female",57,57,54,55,53,276
"Mid Sussex 003D","E01031730","10-14 years","Female",49,52,52,58,60,271
"Mid Sussex 003D","E01031730","15-19 years","Female",38,35,37,40,39,189
"Mid Sussex 003D","E01031730","20-24 years","Female",29,30,39,30,24,152
"Mid Sussex 003D","E01031730","25-29 years","Female",71,61,63,59,63,317
"Mid Sussex 003D","E01031730","30-34 years","Female",77,74,66,67,56,340
"Mid Sussex 003D","E01031730","35-39 years","Female",93,82,85,80,70,410
"Mid Sussex 003D","E01031730","40-44 years","Female",78,77,73,70,74,372
"Mid Sussex 003D","E01031730","45-49 years","Female",62,68,71,69,79,349
"Mid Sussex 003D","E01031730","50-54 years","Female",67,65,64,59,56,311
"Mid Sussex 003D","E01031730","55-59 years","Female",50,57,66,71,70,314
"Mid Sussex 003D","E01031730","60-64 years","Female",48,47,41,46,54,236
"Mid Sussex 003D","E01031730","65-69 years","Female",35,32,34,37,36,174
"Mid Sussex 003D","E01031730","70-74 years","Female",21,26,25,28,27,127
"Mid Sussex 003D","E01031730","75-79 years","Female",10,15,14,14,20,73
"Mid Sussex 003D","E01031730","80-84 years","Female",12,8,8,12,11,51
"Mid Sussex 003D","E01031730","85+ years","Female",12,6,8,10,18,54
"Mid Sussex 003E","E01031735","0-4 years","Male",36,38,36,34,28,172
"Mid Sussex 003E","E01031735","5-9 years","Male",48,52,47,48,51,246
"Mid Sussex 003E","E01031735","10-14 years","Male",37,40,41,42,47,207
"Mid Sussex 003E","E01031735","15-19 years","Male",67,52,57,47,39,262
"Mid Sussex 003E","E01031735","20-24 years","Male",26,26,25,31,36,144
"Mid Sussex 003E","E01031735","25-29 years","Male",40,46,34,32,27,179
"Mid Sussex 003E","E01031735","30-34 years","Male",39,32,31,26,21,149
"Mid Sussex 003E","E01031735","35-39 years","Male",41,47,41,37,39,205
"Mid Sussex 003E","E01031735","40-44 years","Male",44,38,48,48,51,229
"Mid Sussex 003E","E01031735","45-49 years","Male",85,76,57,62,60,340
"Mid Sussex 003E","E01031735","50-54 years","Male",56,61,68,61,59,305
"Mid Sussex 003E","E01031735","55-59 years","Male",66,58,55,57,55,291
"Mid Sussex 003E","E01031735","60-64 years","Male",49,51,57,56,59,272
"Mid Sussex 003E","E01031735","65-69 years","Male",66,67,64,49,41,287
"Mid Sussex 003E","E01031735","70-74 years","Male",60,67,69,71,75,342
"Mid Sussex 003E","E01031735","75-79 years","Male",36,34,32,40,44,186
"Mid Sussex 003E","E01031735","80-84 years","Male",21,21,24,21,25,112
"Mid Sussex 003E","E01031735","85+ years","Male",14,12,13,15,17,71
"Mid Sussex 003E","E01031735","0-4 years","Female",41,40,41,43,38,203
"Mid Sussex 003E","E01031735","5-9 years","Female",50,42,44,42,39,217
"Mid Sussex 003E","E01031735","10-14 years","Female",42,39,38,36,39,194
"Mid Sussex 003E","E01031735","15-19 years","Female",41,41,40,51,52,225
"Mid Sussex 003E","E01031735","20-24 years","Female",29,24,24,22,21,120
"Mid Sussex 003E","E01031735","25-29 years","Female",44,38,32,40,31,185
"Mid Sussex 003E","E01031735","30-34 years","Female",39,42,39,36,38,194
"Mid Sussex 003E","E01031735","35-39 years","Female",53,51,61,57,63,285
"Mid Sussex 003E","E01031735","40-44 years","Female",75,65,62,66,57,325
"Mid Sussex 003E","E01031735","45-49 years","Female",63,66,71,80,74,354
"Mid Sussex 003E","E01031735","50-54 years","Female",57,50,49,48,55,259
"Mid Sussex 003E","E01031735","55-59 years","Female",76,83,74,70,67,370
"Mid Sussex 003E","E01031735","60-64 years","Female",60,61,63,58,60,302
"Mid Sussex 003E","E01031735","65-69 years","Female",76,64,68,69,65,342
"Mid Sussex 003E","E01031735","70-74 years","Female",54,73,70,76,79,352
"Mid Sussex 003E","E01031735","75-79 years","Female",27,33,39,37,44,180
"Mid Sussex 003E","E01031735","80-84 years","Female",26,24,22,20,22,114
"Mid Sussex 003E","E01031735","85+ years","Female",14,16,22,23,26,101
"Mid Sussex 004A","E01031736","0-4 years","Male",21,19,20,15,17,92
"Mid Sussex 004A","E01031736","5-9 years","Male",60,60,61,61,54,296
"Mid Sussex 004A","E01031736","10-14 years","Male",52,57,57,51,64,281
"Mid Sussex 004A","E01031736","15-19 years","Male",47,47,47,60,54,255
"Mid Sussex 004A","E01031736","20-24 years","Male",40,44,44,31,27,186
"Mid Sussex 004A","E01031736","25-29 years","Male",47,37,45,45,43,217
"Mid Sussex 004A","E01031736","30-34 years","Male",20,21,23,30,29,123
"Mid Sussex 004A","E01031736","35-39 years","Male",38,35,35,30,34,172
"Mid Sussex 004A","E01031736","40-44 years","Male",42,35,33,31,29,170
"Mid Sussex 004A","E01031736","45-49 years","Male",91,86,80,82,75,414
"Mid Sussex 004A","E01031736","50-54 years","Male",69,72,80,77,83,381
"Mid Sussex 004A","E01031736","55-59 years","Male",58,68,64,65,83,338
"Mid Sussex 004A","E01031736","60-64 years","Male",56,56,62,60,53,287
"Mid Sussex 004A","E01031736","65-69 years","Male",77,61,62,57,55,312
"Mid Sussex 004A","E01031736","70-74 years","Male",58,68,63,74,68,331
"Mid Sussex 004A","E01031736","75-79 years","Male",35,32,38,35,41,181
"Mid Sussex 004A","E01031736","80-84 years","Male",25,25,26,26,23,125
"Mid Sussex 004A","E01031736","85+ years","Male",38,34,32,26,28,158
"Mid Sussex 004A","E01031736","0-4 years","Female",47,40,43,42,42,214
"Mid Sussex 004A","E01031736","5-9 years","Female",48,39,36,37,34,194
"Mid Sussex 004A","E01031736","10-14 years","Female",66,61,66,56,56,305
"Mid Sussex 004A","E01031736","15-19 years","Female",46,50,48,51,47,242
"Mid Sussex 004A","E01031736","20-24 years","Female",28,29,41,35,38,171
"Mid Sussex 004A","E01031736","25-29 years","Female",35,35,31,28,19,148
"Mid Sussex 004A","E01031736","30-34 years","Female",29,17,18,19,16,99
"Mid Sussex 004A","E01031736","35-39 years","Female",52,56,56,44,42,250
"Mid Sussex 004A","E01031736","40-44 years","Female",56,55,53,48,45,257
"Mid Sussex 004A","E01031736","45-49 years","Female",80,72,65,75,76,368
"Mid Sussex 004A","E01031736","50-54 years","Female",75,82,86,75,82,400
"Mid Sussex 004A","E01031736","55-59 years","Female",58,56,61,67,71,313
"Mid Sussex 004A","E01031736","60-64 years","Female",46,43,44,48,48,229
"Mid Sussex 004A","E01031736","65-69 years","Female",81,72,61,66,66,346
"Mid Sussex 004A","E01031736","70-74 years","Female",60,59,74,71,65,329
"Mid Sussex 004A","E01031736","75-79 years","Female",28,30,32,41,47,178
"Mid Sussex 004A","E01031736","80-84 years","Female",39,46,42,38,25,190
"Mid Sussex 004A","E01031736","85+ years","Female",33,41,45,46,48,213
"Mid Sussex 004B","E01031737","0-4 years","Male",51,54,56,49,47,257
"Mid Sussex 004B","E01031737","5-9 years","Male",51,39,38,41,39,208
"Mid Sussex 004B","E01031737","10-14 years","Male",54,48,54,48,50,254
"Mid Sussex 004B","E01031737","15-19 years","Male",63,69,59,56,54,301
"Mid Sussex 004B","E01031737","20-24 years","Male",40,42,46,44,42,214
"Mid Sussex 004B","E01031737","25-29 years","Male",39,34,27,31,33,164
"Mid Sussex 004B","E01031737","30-34 years","Male",48,45,47,42,42,224
"Mid Sussex 004B","E01031737","35-39 years","Male",51,58,66,58,52,285
"Mid Sussex 004B","E01031737","40-44 years","Male",49,45,40,39,41,214
"Mid Sussex 004B","E01031737","45-49 years","Male",67,57,59,60,60,303
"Mid Sussex 004B","E01031737","50-54 years","Male",41,60,58,69,66,294
"Mid Sussex 004B","E01031737","55-59 years","Male",60,50,55,54,49,268
"Mid Sussex 004B","E01031737","60-64 years","Male",37,44,40,35,37,193
"Mid Sussex 004B","E01031737","65-69 years","Male",44,43,31,33,35,186
"Mid Sussex 004B","E01031737","70-74 years","Male",30,37,49,49,47,212
"Mid Sussex 004B","E01031737","75-79 years","Male",23,22,18,22,17,102
"Mid Sussex 004B","E01031737","80-84 years","Male",20,22,23,22,20,107
"Mid Sussex 004B","E01031737","85+ years","Male",27,22,29,25,24,127
"Mid Sussex 004B","E01031737","0-4 years","Female",41,36,40,38,43,198
"Mid Sussex 004B","E01031737","5-9 years","Female",66,65,64,62,51,308
"Mid Sussex 004B","E01031737","10-14 years","Female",54,51,55,56,50,266
"Mid Sussex 004B","E01031737","15-19 years","Female",40,44,39,43,38,204
"Mid Sussex 004B","E01031737","20-24 years","Female",37,35,35,31,35,173
"Mid Sussex 004B","E01031737","25-29 years","Female",36,37,33,33,39,178
"Mid Sussex 004B","E01031737","30-34 years","Female",54,50,63,59,47,273
"Mid Sussex 004B","E01031737","35-39 years","Female",61,57,57,54,54,283
"Mid Sussex 004B","E01031737","40-44 years","Female",75,61,62,62,58,318
"Mid Sussex 004B","E01031737","45-49 years","Female",69,67,67,71,66,340
"Mid Sussex 004B","E01031737","50-54 years","Female",50,61,58,61,67,297
"Mid Sussex 004B","E01031737","55-59 years","Female",61,58,65,60,51,295
"Mid Sussex 004B","E01031737","60-64 years","Female",39,43,46,50,54,232
"Mid Sussex 004B","E01031737","65-69 years","Female",39,37,35,41,41,193
"Mid Sussex 004B","E01031737","70-74 years","Female",39,41,45,42,39,206
"Mid Sussex 004B","E01031737","75-79 years","Female",24,26,29,34,36,149
"Mid Sussex 004B","E01031737","80-84 years","Female",19,25,27,24,24,119
"Mid Sussex 004B","E01031737","85+ years","Female",34,34,31,42,29,170
"Mid Sussex 004C","E01031738","0-4 years","Male",47,41,37,40,41,206
"Mid Sussex 004C","E01031738","5-9 years","Male",60,61,62,54,51,288
"Mid Sussex 004C","E01031738","10-14 years","Male",59,60,58,55,62,294
"Mid Sussex 004C","E01031738","15-19 years","Male",42,38,48,54,51,233
"Mid Sussex 004C","E01031738","20-24 years","Male",24,22,26,31,37,140
"Mid Sussex 004C","E01031738","25-29 years","Male",30,25,23,18,16,112
"Mid Sussex 004C","E01031738","30-34 years","Male",26,23,22,26,23,120
"Mid Sussex 004C","E01031738","35-39 years","Male",40,40,50,45,41,216
"Mid Sussex 004C","E01031738","40-44 years","Male",57,52,55,58,58,280
"Mid Sussex 004C","E01031738","45-49 years","Male",42,39,35,43,43,202
"Mid Sussex 004C","E01031738","50-54 years","Male",52,58,68,65,64,307
"Mid Sussex 004C","E01031738","55-59 years","Male",55,51,42,42,52,242
"Mid Sussex 004C","E01031738","60-64 years","Male",45,48,48,44,39,224
"Mid Sussex 004C","E01031738","65-69 years","Male",59,48,44,47,45,243
"Mid Sussex 004C","E01031738","70-74 years","Male",31,44,52,58,57,242
"Mid Sussex 004C","E01031738","75-79 years","Male",32,30,33,33,34,162
"Mid Sussex 004C","E01031738","80-84 years","Male",14,13,9,12,15,63
"Mid Sussex 004C","E01031738","85+ years","Male",28,33,30,27,25,143
"Mid Sussex 004C","E01031738","0-4 years","Female",44,42,46,43,34,209
"Mid Sussex 004C","E01031738","5-9 years","Female",49,48,60,67,76,300
"Mid Sussex 004C","E01031738","10-14 years","Female",31,24,25,32,34,146
"Mid Sussex 004C","E01031738","15-19 years","Female",35,38,37,38,35,183
"Mid Sussex 004C","E01031738","20-24 years","Female",16,17,19,17,18,87
"Mid Sussex 004C","E01031738","25-29 years","Female",14,13,12,14,8,61
"Mid Sussex 004C","E01031738","30-34 years","Female",32,22,24,24,26,128
"Mid Sussex 004C","E01031738","35-39 years","Female",60,63,70,66,59,318
"Mid Sussex 004C","E01031738","40-44 years","Female",48,54,57,56,59,274
"Mid Sussex 004C","E01031738","45-49 years","Female",51,53,51,54,52,261
"Mid Sussex 004C","E01031738","50-54 years","Female",65,58,48,46,52,269
"Mid Sussex 004C","E01031738","55-59 years","Female",42,49,50,54,57,252
"Mid Sussex 004C","E01031738","60-64 years","Female",50,43,45,42,41,221
"Mid Sussex 004C","E01031738","65-69 years","Female",55,57,52,53,51,268
"Mid Sussex 004C","E01031738","70-74 years","Female",43,51,55,52,56,257
"Mid Sussex 004C","E01031738","75-79 years","Female",31,30,28,36,39,164
"Mid Sussex 004C","E01031738","80-84 years","Female",27,24,26,24,23,124
"Mid Sussex 004C","E01031738","85+ years","Female",33,34,36,32,34,169
"Mid Sussex 004D","E01031739","0-4 years","Male",49,61,66,51,52,279
"Mid Sussex 004D","E01031739","5-9 years","Male",56,59,56,65,64,300
"Mid Sussex 004D","E01031739","10-14 years","Male",55,55,58,52,49,269
"Mid Sussex 004D","E01031739","15-19 years","Male",48,48,48,51,47,242
"Mid Sussex 004D","E01031739","20-24 years","Male",56,53,47,48,57,261
"Mid Sussex 004D","E01031739","25-29 years","Male",45,39,32,26,22,164
"Mid Sussex 004D","E01031739","30-34 years","Male",67,61,61,54,48,291
"Mid Sussex 004D","E01031739","35-39 years","Male",52,61,57,55,53,278
"Mid Sussex 004D","E01031739","40-44 years","Male",57,55,52,55,57,276
"Mid Sussex 004D","E01031739","45-49 years","Male",75,78,83,77,58,371
"Mid Sussex 004D","E01031739","50-54 years","Male",82,74,64,63,82,365
"Mid Sussex 004D","E01031739","55-59 years","Male",48,62,75,84,76,345
"Mid Sussex 004D","E01031739","60-64 years","Male",62,65,54,52,52,285
"Mid Sussex 004D","E01031739","65-69 years","Male",63,47,48,48,59,265
"Mid Sussex 004D","E01031739","70-74 years","Male",59,70,78,64,57,328
"Mid Sussex 004D","E01031739","75-79 years","Male",25,31,39,47,55,197
"Mid Sussex 004D","E01031739","80-84 years","Male",28,23,29,32,33,145
"Mid Sussex 004D","E01031739","85+ years","Male",14,24,25,25,24,112
"Mid Sussex 004D","E01031739","0-4 years","Female",31,38,42,43,37,191
"Mid Sussex 004D","E01031739","5-9 years","Female",49,47,45,42,42,225
"Mid Sussex 004D","E01031739","10-14 years","Female",42,41,52,54,56,245
"Mid Sussex 004D","E01031739","15-19 years","Female",34,39,40,33,30,176
"Mid Sussex 004D","E01031739","20-24 years","Female",66,63,41,52,44,266
"Mid Sussex 004D","E01031739","25-29 years","Female",49,54,71,63,67,304
"Mid Sussex 004D","E01031739","30-34 years","Female",48,42,39,35,43,207
"Mid Sussex 004D","E01031739","35-39 years","Female",67,84,80,76,68,375
"Mid Sussex 004D","E01031739","40-44 years","Female",67,65,59,65,62,318
"Mid Sussex 004D","E01031739","45-49 years","Female",79,74,88,88,97,426
"Mid Sussex 004D","E01031739","50-54 years","Female",72,78,74,69,73,366
"Mid Sussex 004D","E01031739","55-59 years","Female",64,61,70,73,76,344
"Mid Sussex 004D","E01031739","60-64 years","Female",64,63,60,63,66,316
"Mid Sussex 004D","E01031739","65-69 years","Female",70,71,72,61,61,335
"Mid Sussex 004D","E01031739","70-74 years","Female",58,59,62,64,62,305
"Mid Sussex 004D","E01031739","75-79 years","Female",29,34,40,46,46,195
"Mid Sussex 004D","E01031739","80-84 years","Female",26,21,19,21,27,114
"Mid Sussex 004D","E01031739","85+ years","Female",29,35,36,36,37,173
"Mid Sussex 004E","E01031740","0-4 years","Male",24,31,32,28,25,140
"Mid Sussex 004E","E01031740","5-9 years","Male",55,48,53,55,47,258
"Mid Sussex 004E","E01031740","10-14 years","Male",18,25,26,28,31,128
"Mid Sussex 004E","E01031740","15-19 years","Male",38,28,23,22,28,139
"Mid Sussex 004E","E01031740","20-24 years","Male",36,38,35,27,26,162
"Mid Sussex 004E","E01031740","25-29 years","Male",30,24,26,33,28,141
"Mid Sussex 004E","E01031740","30-34 years","Male",28,29,28,25,35,145
"Mid Sussex 004E","E01031740","35-39 years","Male",37,42,40,36,35,190
"Mid Sussex 004E","E01031740","40-44 years","Male",38,41,47,46,46,218
"Mid Sussex 004E","E01031740","45-49 years","Male",52,45,48,43,37,225
"Mid Sussex 004E","E01031740","50-54 years","Male",53,47,51,49,53,253
"Mid Sussex 004E","E01031740","55-59 years","Male",48,49,50,51,49,247
"Mid Sussex 004E","E01031740","60-64 years","Male",44,48,47,52,47,238
"Mid Sussex 004E","E01031740","65-69 years","Male",35,32,32,32,31,162
"Mid Sussex 004E","E01031740","70-74 years","Male",33,38,42,36,38,187
"Mid Sussex 004E","E01031740","75-79 years","Male",24,26,33,34,36,153
"Mid Sussex 004E","E01031740","80-84 years","Male",23,19,14,21,21,98
"Mid Sussex 004E","E01031740","85+ years","Male",15,17,16,15,15,78
"Mid Sussex 004E","E01031740","0-4 years","Female",31,28,22,21,21,123
"Mid Sussex 004E","E01031740","5-9 years","Female",34,36,51,47,37,205
"Mid Sussex 004E","E01031740","10-14 years","Female",36,40,40,34,38,188
"Mid Sussex 004E","E01031740","15-19 years","Female",38,32,20,27,26,143
"Mid Sussex 004E","E01031740","20-24 years","Female",31,34,31,24,25,145
"Mid Sussex 004E","E01031740","25-29 years","Female",30,31,25,25,20,131
"Mid Sussex 004E","E01031740","30-34 years","Female",29,31,40,38,44,182
"Mid Sussex 004E","E01031740","35-39 years","Female",30,36,43,33,36,178
"Mid Sussex 004E","E01031740","40-44 years","Female",43,37,40,41,37,198
"Mid Sussex 004E","E01031740","45-49 years","Female",54,53,53,49,47,256
"Mid Sussex 004E","E01031740","50-54 years","Female",61,62,53,46,56,278
"Mid Sussex 004E","E01031740","55-59 years","Female",46,49,50,52,53,250
"Mid Sussex 004E","E01031740","60-64 years","Female",51,51,50,50,47,249
"Mid Sussex 004E","E01031740","65-69 years","Female",31,27,26,28,29,141
"Mid Sussex 004E","E01031740","70-74 years","Female",35,39,43,37,41,195
"Mid Sussex 004E","E01031740","75-79 years","Female",21,21,26,32,33,133
"Mid Sussex 004E","E01031740","80-84 years","Female",32,31,31,30,30,154
"Mid Sussex 004E","E01031740","85+ years","Female",43,38,34,37,39,191
"Mid Sussex 005A","E01031721","0-4 years","Male",74,72,72,59,63,340
"Mid Sussex 005A","E01031721","5-9 years","Male",44,58,63,67,61,293
"Mid Sussex 005A","E01031721","10-14 years","Male",49,53,59,59,68,288
"Mid Sussex 005A","E01031721","15-19 years","Male",36,30,36,33,38,173
"Mid Sussex 005A","E01031721","20-24 years","Male",34,26,27,30,30,147
"Mid Sussex 005A","E01031721","25-29 years","Male",48,56,48,36,33,221
"Mid Sussex 005A","E01031721","30-34 years","Male",27,29,34,34,38,162
"Mid Sussex 005A","E01031721","35-39 years","Male",26,29,32,35,29,151
"Mid Sussex 005A","E01031721","40-44 years","Male",48,51,49,41,46,235
"Mid Sussex 005A","E01031721","45-49 years","Male",66,54,57,59,64,300
"Mid Sussex 005A","E01031721","50-54 years","Male",49,51,58,67,59,284
"Mid Sussex 005A","E01031721","55-59 years","Male",50,52,50,46,50,248
"Mid Sussex 005A","E01031721","60-64 years","Male",69,67,63,62,66,327
"Mid Sussex 005A","E01031721","65-69 years","Male",66,63,69,78,68,344
"Mid Sussex 005A","E01031721","70-74 years","Male",71,79,75,71,83,379
"Mid Sussex 005A","E01031721","75-79 years","Male",42,36,40,50,51,219
"Mid Sussex 005A","E01031721","80-84 years","Male",36,40,39,45,36,196
"Mid Sussex 005A","E01031721","85+ years","Male",15,16,18,17,23,89
"Mid Sussex 005A","E01031721","0-4 years","Female",58,61,64,64,57,304
"Mid Sussex 005A","E01031721","5-9 years","Female",48,54,52,49,52,255
"Mid Sussex 005A","E01031721","10-14 years","Female",33,34,45,45,53,210
"Mid Sussex 005A","E01031721","15-19 years","Female",36,38,39,30,32,175
"Mid Sussex 005A","E01031721","20-24 years","Female",34,29,36,35,34,168
"Mid Sussex 005A","E01031721","25-29 years","Female",37,36,42,39,38,192
"Mid Sussex 005A","E01031721","30-34 years","Female",53,58,54,52,51,268
"Mid Sussex 005A","E01031721","35-39 years","Female",61,70,75,77,84,367
"Mid Sussex 005A","E01031721","40-44 years","Female",40,40,46,56,48,230
"Mid Sussex 005A","E01031721","45-49 years","Female",67,61,60,51,51,290
"Mid Sussex 005A","E01031721","50-54 years","Female",47,49,54,56,55,261
"Mid Sussex 005A","E01031721","55-59 years","Female",60,62,58,59,69,308
"Mid Sussex 005A","E01031721","60-64 years","Female",67,68,66,66,60,327
"Mid Sussex 005A","E01031721","65-69 years","Female",83,77,71,75,80,386
"Mid Sussex 005A","E01031721","70-74 years","Female",71,85,95,92,101,444
"Mid Sussex 005A","E01031721","75-79 years","Female",66,54,51,55,54,280
"Mid Sussex 005A","E01031721","80-84 years","Female",43,48,50,51,41,233
"Mid Sussex 005A","E01031721","85+ years","Female",45,46,41,43,43,218
"Mid Sussex 005B","E01031723","0-4 years","Male",51,57,58,56,47,269
"Mid Sussex 005B","E01031723","5-9 years","Male",46,41,44,39,44,214
"Mid Sussex 005B","E01031723","10-14 years","Male",43,49,46,46,40,224
"Mid Sussex 005B","E01031723","15-19 years","Male",51,42,53,58,61,265
"Mid Sussex 005B","E01031723","20-24 years","Male",30,24,26,23,30,133
"Mid Sussex 005B","E01031723","25-29 years","Male",52,50,38,37,38,215
"Mid Sussex 005B","E01031723","30-34 years","Male",26,32,29,34,32,153
"Mid Sussex 005B","E01031723","35-39 years","Male",22,20,23,21,22,108
"Mid Sussex 005B","E01031723","40-44 years","Male",41,41,44,35,39,200
"Mid Sussex 005B","E01031723","45-49 years","Male",62,63,58,64,63,310
"Mid Sussex 005B","E01031723","50-54 years","Male",79,81,87,86,84,417
"Mid Sussex 005B","E01031723","55-59 years","Male",66,69,71,69,61,336
"Mid Sussex 005B","E01031723","60-64 years","Male",61,59,61,67,68,316
"Mid Sussex 005B","E01031723","65-69 years","Male",63,58,57,50,61,289
"Mid Sussex 005B","E01031723","70-74 years","Male",59,65,66,63,58,311
"Mid Sussex 005B","E01031723","75-79 years","Male",27,27,35,41,42,172
"Mid Sussex 005B","E01031723","80-84 years","Male",27,21,24,24,24,120
"Mid Sussex 005B","E01031723","85+ years","Male",6,3,6,3,3,21
"Mid Sussex 005B","E01031723","0-4 years","Female",33,34,32,32,33,164
"Mid Sussex 005B","E01031723","5-9 years","Female",50,57,55,52,55,269
"Mid Sussex 005B","E01031723","10-14 years","Female",38,41,55,49,57,240
"Mid Sussex 005B","E01031723","15-19 years","Female",48,55,49,45,45,242
"Mid Sussex 005B","E01031723","20-24 years","Female",16,19,23,24,20,102
"Mid Sussex 005B","E01031723","25-29 years","Female",37,42,29,32,32,172
"Mid Sussex 005B","E01031723","30-34 years","Female",39,35,39,39,35,187
"Mid Sussex 005B","E01031723","35-39 years","Female",29,38,35,34,36,172
"Mid Sussex 005B","E01031723","40-44 years","Female",65,49,52,54,57,277
"Mid Sussex 005B","E01031723","45-49 years","Female",57,66,56,54,61,294
"Mid Sussex 005B","E01031723","50-54 years","Female",57,55,68,75,76,331
"Mid Sussex 005B","E01031723","55-59 years","Female",76,67,67,70,72,352
"Mid Sussex 005B","E01031723","60-64 years","Female",55,58,59,59,59,290
"Mid Sussex 005B","E01031723","65-69 years","Female",67,61,64,66,69,327
"Mid Sussex 005B","E01031723","70-74 years","Female",41,48,52,57,58,256
"Mid Sussex 005B","E01031723","75-79 years","Female",32,39,36,41,43,191
"Mid Sussex 005B","E01031723","80-84 years","Female",21,24,28,25,22,120
"Mid Sussex 005B","E01031723","85+ years","Female",22,24,22,26,28,122
"Mid Sussex 005C","E01031724","0-4 years","Male",33,30,36,40,39,178
"Mid Sussex 005C","E01031724","5-9 years","Male",31,38,37,41,45,192
"Mid Sussex 005C","E01031724","10-14 years","Male",48,38,31,30,30,177
"Mid Sussex 005C","E01031724","15-19 years","Male",40,50,47,47,42,226
"Mid Sussex 005C","E01031724","20-24 years","Male",31,32,32,30,29,154
"Mid Sussex 005C","E01031724","25-29 years","Male",35,32,33,31,30,161
"Mid Sussex 005C","E01031724","30-34 years","Male",35,37,38,43,35,188
"Mid Sussex 005C","E01031724","35-39 years","Male",45,47,49,47,52,240
"Mid Sussex 005C","E01031724","40-44 years","Male",24,24,32,36,37,153
"Mid Sussex 005C","E01031724","45-49 years","Male",50,50,44,44,44,232
"Mid Sussex 005C","E01031724","50-54 years","Male",47,44,39,42,38,210
"Mid Sussex 005C","E01031724","55-59 years","Male",54,55,48,39,38,234
"Mid Sussex 005C","E01031724","60-64 years","Male",44,41,43,55,60,243
"Mid Sussex 005C","E01031724","65-69 years","Male",40,38,42,36,37,193
"Mid Sussex 005C","E01031724","70-74 years","Male",34,33,33,45,45,190
"Mid Sussex 005C","E01031724","75-79 years","Male",21,26,27,26,30,130
"Mid Sussex 005C","E01031724","80-84 years","Male",6,6,5,6,4,27
"Mid Sussex 005C","E01031724","85+ years","Male",7,8,6,5,11,37
"Mid Sussex 005C","E01031724","0-4 years","Female",26,34,33,37,35,165
"Mid Sussex 005C","E01031724","5-9 years","Female",43,39,40,38,35,195
"Mid Sussex 005C","E01031724","10-14 years","Female",30,33,35,37,40,175
"Mid Sussex 005C","E01031724","15-19 years","Female",38,39,38,36,33,184
"Mid Sussex 005C","E01031724","20-24 years","Female",32,25,28,24,24,133
"Mid Sussex 005C","E01031724","25-29 years","Female",31,35,36,41,33,176
"Mid Sussex 005C","E01031724","30-34 years","Female",41,39,38,37,41,196
"Mid Sussex 005C","E01031724","35-39 years","Female",27,33,32,37,38,167
"Mid Sussex 005C","E01031724","40-44 years","Female",55,49,45,40,29,218
"Mid Sussex 005C","E01031724","45-49 years","Female",51,50,46,53,60,260
"Mid Sussex 005C","E01031724","50-54 years","Female",51,58,50,46,46,251
"Mid Sussex 005C","E01031724","55-59 years","Female",68,63,59,56,55,301
"Mid Sussex 005C","E01031724","60-64 years","Female",49,49,58,52,56,264
"Mid Sussex 005C","E01031724","65-69 years","Female",57,58,48,53,54,270
"Mid Sussex 005C","E01031724","70-74 years","Female",28,27,41,44,42,182
"Mid Sussex 005C","E01031724","75-79 years","Female",12,14,17,18,18,79
"Mid Sussex 005C","E01031724","80-84 years","Female",10,11,9,8,8,46
"Mid Sussex 005C","E01031724","85+ years","Female",8,8,9,8,14,47
"Mid Sussex 005D","E01031725","0-4 years","Male",54,47,56,56,54,267
"Mid Sussex 005D","E01031725","5-9 years","Male",46,43,47,46,53,235
"Mid Sussex 005D","E01031725","10-14 years","Male",42,50,46,46,41,225
"Mid Sussex 005D","E01031725","15-19 years","Male",39,35,45,37,40,196
"Mid Sussex 005D","E01031725","20-24 years","Male",36,32,32,29,38,167
"Mid Sussex 005D","E01031725","25-29 years","Male",32,31,29,36,30,158
"Mid Sussex 005D","E01031725","30-34 years","Male",25,21,27,31,29,133
"Mid Sussex 005D","E01031725","35-39 years","Male",30,38,37,36,31,172
"Mid Sussex 005D","E01031725","40-44 years","Male",38,38,31,38,34,179
"Mid Sussex 005D","E01031725","45-49 years","Male",70,70,74,60,57,331
"Mid Sussex 005D","E01031725","50-54 years","Male",44,52,51,66,61,274
"Mid Sussex 005D","E01031725","55-59 years","Male",47,44,45,38,48,222
"Mid Sussex 005D","E01031725","60-64 years","Male",60,53,51,52,44,260
"Mid Sussex 005D","E01031725","65-69 years","Male",64,62,45,49,47,267
"Mid Sussex 005D","E01031725","70-74 years","Male",48,58,72,56,60,294
"Mid Sussex 005D","E01031725","75-79 years","Male",36,31,26,32,32,157
"Mid Sussex 005D","E01031725","80-84 years","Male",20,24,33,36,31,144
"Mid Sussex 005D","E01031725","85+ years","Male",16,13,12,14,15,70
"Mid Sussex 005D","E01031725","0-4 years","Female",59,48,48,46,40,241
"Mid Sussex 005D","E01031725","5-9 years","Female",36,48,49,56,54,243
"Mid Sussex 005D","E01031725","10-14 years","Female",46,47,38,38,35,204
"Mid Sussex 005D","E01031725","15-19 years","Female",14,20,33,29,30,126
"Mid Sussex 005D","E01031725","20-24 years","Female",30,25,19,18,19,111
"Mid Sussex 005D","E01031725","25-29 years","Female",21,19,17,17,14,88
"Mid Sussex 005D","E01031725","30-34 years","Female",30,36,39,42,46,193
"Mid Sussex 005D","E01031725","35-39 years","Female",44,43,51,51,44,233
"Mid Sussex 005D","E01031725","40-44 years","Female",52,50,46,47,42,237
"Mid Sussex 005D","E01031725","45-49 years","Female",52,50,48,48,50,248
"Mid Sussex 005D","E01031725","50-54 years","Female",53,54,53,47,46,253
"Mid Sussex 005D","E01031725","55-59 years","Female",46,47,39,45,46,223
"Mid Sussex 005D","E01031725","60-64 years","Female",52,53,51,48,44,248
"Mid Sussex 005D","E01031725","65-69 years","Female",72,63,52,54,48,289
"Mid Sussex 005D","E01031725","70-74 years","Female",52,55,65,67,67,306
"Mid Sussex 005D","E01031725","75-79 years","Female",36,42,42,41,41,202
"Mid Sussex 005D","E01031725","80-84 years","Female",40,36,39,44,45,204
"Mid Sussex 005D","E01031725","85+ years","Female",14,14,9,13,16,66
"Mid Sussex 006A","E01031694","0-4 years","Male",45,44,46,48,52,235
"Mid Sussex 006A","E01031694","5-9 years","Male",47,49,44,50,44,234
"Mid Sussex 006A","E01031694","10-14 years","Male",68,84,85,77,83,397
"Mid Sussex 006A","E01031694","15-19 years","Male",206,207,165,184,167,929
"Mid Sussex 006A","E01031694","20-24 years","Male",54,66,42,41,34,237
"Mid Sussex 006A","E01031694","25-29 years","Male",47,43,37,39,49,215
"Mid Sussex 006A","E01031694","30-34 years","Male",42,43,44,40,39,208
"Mid Sussex 006A","E01031694","35-39 years","Male",61,61,56,56,43,277
"Mid Sussex 006A","E01031694","40-44 years","Male",67,65,60,66,71,329
"Mid Sussex 006A","E01031694","45-49 years","Male",66,62,55,55,45,283
"Mid Sussex 006A","E01031694","50-54 years","Male",88,85,90,88,82,433
"Mid Sussex 006A","E01031694","55-59 years","Male",51,55,63,69,78,316
"Mid Sussex 006A","E01031694","60-64 years","Male",60,54,53,52,51,270
"Mid Sussex 006A","E01031694","65-69 years","Male",49,57,53,56,60,275
"Mid Sussex 006A","E01031694","70-74 years","Male",30,36,39,43,47,195
"Mid Sussex 006A","E01031694","75-79 years","Male",29,29,33,31,30,152
"Mid Sussex 006A","E01031694","80-84 years","Male",11,11,13,16,20,71
"Mid Sussex 006A","E01031694","85+ years","Male",14,15,14,11,12,66
"Mid Sussex 006A","E01031694","0-4 years","Female",44,40,48,43,38,213
"Mid Sussex 006A","E01031694","5-9 years","Female",60,59,59,60,49,287
"Mid Sussex 006A","E01031694","10-14 years","Female",48,62,64,70,60,304
"Mid Sussex 006A","E01031694","15-19 years","Female",151,161,136,156,154,758
"Mid Sussex 006A","E01031694","20-24 years","Female",62,67,46,51,43,269
"Mid Sussex 006A","E01031694","25-29 years","Female",19,21,21,19,22,102
"Mid Sussex 006A","E01031694","30-34 years","Female",35,47,44,45,44,215
"Mid Sussex 006A","E01031694","35-39 years","Female",62,66,65,63,55,311
"Mid Sussex 006A","E01031694","40-44 years","Female",65,65,58,63,58,309
"Mid Sussex 006A","E01031694","45-49 years","Female",65,58,60,61,73,317
"Mid Sussex 006A","E01031694","50-54 years","Female",79,74,74,75,67,369
"Mid Sussex 006A","E01031694","55-59 years","Female",47,52,55,55,61,270
"Mid Sussex 006A","E01031694","60-64 years","Female",74,79,79,76,73,381
"Mid Sussex 006A","E01031694","65-69 years","Female",44,41,40,49,57,231
"Mid Sussex 006A","E01031694","70-74 years","Female",44,44,51,48,51,238
"Mid Sussex 006A","E01031694","75-79 years","Female",36,36,37,45,46,200
"Mid Sussex 006A","E01031694","80-84 years","Female",16,16,14,14,16,76
"Mid Sussex 006A","E01031694","85+ years","Female",25,26,28,31,31,141
"Mid Sussex 006B","E01031764","0-4 years","Male",30,28,28,32,28,146
"Mid Sussex 006B","E01031764","5-9 years","Male",39,33,37,37,43,189
"Mid Sussex 006B","E01031764","10-14 years","Male",63,66,52,53,45,279
"Mid Sussex 006B","E01031764","15-19 years","Male",51,43,53,55,56,258
"Mid Sussex 006B","E01031764","20-24 years","Male",21,24,25,25,29,124
"Mid Sussex 006B","E01031764","25-29 years","Male",33,31,26,37,27,154
"Mid Sussex 006B","E01031764","30-34 years","Male",23,25,21,16,20,105
"Mid Sussex 006B","E01031764","35-39 years","Male",32,28,28,32,29,149
"Mid Sussex 006B","E01031764","40-44 years","Male",49,43,39,35,33,199
"Mid Sussex 006B","E01031764","45-49 years","Male",53,55,56,57,50,271
"Mid Sussex 006B","E01031764","50-54 years","Male",61,60,55,52,53,281
"Mid Sussex 006B","E01031764","55-59 years","Male",75,76,77,72,74,374
"Mid Sussex 006B","E01031764","60-64 years","Male",38,38,47,56,55,234
"Mid Sussex 006B","E01031764","65-69 years","Male",52,47,35,38,34,206
"Mid Sussex 006B","E01031764","70-74 years","Male",43,50,52,44,46,235
"Mid Sussex 006B","E01031764","75-79 years","Male",27,29,30,38,30,154
"Mid Sussex 006B","E01031764","80-84 years","Male",17,15,22,23,21,98
"Mid Sussex 006B","E01031764","85+ years","Male",26,24,22,24,24,120
"Mid Sussex 006B","E01031764","0-4 years","Female",30,29,27,24,26,136
"Mid Sussex 006B","E01031764","5-9 years","Female",56,55,45,39,42,237
"Mid Sussex 006B","E01031764","10-14 years","Female",65,62,64,62,58,311
"Mid Sussex 006B","E01031764","15-19 years","Female",33,36,36,43,38,186
"Mid Sussex 006B","E01031764","20-24 years","Female",23,14,16,16,15,84
"Mid Sussex 006B","E01031764","25-29 years","Female",15,25,22,19,12,93
"Mid Sussex 006B","E01031764","30-34 years","Female",21,17,18,19,22,97
"Mid Sussex 006B","E01031764","35-39 years","Female",30,27,29,41,39,166
"Mid Sussex 006B","E01031764","40-44 years","Female",66,52,51,53,47,269
"Mid Sussex 006B","E01031764","45-49 years","Female",66,59,64,56,51,296
"Mid Sussex 006B","E01031764","50-54 years","Female",69,67,68,70,64,338
"Mid Sussex 006B","E01031764","55-59 years","Female",56,64,74,74,81,349
"Mid Sussex 006B","E01031764","60-64 years","Female",43,41,42,44,40,210
"Mid Sussex 006B","E01031764","65-69 years","Female",48,42,37,34,43,204
"Mid Sussex 006B","E01031764","70-74 years","Female",39,45,42,48,47,221
"Mid Sussex 006B","E01031764","75-79 years","Female",44,46,44,36,32,202
"Mid Sussex 006B","E01031764","80-84 years","Female",17,16,24,26,29,112
"Mid Sussex 006B","E01031764","85+ years","Female",41,47,39,39,34,200
"Mid Sussex 006C","E01031765","0-4 years","Male",30,32,27,36,32,157
"Mid Sussex 006C","E01031765","5-9 years","Male",60,45,50,49,50,254
"Mid Sussex 006C","E01031765","10-14 years","Male",56,55,46,53,49,259
"Mid Sussex 006C","E01031765","15-19 years","Male",41,39,37,35,43,195
"Mid Sussex 006C","E01031765","20-24 years","Male",55,49,44,38,34,220
"Mid Sussex 006C","E01031765","25-29 years","Male",37,32,36,31,33,169
"Mid Sussex 006C","E01031765","30-34 years","Male",33,25,22,26,24,130
"Mid Sussex 006C","E01031765","35-39 years","Male",33,41,40,37,42,193
"Mid Sussex 006C","E01031765","40-44 years","Male",47,45,44,40,50,226
"Mid Sussex 006C","E01031765","45-49 years","Male",54,53,51,44,42,244
"Mid Sussex 006C","E01031765","50-54 years","Male",58,60,57,57,50,282
"Mid Sussex 006C","E01031765","55-59 years","Male",47,47,47,54,56,251
"Mid Sussex 006C","E01031765","60-64 years","Male",49,47,50,51,54,251
"Mid Sussex 006C","E01031765","65-69 years","Male",65,64,52,53,40,274
"Mid Sussex 006C","E01031765","70-74 years","Male",40,43,50,44,52,229
"Mid Sussex 006C","E01031765","75-79 years","Male",28,30,26,30,32,146
"Mid Sussex 006C","E01031765","80-84 years","Male",16,17,23,26,24,106
"Mid Sussex 006C","E01031765","85+ years","Male",18,19,23,25,25,110
"Mid Sussex 006C","E01031765","0-4 years","Female",32,37,37,29,26,161
"Mid Sussex 006C","E01031765","5-9 years","Female",52,53,49,58,54,266
"Mid Sussex 006C","E01031765","10-14 years","Female",38,40,42,41,42,203
"Mid Sussex 006C","E01031765","15-19 years","Female",39,35,32,31,31,168
"Mid Sussex 006C","E01031765","20-24 years","Female",45,49,44,33,27,198
"Mid Sussex 006C","E01031765","25-29 years","Female",30,39,40,41,47,197
"Mid Sussex 006C","E01031765","30-34 years","Female",26,22,25,28,28,129
"Mid Sussex 006C","E01031765","35-39 years","Female",30,27,26,29,34,146
"Mid Sussex 006C","E01031765","40-44 years","Female",55,47,40,45,37,224
"Mid Sussex 006C","E01031765","45-49 years","Female",58,56,52,46,50,262
"Mid Sussex 006C","E01031765","50-54 years","Female",88,77,83,75,67,390
"Mid Sussex 006C","E01031765","55-59 years","Female",64,72,69,70,77,352
"Mid Sussex 006C","E01031765","60-64 years","Female",48,49,48,48,46,239
"Mid Sussex 006C","E01031765","65-69 years","Female",47,43,42,42,42,216
"Mid Sussex 006C","E01031765","70-74 years","Female",50,59,61,54,54,278
"Mid Sussex 006C","E01031765","75-79 years","Female",29,25,29,46,49,178
"Mid Sussex 006C","E01031765","80-84 years","Female",13,15,11,13,12,64
"Mid Sussex 006C","E01031765","85+ years","Female",18,19,21,19,16,93
"Mid Sussex 006D","E01031766","0-4 years","Male",41,34,34,28,28,165
"Mid Sussex 006D","E01031766","5-9 years","Male",51,41,36,39,31,198
"Mid Sussex 006D","E01031766","10-14 years","Male",59,73,76,74,78,360
"Mid Sussex 006D","E01031766","15-19 years","Male",60,59,61,64,61,305
"Mid Sussex 006D","E01031766","20-24 years","Male",52,54,59,62,56,283
"Mid Sussex 006D","E01031766","25-29 years","Male",46,42,40,40,44,212
"Mid Sussex 006D","E01031766","30-34 years","Male",51,38,35,28,33,185
"Mid Sussex 006D","E01031766","35-39 years","Male",46,55,48,40,38,227
"Mid Sussex 006D","E01031766","40-44 years","Male",63,55,56,59,58,291
"Mid Sussex 006D","E01031766","45-49 years","Male",84,89,79,71,63,386
"Mid Sussex 006D","E01031766","50-54 years","Male",95,83,77,75,71,401
"Mid Sussex 006D","E01031766","55-59 years","Male",84,96,105,100,103,488
"Mid Sussex 006D","E01031766","60-64 years","Male",75,79,71,77,78,380
"Mid Sussex 006D","E01031766","65-69 years","Male",84,71,75,76,76,382
"Mid Sussex 006D","E01031766","70-74 years","Male",67,72,71,74,69,353
"Mid Sussex 006D","E01031766","75-79 years","Male",30,34,35,36,40,175
"Mid Sussex 006D","E01031766","80-84 years","Male",28,20,21,21,23,113
"Mid Sussex 006D","E01031766","85+ years","Male",16,19,18,18,17,88
"Mid Sussex 006D","E01031766","0-4 years","Female",41,44,36,35,37,193
"Mid Sussex 006D","E01031766","5-9 years","Female",57,58,55,58,56,284
"Mid Sussex 006D","E01031766","10-14 years","Female",67,69,67,70,65,338
"Mid Sussex 006D","E01031766","15-19 years","Female",72,66,63,55,61,317
"Mid Sussex 006D","E01031766","20-24 years","Female",32,27,29,35,41,164
"Mid Sussex 006D","E01031766","25-29 years","Female",46,45,40,33,27,191
"Mid Sussex 006D","E01031766","30-34 years","Female",42,44,35,30,31,182
"Mid Sussex 006D","E01031766","35-39 years","Female",40,43,48,52,51,234
"Mid Sussex 006D","E01031766","40-44 years","Female",66,67,68,60,58,319
"Mid Sussex 006D","E01031766","45-49 years","Female",94,88,89,82,76,429
"Mid Sussex 006D","E01031766","50-54 years","Female",87,88,91,87,87,440
"Mid Sussex 006D","E01031766","55-59 years","Female",78,77,71,85,87,398
"Mid Sussex 006D","E01031766","60-64 years","Female",71,75,76,73,72,367
"Mid Sussex 006D","E01031766","65-69 years","Female",80,80,82,71,73,386
"Mid Sussex 006D","E01031766","70-74 years","Female",77,74,70,71,72,364
"Mid Sussex 006D","E01031766","75-79 years","Female",38,48,46,53,56,241
"Mid Sussex 006D","E01031766","80-84 years","Female",35,35,32,27,30,159
"Mid Sussex 006D","E01031766","85+ years","Female",40,39,41,31,30,181
"Mid Sussex 007A","E01031692","0-4 years","Male",82,93,99,84,86,444
"Mid Sussex 007A","E01031692","5-9 years","Male",104,107,113,119,106,549
"Mid Sussex 007A","E01031692","10-14 years","Male",81,95,102,103,132,513
"Mid Sussex 007A","E01031692","15-19 years","Male",60,58,65,69,76,328
"Mid Sussex 007A","E01031692","20-24 years","Male",46,47,40,45,45,223
"Mid Sussex 007A","E01031692","25-29 years","Male",42,38,45,48,53,226
"Mid Sussex 007A","E01031692","30-34 years","Male",86,102,95,87,78,448
"Mid Sussex 007A","E01031692","35-39 years","Male",87,89,96,95,86,453
"Mid Sussex 007A","E01031692","40-44 years","Male",99,90,90,99,117,495
"Mid Sussex 007A","E01031692","45-49 years","Male",111,106,104,108,108,537
"Mid Sussex 007A","E01031692","50-54 years","Male",94,97,96,100,95,482
"Mid Sussex 007A","E01031692","55-59 years","Male",103,95,102,109,120,529
"Mid Sussex 007A","E01031692","60-64 years","Male",57,68,87,88,90,390
"Mid Sussex 007A","E01031692","65-69 years","Male",51,55,46,49,53,254
"Mid Sussex 007A","E01031692","70-74 years","Male",37,39,44,39,45,204
"Mid Sussex 007A","E01031692","75-79 years","Male",20,25,26,33,37,141
"Mid Sussex 007A","E01031692","80-84 years","Male",18,15,15,15,12,75
"Mid Sussex 007A","E01031692","85+ years","Male",18,22,23,20,11,94
"Mid Sussex 007A","E01031692","0-4 years","Female",72,83,80,91,85,411
"Mid Sussex 007A","E01031692","5-9 years","Female",92,98,103,108,113,514
"Mid Sussex 007A","E01031692","10-14 years","Female",83,87,98,101,109,478
"Mid Sussex 007A","E01031692","15-19 years","Female",64,54,60,73,67,318
"Mid Sussex 007A","E01031692","20-24 years","Female",59,60,65,62,61,307
"Mid Sussex 007A","E01031692","25-29 years","Female",63,69,62,67,65,326
"Mid Sussex 007A","E01031692","30-34 years","Female",80,74,96,96,92,438
"Mid Sussex 007A","E01031692","35-39 years","Female",96,106,105,112,112,531
"Mid Sussex 007A","E01031692","40-44 years","Female",95,100,102,84,97,478
"Mid Sussex 007A","E01031692","45-49 years","Female",112,96,103,131,138,580
"Mid Sussex 007A","E01031692","50-54 years","Female",79,99,102,94,88,462
"Mid Sussex 007A","E01031692","55-59 years","Female",91,90,94,99,97,471
"Mid Sussex 007A","E01031692","60-64 years","Female",66,67,66,81,90,370
"Mid Sussex 007A","E01031692","65-69 years","Female",40,48,56,51,56,251
"Mid Sussex 007A","E01031692","70-74 years","Female",45,47,58,53,56,259
"Mid Sussex 007A","E01031692","75-79 years","Female",23,22,23,31,28,127
"Mid Sussex 007A","E01031692","80-84 years","Female",31,27,21,19,15,113
"Mid Sussex 007A","E01031692","85+ years","Female",21,25,31,32,32,141
"Mid Sussex 007B","E01031693","0-4 years","Male",43,53,58,56,59,269
"Mid Sussex 007B","E01031693","5-9 years","Male",77,75,72,77,73,374
"Mid Sussex 007B","E01031693","10-14 years","Male",73,80,82,83,89,407
"Mid Sussex 007B","E01031693","15-19 years","Male",37,34,26,30,36,163
"Mid Sussex 007B","E01031693","20-24 years","Male",21,20,21,20,18,100
"Mid Sussex 007B","E01031693","25-29 years","Male",35,31,30,31,29,156
"Mid Sussex 007B","E01031693","30-34 years","Male",40,36,41,43,36,196
"Mid Sussex 007B","E01031693","35-39 years","Male",52,62,51,48,52,265
"Mid Sussex 007B","E01031693","40-44 years","Male",65,64,64,62,63,318
"Mid Sussex 007B","E01031693","45-49 years","Male",60,62,69,71,64,326
"Mid Sussex 007B","E01031693","50-54 years","Male",92,89,83,80,88,432
"Mid Sussex 007B","E01031693","55-59 years","Male",67,70,75,68,75,355
"Mid Sussex 007B","E01031693","60-64 years","Male",61,52,47,60,63,283
"Mid Sussex 007B","E01031693","65-69 years","Male",64,62,57,49,44,276
"Mid Sussex 007B","E01031693","70-74 years","Male",40,45,46,50,52,233
"Mid Sussex 007B","E01031693","75-79 years","Male",42,45,43,42,42,214
"Mid Sussex 007B","E01031693","80-84 years","Male",31,30,23,27,36,147
"Mid Sussex 007B","E01031693","85+ years","Male",44,36,39,32,25,176
"Mid Sussex 007B","E01031693","0-4 years","Female",35,37,38,32,27,169
"Mid Sussex 007B","E01031693","5-9 years","Female",69,58,52,50,58,287
"Mid Sussex 007B","E01031693","10-14 years","Female",58,63,68,70,68,327
"Mid Sussex 007B","E01031693","15-19 years","Female",44,49,47,43,43,226
"Mid Sussex 007B","E01031693","20-24 years","Female",42,38,39,37,34,190
"Mid Sussex 007B","E01031693","25-29 years","Female",29,33,34,39,38,173
"Mid Sussex 007B","E01031693","30-34 years","Female",45,41,38,36,48,208
"Mid Sussex 007B","E01031693","35-39 years","Female",49,63,57,58,47,274
"Mid Sussex 007B","E01031693","40-44 years","Female",76,64,68,82,81,371
"Mid Sussex 007B","E01031693","45-49 years","Female",79,88,90,74,76,407
"Mid Sussex 007B","E01031693","50-54 years","Female",74,72,71,88,83,388
"Mid Sussex 007B","E01031693","55-59 years","Female",51,49,52,54,56,262
"Mid Sussex 007B","E01031693","60-64 years","Female",47,44,56,52,55,254
"Mid Sussex 007B","E01031693","65-69 years","Female",56,55,48,39,39,237
"Mid Sussex 007B","E01031693","70-74 years","Female",50,49,45,53,54,251
"Mid Sussex 007B","E01031693","75-79 years","Female",31,37,40,38,37,183
"Mid Sussex 007B","E01031693","80-84 years","Female",41,33,24,24,26,148
"Mid Sussex 007B","E01031693","85+ years","Female",78,55,65,60,58,316
"Mid Sussex 007C","E01031697","0-4 years","Male",37,31,27,18,9,122
"Mid Sussex 007C","E01031697","5-9 years","Male",39,32,34,36,39,180
"Mid Sussex 007C","E01031697","10-14 years","Male",32,38,39,39,39,187
"Mid Sussex 007C","E01031697","15-19 years","Male",34,27,25,26,21,133
"Mid Sussex 007C","E01031697","20-24 years","Male",15,15,14,17,16,77
"Mid Sussex 007C","E01031697","25-29 years","Male",30,31,30,25,28,144
"Mid Sussex 007C","E01031697","30-34 years","Male",23,23,21,20,21,108
"Mid Sussex 007C","E01031697","35-39 years","Male",32,27,30,25,21,135
"Mid Sussex 007C","E01031697","40-44 years","Male",48,42,41,36,33,200
"Mid Sussex 007C","E01031697","45-49 years","Male",51,47,40,48,49,235
"Mid Sussex 007C","E01031697","50-54 years","Male",66,69,70,65,63,333
"Mid Sussex 007C","E01031697","55-59 years","Male",47,47,54,56,67,271
"Mid Sussex 007C","E01031697","60-64 years","Male",45,47,41,49,46,228
"Mid Sussex 007C","E01031697","65-69 years","Male",39,36,35,32,37,179
"Mid Sussex 007C","E01031697","70-74 years","Male",38,39,42,32,36,187
"Mid Sussex 007C","E01031697","75-79 years","Male",29,33,33,32,33,160
"Mid Sussex 007C","E01031697","80-84 years","Male",16,20,18,17,14,85
"Mid Sussex 007C","E01031697","85+ years","Male",20,13,12,17,28,90
"Mid Sussex 007C","E01031697","0-4 years","Female",36,34,19,15,17,121
"Mid Sussex 007C","E01031697","5-9 years","Female",39,32,35,26,22,154
"Mid Sussex 007C","E01031697","10-14 years","Female",40,39,35,38,37,189
"Mid Sussex 007C","E01031697","15-19 years","Female",20,26,30,33,43,152
"Mid Sussex 007C","E01031697","20-24 years","Female",20,17,16,16,21,90
"Mid Sussex 007C","E01031697","25-29 years","Female",34,33,33,25,26,151
"Mid Sussex 007C","E01031697","30-34 years","Female",21,24,21,20,17,103
"Mid Sussex 007C","E01031697","35-39 years","Female",34,25,21,20,24,124
"Mid Sussex 007C","E01031697","40-44 years","Female",38,39,38,36,36,187
"Mid Sussex 007C","E01031697","45-49 years","Female",56,48,34,43,46,227
"Mid Sussex 007C","E01031697","50-54 years","Female",75,73,73,64,58,343
"Mid Sussex 007C","E01031697","55-59 years","Female",51,56,65,59,58,289
"Mid Sussex 007C","E01031697","60-64 years","Female",51,49,50,55,59,264
"Mid Sussex 007C","E01031697","65-69 years","Female",31,37,41,40,38,187
"Mid Sussex 007C","E01031697","70-74 years","Female",16,18,17,18,19,88
"Mid Sussex 007C","E01031697","75-79 years","Female",21,14,18,21,21,95
"Mid Sussex 007C","E01031697","80-84 years","Female",21,26,23,31,33,134
"Mid Sussex 007C","E01031697","85+ years","Female",23,25,31,23,22,124
"Mid Sussex 007D","E01031727","0-4 years","Male",47,48,55,45,48,243
"Mid Sussex 007D","E01031727","5-9 years","Male",38,45,48,51,48,230
"Mid Sussex 007D","E01031727","10-14 years","Male",79,80,67,64,68,358
"Mid Sussex 007D","E01031727","15-19 years","Male",46,48,43,43,40,220
"Mid Sussex 007D","E01031727","20-24 years","Male",37,27,31,26,27,148
"Mid Sussex 007D","E01031727","25-29 years","Male",23,23,30,32,30,138
"Mid Sussex 007D","E01031727","30-34 years","Male",21,26,27,24,25,123
"Mid Sussex 007D","E01031727","35-39 years","Male",49,46,50,46,51,242
"Mid Sussex 007D","E01031727","40-44 years","Male",52,52,53,57,51,265
"Mid Sussex 007D","E01031727","45-49 years","Male",81,85,88,86,79,419
"Mid Sussex 007D","E01031727","50-54 years","Male",70,68,61,59,59,317
"Mid Sussex 007D","E01031727","55-59 years","Male",65,62,76,72,80,355
"Mid Sussex 007D","E01031727","60-64 years","Male",53,55,57,61,58,284
"Mid Sussex 007D","E01031727","65-69 years","Male",48,46,44,58,59,255
"Mid Sussex 007D","E01031727","70-74 years","Male",57,64,60,48,54,283
"Mid Sussex 007D","E01031727","75-79 years","Male",38,29,40,45,50,202
"Mid Sussex 007D","E01031727","80-84 years","Male",21,25,28,36,32,142
"Mid Sussex 007D","E01031727","85+ years","Male",29,28,28,27,29,141
"Mid Sussex 007D","E01031727","0-4 years","Female",34,43,37,34,29,177
"Mid Sussex 007D","E01031727","5-9 years","Female",50,52,48,44,46,240
"Mid Sussex 007D","E01031727","10-14 years","Female",60,59,67,71,72,329
"Mid Sussex 007D","E01031727","15-19 years","Female",49,48,47,49,53,246
"Mid Sussex 007D","E01031727","20-24 years","Female",24,29,34,29,35,151
"Mid Sussex 007D","E01031727","25-29 years","Female",16,21,23,25,25,110
"Mid Sussex 007D","E01031727","30-34 years","Female",30,34,30,31,25,150
"Mid Sussex 007D","E01031727","35-39 years","Female",40,48,56,53,46,243
"Mid Sussex 007D","E01031727","40-44 years","Female",65,56,47,49,56,273
"Mid Sussex 007D","E01031727","45-49 years","Female",73,76,71,66,67,353
"Mid Sussex 007D","E01031727","50-54 years","Female",85,85,95,90,75,430
"Mid Sussex 007D","E01031727","55-59 years","Female",59,65,60,68,66,318
"Mid Sussex 007D","E01031727","60-64 years","Female",43,43,51,47,57,241
"Mid Sussex 007D","E01031727","65-69 years","Female",71,65,60,60,53,309
"Mid Sussex 007D","E01031727","70-74 years","Female",52,60,56,61,54,283
"Mid Sussex 007D","E01031727","75-79 years","Female",41,48,61,61,65,276
"Mid Sussex 007D","E01031727","80-84 years","Female",28,26,29,32,29,144
"Mid Sussex 007D","E01031727","85+ years","Female",47,42,46,50,45,230
"Mid Sussex 008A","E01031758","0-4 years","Male",45,47,43,34,36,205
"Mid Sussex 008A","E01031758","5-9 years","Male",42,40,48,42,46,218
"Mid Sussex 008A","E01031758","10-14 years","Male",51,50,46,50,49,246
"Mid Sussex 008A","E01031758","15-19 years","Male",43,43,41,36,37,200
"Mid Sussex 008A","E01031758","20-24 years","Male",35,35,25,27,29,151
"Mid Sussex 008A","E01031758","25-29 years","Male",34,25,35,32,31,157
"Mid Sussex 008A","E01031758","30-34 years","Male",31,33,30,28,28,150
"Mid Sussex 008A","E01031758","35-39 years","Male",49,38,42,37,34,200
"Mid Sussex 008A","E01031758","40-44 years","Male",41,39,42,41,48,211
"Mid Sussex 008A","E01031758","45-49 years","Male",44,55,54,53,44,250
"Mid Sussex 008A","E01031758","50-54 years","Male",43,39,42,43,44,211
"Mid Sussex 008A","E01031758","55-59 years","Male",59,55,47,44,40,245
"Mid Sussex 008A","E01031758","60-64 years","Male",57,57,59,58,54,285
"Mid Sussex 008A","E01031758","65-69 years","Male",58,58,60,58,59,293
"Mid Sussex 008A","E01031758","70-74 years","Male",42,44,47,48,50,231
"Mid Sussex 008A","E01031758","75-79 years","Male",21,25,22,29,32,129
"Mid Sussex 008A","E01031758","80-84 years","Male",13,15,18,20,21,87
"Mid Sussex 008A","E01031758","85+ years","Male",4,3,7,4,6,24
"Mid Sussex 008A","E01031758","0-4 years","Female",33,40,40,35,40,188
"Mid Sussex 008A","E01031758","5-9 years","Female",57,59,48,54,51,269
"Mid Sussex 008A","E01031758","10-14 years","Female",41,44,52,50,55,242
"Mid Sussex 008A","E01031758","15-19 years","Female",43,41,40,36,36,196
"Mid Sussex 008A","E01031758","20-24 years","Female",22,23,22,18,21,106
"Mid Sussex 008A","E01031758","25-29 years","Female",21,24,18,25,21,109
"Mid Sussex 008A","E01031758","30-34 years","Female",42,31,31,27,31,162
"Mid Sussex 008A","E01031758","35-39 years","Female",49,46,52,39,41,227
"Mid Sussex 008A","E01031758","40-44 years","Female",43,41,43,50,55,232
"Mid Sussex 008A","E01031758","45-49 years","Female",47,48,47,50,54,246
"Mid Sussex 008A","E01031758","50-54 years","Female",64,54,48,43,42,251
"Mid Sussex 008A","E01031758","55-59 years","Female",63,65,65,65,53,311
"Mid Sussex 008A","E01031758","60-64 years","Female",58,62,59,53,55,287
"Mid Sussex 008A","E01031758","65-69 years","Female",48,45,49,51,55,248
"Mid Sussex 008A","E01031758","70-74 years","Female",36,52,55,56,56,255
"Mid Sussex 008A","E01031758","75-79 years","Female",19,16,19,27,34,115
"Mid Sussex 008A","E01031758","80-84 years","Female",15,13,12,11,13,64
"Mid Sussex 008A","E01031758","85+ years","Female",5,7,9,13,10,44
"Mid Sussex 008B","E01031760","0-4 years","Male",63,67,65,64,59,318
"Mid Sussex 008B","E01031760","5-9 years","Male",59,60,61,61,66,307
"Mid Sussex 008B","E01031760","10-14 years","Male",48,52,48,50,45,243
"Mid Sussex 008B","E01031760","15-19 years","Male",77,67,73,70,73,360
"Mid Sussex 008B","E01031760","20-24 years","Male",37,41,43,38,36,195
"Mid Sussex 008B","E01031760","25-29 years","Male",42,33,31,25,29,160
"Mid Sussex 008B","E01031760","30-34 years","Male",42,40,39,48,50,219
"Mid Sussex 008B","E01031760","35-39 years","Male",71,70,55,52,50,298
"Mid Sussex 008B","E01031760","40-44 years","Male",63,56,54,65,64,302
"Mid Sussex 008B","E01031760","45-49 years","Male",76,88,93,81,89,427
"Mid Sussex 008B","E01031760","50-54 years","Male",59,59,57,54,51,280
"Mid Sussex 008B","E01031760","55-59 years","Male",57,59,59,62,64,301
"Mid Sussex 008B","E01031760","60-64 years","Male",44,46,46,47,45,228
"Mid Sussex 008B","E01031760","65-69 years","Male",42,35,36,38,43,194
"Mid Sussex 008B","E01031760","70-74 years","Male",33,42,41,48,45,209
"Mid Sussex 008B","E01031760","75-79 years","Male",21,19,27,27,33,127
"Mid Sussex 008B","E01031760","80-84 years","Male",14,13,12,14,16,69
"Mid Sussex 008B","E01031760","85+ years","Male",15,18,16,12,14,75
"Mid Sussex 008B","E01031760","0-4 years","Female",47,42,43,42,46,220
"Mid Sussex 008B","E01031760","5-9 years","Female",61,63,55,52,53,284
"Mid Sussex 008B","E01031760","10-14 years","Female",78,73,75,77,78,381
"Mid Sussex 008B","E01031760","15-19 years","Female",38,39,41,42,47,207
"Mid Sussex 008B","E01031760","20-24 years","Female",37,35,41,44,45,202
"Mid Sussex 008B","E01031760","25-29 years","Female",43,41,44,38,38,204
"Mid Sussex 008B","E01031760","30-34 years","Female",57,50,49,59,68,283
"Mid Sussex 008B","E01031760","35-39 years","Female",54,57,62,57,64,294
"Mid Sussex 008B","E01031760","40-44 years","Female",84,85,71,67,62,369
"Mid Sussex 008B","E01031760","45-49 years","Female",69,72,74,78,81,374
"Mid Sussex 008B","E01031760","50-54 years","Female",86,84,79,71,80,400
"Mid Sussex 008B","E01031760","55-59 years","Female",45,49,64,71,71,300
"Mid Sussex 008B","E01031760","60-64 years","Female",37,32,36,35,34,174
"Mid Sussex 008B","E01031760","65-69 years","Female",60,68,59,59,58,304
"Mid Sussex 008B","E01031760","70-74 years","Female",42,48,57,58,61,266
"Mid Sussex 008B","E01031760","75-79 years","Female",33,28,30,28,31,150
"Mid Sussex 008B","E01031760","80-84 years","Female",18,25,25,32,21,121
"Mid Sussex 008B","E01031760","85+ years","Female",35,30,32,29,36,162
"Mid Sussex 008C","E01031772","0-4 years","Male",67,66,76,67,57,333
"Mid Sussex 008C","E01031772","5-9 years","Male",79,82,96,87,98,442
"Mid Sussex 008C","E01031772","10-14 years","Male",50,57,66,70,82,325
"Mid Sussex 008C","E01031772","15-19 years","Male",52,42,42,44,48,228
"Mid Sussex 008C","E01031772","20-24 years","Male",33,30,26,30,38,157
"Mid Sussex 008C","E01031772","25-29 years","Male",67,62,58,58,56,301
"Mid Sussex 008C","E01031772","30-34 years","Male",39,37,47,50,53,226
"Mid Sussex 008C","E01031772","35-39 years","Male",45,49,38,40,37,209
"Mid Sussex 008C","E01031772","40-44 years","Male",88,84,98,95,106,471
"Mid Sussex 008C","E01031772","45-49 years","Male",68,69,68,72,72,349
"Mid Sussex 008C","E01031772","50-54 years","Male",54,49,50,53,60,266
"Mid Sussex 008C","E01031772","55-59 years","Male",54,63,65,67,63,312
"Mid Sussex 008C","E01031772","60-64 years","Male",36,39,43,48,55,221
"Mid Sussex 008C","E01031772","65-69 years","Male",51,46,42,36,35,210
"Mid Sussex 008C","E01031772","70-74 years","Male",43,42,45,51,49,230
"Mid Sussex 008C","E01031772","75-79 years","Male",37,39,45,42,48,211
"Mid Sussex 008C","E01031772","80-84 years","Male",24,23,21,29,31,128
"Mid Sussex 008C","E01031772","85+ years","Male",39,34,34,32,34,173
"Mid Sussex 008C","E01031772","0-4 years","Female",65,55,62,57,54,293
"Mid Sussex 008C","E01031772","5-9 years","Female",68,69,65,62,77,341
"Mid Sussex 008C","E01031772","10-14 years","Female",39,45,59,60,68,271
"Mid Sussex 008C","E01031772","15-19 years","Female",49,48,47,47,44,235
"Mid Sussex 008C","E01031772","20-24 years","Female",18,20,25,26,25,114
"Mid Sussex 008C","E01031772","25-29 years","Female",45,37,35,40,40,197
"Mid Sussex 008C","E01031772","30-34 years","Female",47,39,48,49,48,231
"Mid Sussex 008C","E01031772","35-39 years","Female",76,65,73,60,59,333
"Mid Sussex 008C","E01031772","40-44 years","Female",63,76,82,88,98,407
"Mid Sussex 008C","E01031772","45-49 years","Female",77,71,69,74,79,370
"Mid Sussex 008C","E01031772","50-54 years","Female",66,71,74,76,80,367
"Mid Sussex 008C","E01031772","55-59 years","Female",45,43,50,55,62,255
"Mid Sussex 008C","E01031772","60-64 years","Female",47,40,45,46,42,220
"Mid Sussex 008C","E01031772","65-69 years","Female",66,63,56,56,50,291
"Mid Sussex 008C","E01031772","70-74 years","Female",54,57,63,69,70,313
"Mid Sussex 008C","E01031772","75-79 years","Female",48,53,48,52,52,253
"Mid Sussex 008C","E01031772","80-84 years","Female",45,42,45,45,43,220
"Mid Sussex 008C","E01031772","85+ years","Female",84,84,78,75,73,394
"Mid Sussex 008D","E01031773","0-4 years","Male",53,44,49,44,44,234
"Mid Sussex 008D","E01031773","5-9 years","Male",75,80,68,66,54,343
"Mid Sussex 008D","E01031773","10-14 years","Male",67,78,80,74,75,374
"Mid Sussex 008D","E01031773","15-19 years","Male",52,43,47,52,53,247
"Mid Sussex 008D","E01031773","20-24 years","Male",25,37,39,44,44,189
"Mid Sussex 008D","E01031773","25-29 years","Male",33,30,28,27,24,142
"Mid Sussex 008D","E01031773","30-34 years","Male",27,23,23,34,34,141
"Mid Sussex 008D","E01031773","35-39 years","Male",55,54,49,42,42,242
"Mid Sussex 008D","E01031773","40-44 years","Male",74,76,75,66,57,348
"Mid Sussex 008D","E01031773","45-49 years","Male",62,68,63,73,76,342
"Mid Sussex 008D","E01031773","50-54 years","Male",85,81,82,75,70,393
"Mid Sussex 008D","E01031773","55-59 years","Male",59,64,69,72,77,341
"Mid Sussex 008D","E01031773","60-64 years","Male",60,51,57,52,50,270
"Mid Sussex 008D","E01031773","65-69 years","Male",55,52,51,57,58,273
"Mid Sussex 008D","E01031773","70-74 years","Male",67,67,68,56,53,311
"Mid Sussex 008D","E01031773","75-79 years","Male",46,48,48,52,58,252
"Mid Sussex 008D","E01031773","80-84 years","Male",25,29,30,28,33,145
"Mid Sussex 008D","E01031773","85+ years","Male",27,24,23,27,25,126
"Mid Sussex 008D","E01031773","0-4 years","Female",38,37,39,45,49,208
"Mid Sussex 008D","E01031773","5-9 years","Female",88,86,93,71,52,390
"Mid Sussex 008D","E01031773","10-14 years","Female",51,47,56,68,77,299
"Mid Sussex 008D","E01031773","15-19 years","Female",38,47,47,49,49,230
"Mid Sussex 008D","E01031773","20-24 years","Female",21,27,30,21,19,118
"Mid Sussex 008D","E01031773","25-29 years","Female",32,29,32,33,32,158
"Mid Sussex 008D","E01031773","30-34 years","Female",35,48,41,39,46,209
"Mid Sussex 008D","E01031773","35-39 years","Female",75,61,57,45,46,284
"Mid Sussex 008D","E01031773","40-44 years","Female",80,82,82,85,81,410
"Mid Sussex 008D","E01031773","45-49 years","Female",81,88,94,84,73,420
"Mid Sussex 008D","E01031773","50-54 years","Female",72,61,58,64,73,328
"Mid Sussex 008D","E01031773","55-59 years","Female",61,67,70,67,67,332
"Mid Sussex 008D","E01031773","60-64 years","Female",71,71,68,69,76,355
"Mid Sussex 008D","E01031773","65-69 years","Female",58,58,62,72,68,318
"Mid Sussex 008D","E01031773","70-74 years","Female",84,90,87,78,75,414
"Mid Sussex 008D","E01031773","75-79 years","Female",59,65,65,64,64,317
"Mid Sussex 008D","E01031773","80-84 years","Female",44,47,49,50,55,245
"Mid Sussex 008D","E01031773","85+ years","Female",56,50,48,48,47,249
"Mid Sussex 008E","E01031774","0-4 years","Male",44,58,61,74,82,319
"Mid Sussex 008E","E01031774","5-9 years","Male",76,89,85,76,78,404
"Mid Sussex 008E","E01031774","10-14 years","Male",62,61,75,78,82,358
"Mid Sussex 008E","E01031774","15-19 years","Male",45,48,40,42,47,222
"Mid Sussex 008E","E01031774","20-24 years","Male",28,29,30,35,32,154
"Mid Sussex 008E","E01031774","25-29 years","Male",17,19,21,22,18,97
"Mid Sussex 008E","E01031774","30-34 years","Male",40,40,33,36,37,186
"Mid Sussex 008E","E01031774","35-39 years","Male",61,71,80,86,86,384
"Mid Sussex 008E","E01031774","40-44 years","Male",76,76,76,72,72,372
"Mid Sussex 008E","E01031774","45-49 years","Male",83,85,91,83,88,430
"Mid Sussex 008E","E01031774","50-54 years","Male",48,53,60,76,80,317
"Mid Sussex 008E","E01031774","55-59 years","Male",42,49,44,43,46,224
"Mid Sussex 008E","E01031774","60-64 years","Male",68,60,62,56,56,302
"Mid Sussex 008E","E01031774","65-69 years","Male",58,62,64,61,50,295
"Mid Sussex 008E","E01031774","70-74 years","Male",73,70,72,74,74,363
"Mid Sussex 008E","E01031774","75-79 years","Male",42,52,60,69,72,295
"Mid Sussex 008E","E01031774","80-84 years","Male",34,31,25,27,30,147
"Mid Sussex 008E","E01031774","85+ years","Male",35,40,40,37,39,191
"Mid Sussex 008E","E01031774","0-4 years","Female",79,85,102,115,117,498
"Mid Sussex 008E","E01031774","5-9 years","Female",73,88,88,90,103,442
"Mid Sussex 008E","E01031774","10-14 years","Female",68,77,76,86,82,389
"Mid Sussex 008E","E01031774","15-19 years","Female",44,35,35,35,38,187
"Mid Sussex 008E","E01031774","20-24 years","Female",37,39,33,28,31,168
"Mid Sussex 008E","E01031774","25-29 years","Female",30,36,52,55,49,222
"Mid Sussex 008E","E01031774","30-34 years","Female",50,51,50,49,47,247
"Mid Sussex 008E","E01031774","35-39 years","Female",86,96,90,92,98,462
"Mid Sussex 008E","E01031774","40-44 years","Female",73,74,86,88,102,423
"Mid Sussex 008E","E01031774","45-49 years","Female",75,79,84,85,89,412
"Mid Sussex 008E","E01031774","50-54 years","Female",71,80,76,78,69,374
"Mid Sussex 008E","E01031774","55-59 years","Female",71,67,63,69,77,347
"Mid Sussex 008E","E01031774","60-64 years","Female",64,64,60,54,63,305
"Mid Sussex 008E","E01031774","65-69 years","Female",73,63,66,69,60,331
"Mid Sussex 008E","E01031774","70-74 years","Female",64,82,74,70,75,365
"Mid Sussex 008E","E01031774","75-79 years","Female",41,41,51,62,66,261
"Mid Sussex 008E","E01031774","80-84 years","Female",31,34,34,35,36,170
"Mid Sussex 008E","E01031774","85+ years","Female",43,40,45,49,41,218
"Mid Sussex 008F","E01031775","0-4 years","Male",65,65,63,64,72,329
"Mid Sussex 008F","E01031775","5-9 years","Male",71,71,85,87,75,389
"Mid Sussex 008F","E01031775","10-14 years","Male",65,61,64,76,86,352
"Mid Sussex 008F","E01031775","15-19 years","Male",36,38,37,44,43,198
"Mid Sussex 008F","E01031775","20-24 years","Male",21,23,31,30,27,132
"Mid Sussex 008F","E01031775","25-29 years","Male",24,23,24,23,29,123
"Mid Sussex 008F","E01031775","30-34 years","Male",33,27,28,23,26,137
"Mid Sussex 008F","E01031775","35-39 years","Male",62,63,60,50,50,285
"Mid Sussex 008F","E01031775","40-44 years","Male",60,64,68,63,63,318
"Mid Sussex 008F","E01031775","45-49 years","Male",66,60,59,73,73,331
"Mid Sussex 008F","E01031775","50-54 years","Male",43,47,50,42,38,220
"Mid Sussex 008F","E01031775","55-59 years","Male",45,50,49,58,62,264
"Mid Sussex 008F","E01031775","60-64 years","Male",41,38,41,42,36,198
"Mid Sussex 008F","E01031775","65-69 years","Male",56,40,38,40,43,217
"Mid Sussex 008F","E01031775","70-74 years","Male",56,70,62,67,58,313
"Mid Sussex 008F","E01031775","75-79 years","Male",45,47,50,44,44,230
"Mid Sussex 008F","E01031775","80-84 years","Male",34,37,37,34,34,176
"Mid Sussex 008F","E01031775","85+ years","Male",50,44,47,47,49,237
"Mid Sussex 008F","E01031775","0-4 years","Female",51,49,47,50,55,252
"Mid Sussex 008F","E01031775","5-9 years","Female",64,60,69,65,75,333
"Mid Sussex 008F","E01031775","10-14 years","Female",59,60,61,61,62,303
"Mid Sussex 008F","E01031775","15-19 years","Female",57,55,52,52,46,262
"Mid Sussex 008F","E01031775","20-24 years","Female",14,14,21,27,25,101
"Mid Sussex 008F","E01031775","25-29 years","Female",23,24,19,18,27,111
"Mid Sussex 008F","E01031775","30-34 years","Female",36,28,30,35,32,161
"Mid Sussex 008F","E01031775","35-39 years","Female",68,76,77,74,66,361
"Mid Sussex 008F","E01031775","40-44 years","Female",74,61,64,68,73,340
"Mid Sussex 008F","E01031775","45-49 years","Female",67,64,72,76,75,354
"Mid Sussex 008F","E01031775","50-54 years","Female",59,67,63,63,66,318
"Mid Sussex 008F","E01031775","55-59 years","Female",50,54,47,49,49,249
"Mid Sussex 008F","E01031775","60-64 years","Female",55,43,51,47,40,236
"Mid Sussex 008F","E01031775","65-69 years","Female",59,55,51,50,55,270
"Mid Sussex 008F","E01031775","70-74 years","Female",88,102,99,85,66,440
"Mid Sussex 008F","E01031775","75-79 years","Female",60,55,61,69,83,328
"Mid Sussex 008F","E01031775","80-84 years","Female",54,48,49,50,50,251
"Mid Sussex 008F","E01031775","85+ years","Female",55,56,54,56,52,273
"Mid Sussex 009A","E01031751","0-4 years","Male",106,96,103,85,80,470
"Mid Sussex 009A","E01031751","5-9 years","Male",66,65,68,73,65,337
"Mid Sussex 009A","E01031751","10-14 years","Male",73,78,77,76,94,398
"Mid Sussex 009A","E01031751","15-19 years","Male",59,52,52,51,47,261
"Mid Sussex 009A","E01031751","20-24 years","Male",60,61,66,69,66,322
"Mid Sussex 009A","E01031751","25-29 years","Male",134,121,115,97,103,570
"Mid Sussex 009A","E01031751","30-34 years","Male",127,141,136,136,143,683
"Mid Sussex 009A","E01031751","35-39 years","Male",132,131,129,136,129,657
"Mid Sussex 009A","E01031751","40-44 years","Male",143,144,136,131,133,687
"Mid Sussex 009A","E01031751","45-49 years","Male",99,104,99,105,102,509
"Mid Sussex 009A","E01031751","50-54 years","Male",79,66,83,95,103,426
"Mid Sussex 009A","E01031751","55-59 years","Male",90,95,97,96,95,473
"Mid Sussex 009A","E01031751","60-64 years","Male",57,61,60,68,69,315
"Mid Sussex 009A","E01031751","65-69 years","Male",58,51,42,44,53,248
"Mid Sussex 009A","E01031751","70-74 years","Male",41,51,59,57,65,273
"Mid Sussex 009A","E01031751","75-79 years","Male",39,30,33,36,31,169
"Mid Sussex 009A","E01031751","80-84 years","Male",17,18,17,14,15,81
"Mid Sussex 009A","E01031751","85+ years","Male",7,7,9,12,11,46
"Mid Sussex 009A","E01031751","0-4 years","Female",107,102,103,99,94,505
"Mid Sussex 009A","E01031751","5-9 years","Female",76,73,67,70,60,346
"Mid Sussex 009A","E01031751","10-14 years","Female",63,57,60,68,53,301
"Mid Sussex 009A","E01031751","15-19 years","Female",63,69,64,57,60,313
"Mid Sussex 009A","E01031751","20-24 years","Female",68,61,65,68,60,322
"Mid Sussex 009A","E01031751","25-29 years","Female",142,128,131,127,133,661
"Mid Sussex 009A","E01031751","30-34 years","Female",140,139,117,123,109,628
"Mid Sussex 009A","E01031751","35-39 years","Female",102,113,127,120,130,592
"Mid Sussex 009A","E01031751","40-44 years","Female",117,103,94,101,100,515
"Mid Sussex 009A","E01031751","45-49 years","Female",112,109,112,108,107,548
"Mid Sussex 009A","E01031751","50-54 years","Female",89,95,92,99,90,465
"Mid Sussex 009A","E01031751","55-59 years","Female",75,71,81,74,89,390
"Mid Sussex 009A","E01031751","60-64 years","Female",58,68,64,72,70,332
"Mid Sussex 009A","E01031751","65-69 years","Female",58,49,47,45,48,247
"Mid Sussex 009A","E01031751","70-74 years","Female",54,62,73,77,68,334
"Mid Sussex 009A","E01031751","75-79 years","Female",25,28,28,31,45,157
"Mid Sussex 009A","E01031751","80-84 years","Female",22,17,17,17,16,89
"Mid Sussex 009A","E01031751","85+ years","Female",21,26,17,15,13,92
"Mid Sussex 009B","E01031759","0-4 years","Male",63,56,52,56,54,281
"Mid Sussex 009B","E01031759","5-9 years","Male",59,59,58,63,62,301
"Mid Sussex 009B","E01031759","10-14 years","Male",38,46,53,56,53,246
"Mid Sussex 009B","E01031759","15-19 years","Male",31,28,27,24,28,138
"Mid Sussex 009B","E01031759","20-24 years","Male",43,47,48,42,52,232
"Mid Sussex 009B","E01031759","25-29 years","Male",46,48,37,40,37,208
"Mid Sussex 009B","E01031759","30-34 years","Male",72,72,62,52,59,317
"Mid Sussex 009B","E01031759","35-39 years","Male",72,72,77,80,82,383
"Mid Sussex 009B","E01031759","40-44 years","Male",44,56,62,62,60,284
"Mid Sussex 009B","E01031759","45-49 years","Male",71,73,69,72,64,349
"Mid Sussex 009B","E01031759","50-54 years","Male",64,66,73,69,66,338
"Mid Sussex 009B","E01031759","55-59 years","Male",42,50,48,48,49,237
"Mid Sussex 009B","E01031759","60-64 years","Male",41,42,34,41,49,207
"Mid Sussex 009B","E01031759","65-69 years","Male",61,53,55,51,48,268
"Mid Sussex 009B","E01031759","70-74 years","Male",39,42,47,50,55,233
"Mid Sussex 009B","E01031759","75-79 years","Male",27,25,30,33,33,148
"Mid Sussex 009B","E01031759","80-84 years","Male",17,15,15,15,14,76
"Mid Sussex 009B","E01031759","85+ years","Male",22,29,27,31,34,143
"Mid Sussex 009B","E01031759","0-4 years","Female",58,59,60,62,62,301
"Mid Sussex 009B","E01031759","5-9 years","Female",55,58,56,54,52,275
"Mid Sussex 009B","E01031759","10-14 years","Female",39,42,43,51,50,225
"Mid Sussex 009B","E01031759","15-19 years","Female",38,35,39,39,35,186
"Mid Sussex 009B","E01031759","20-24 years","Female",26,27,27,30,27,137
"Mid Sussex 009B","E01031759","25-29 years","Female",49,52,48,50,46,245
"Mid Sussex 009B","E01031759","30-34 years","Female",68,67,64,59,59,317
"Mid Sussex 009B","E01031759","35-39 years","Female",53,57,61,62,68,301
"Mid Sussex 009B","E01031759","40-44 years","Female",63,67,65,71,72,338
"Mid Sussex 009B","E01031759","45-49 years","Female",63,67,73,73,65,341
"Mid Sussex 009B","E01031759","50-54 years","Female",57,61,54,51,61,284
"Mid Sussex 009B","E01031759","55-59 years","Female",32,37,41,44,42,196
"Mid Sussex 009B","E01031759","60-64 years","Female",66,51,40,39,40,236
"Mid Sussex 009B","E01031759","65-69 years","Female",52,56,58,59,60,285
"Mid Sussex 009B","E01031759","70-74 years","Female",43,48,54,58,57,260
"Mid Sussex 009B","E01031759","75-79 years","Female",38,36,39,35,38,186
"Mid Sussex 009B","E01031759","80-84 years","Female",21,22,25,27,31,126
"Mid Sussex 009B","E01031759","85+ years","Female",25,26,23,26,25,125
"Mid Sussex 009C","E01031761","0-4 years","Male",55,47,53,50,54,259
"Mid Sussex 009C","E01031761","5-9 years","Male",54,49,46,46,48,243
"Mid Sussex 009C","E01031761","10-14 years","Male",44,44,49,50,58,245
"Mid Sussex 009C","E01031761","15-19 years","Male",36,42,40,46,54,218
"Mid Sussex 009C","E01031761","20-24 years","Male",50,44,58,51,52,255
"Mid Sussex 009C","E01031761","25-29 years","Male",122,111,127,117,109,586
"Mid Sussex 009C","E01031761","30-34 years","Male",135,128,117,132,137,649
"Mid Sussex 009C","E01031761","35-39 years","Male",99,94,91,91,87,462
"Mid Sussex 009C","E01031761","40-44 years","Male",113,113,114,130,123,593
"Mid Sussex 009C","E01031761","45-49 years","Male",87,86,93,92,100,458
"Mid Sussex 009C","E01031761","50-54 years","Male",89,92,87,87,89,444
"Mid Sussex 009C","E01031761","55-59 years","Male",50,43,53,61,67,274
"Mid Sussex 009C","E01031761","60-64 years","Male",47,53,43,42,48,233
"Mid Sussex 009C","E01031761","65-69 years","Male",40,47,48,47,41,223
"Mid Sussex 009C","E01031761","70-74 years","Male",41,49,55,66,63,274
"Mid Sussex 009C","E01031761","75-79 years","Male",22,18,26,25,28,119
"Mid Sussex 009C","E01031761","80-84 years","Male",19,28,26,29,27,129
"Mid Sussex 009C","E01031761","85+ years","Male",40,40,39,37,40,196
"Mid Sussex 009C","E01031761","0-4 years","Female",67,54,48,55,56,280
"Mid Sussex 009C","E01031761","5-9 years","Female",32,39,34,43,44,192
"Mid Sussex 009C","E01031761","10-14 years","Female",28,32,31,35,33,159
"Mid Sussex 009C","E01031761","15-19 years","Female",20,19,14,12,17,82
"Mid Sussex 009C","E01031761","20-24 years","Female",53,57,52,45,44,251
"Mid Sussex 009C","E01031761","25-29 years","Female",130,115,123,124,116,608
"Mid Sussex 009C","E01031761","30-34 years","Female",109,114,132,142,134,631
"Mid Sussex 009C","E01031761","35-39 years","Female",104,90,100,100,96,490
"Mid Sussex 009C","E01031761","40-44 years","Female",62,69,66,67,82,346
"Mid Sussex 009C","E01031761","45-49 years","Female",63,78,60,67,68,336
"Mid Sussex 009C","E01031761","50-54 years","Female",53,54,53,60,68,288
"Mid Sussex 009C","E01031761","55-59 years","Female",35,34,42,43,42,196
"Mid Sussex 009C","E01031761","60-64 years","Female",38,39,39,35,35,186
"Mid Sussex 009C","E01031761","65-69 years","Female",59,55,56,61,57,288
"Mid Sussex 009C","E01031761","70-74 years","Female",38,40,40,45,45,208
"Mid Sussex 009C","E01031761","75-79 years","Female",39,50,43,42,56,230
"Mid Sussex 009C","E01031761","80-84 years","Female",38,44,49,49,46,226
"Mid Sussex 009C","E01031761","85+ years","Female",120,119,115,119,126,599
"Mid Sussex 009E","E01032837","0-4 years","Male",93,101,109,106,96,505
"Mid Sussex 009E","E01032837","5-9 years","Male",83,103,105,115,107,513
"Mid Sussex 009E","E01032837","10-14 years","Male",45,46,54,55,64,264
"Mid Sussex 009E","E01032837","15-19 years","Male",38,34,31,31,39,173
"Mid Sussex 009E","E01032837","20-24 years","Male",32,42,39,39,38,190
"Mid Sussex 009E","E01032837","25-29 years","Male",40,42,53,45,54,234
"Mid Sussex 009E","E01032837","30-34 years","Male",74,85,86,90,78,413
"Mid Sussex 009E","E01032837","35-39 years","Male",68,82,88,78,80,396
"Mid Sussex 009E","E01032837","40-44 years","Male",84,89,93,93,95,454
"Mid Sussex 009E","E01032837","45-49 years","Male",80,89,100,107,107,483
"Mid Sussex 009E","E01032837","50-54 years","Male",35,49,49,57,66,256
"Mid Sussex 009E","E01032837","55-59 years","Male",32,32,30,37,36,167
"Mid Sussex 009E","E01032837","60-64 years","Male",39,43,42,47,46,217
"Mid Sussex 009E","E01032837","65-69 years","Male",28,33,28,27,29,145
"Mid Sussex 009E","E01032837","70-74 years","Male",34,35,35,32,30,166
"Mid Sussex 009E","E01032837","75-79 years","Male",31,36,48,54,55,224
"Mid Sussex 009E","E01032837","80-84 years","Male",19,27,29,28,37,140
"Mid Sussex 009E","E01032837","85+ years","Male",54,48,59,52,49,262
"Mid Sussex 009E","E01032837","0-4 years","Female",65,77,85,76,81,384
"Mid Sussex 009E","E01032837","5-9 years","Female",68,60,56,76,75,335
"Mid Sussex 009E","E01032837","10-14 years","Female",59,81,86,80,88,394
"Mid Sussex 009E","E01032837","15-19 years","Female",34,31,43,46,50,204
"Mid Sussex 009E","E01032837","20-24 years","Female",29,32,29,33,24,147
"Mid Sussex 009E","E01032837","25-29 years","Female",44,55,61,64,63,287
"Mid Sussex 009E","E01032837","30-34 years","Female",56,67,71,78,69,341
"Mid Sussex 009E","E01032837","35-39 years","Female",99,109,123,106,116,553
"Mid Sussex 009E","E01032837","40-44 years","Female",105,113,109,104,112,543
"Mid Sussex 009E","E01032837","45-49 years","Female",61,73,88,95,99,416
"Mid Sussex 009E","E01032837","50-54 years","Female",43,47,51,55,61,257
"Mid Sussex 009E","E01032837","55-59 years","Female",33,37,40,46,52,208
"Mid Sussex 009E","E01032837","60-64 years","Female",31,34,34,39,36,174
"Mid Sussex 009E","E01032837","65-69 years","Female",55,66,55,43,37,256
"Mid Sussex 009E","E01032837","70-74 years","Female",30,35,36,39,43,183
"Mid Sussex 009E","E01032837","75-79 years","Female",37,51,55,65,62,270
"Mid Sussex 009E","E01032837","80-84 years","Female",31,45,63,59,64,262
"Mid Sussex 009E","E01032837","85+ years","Female",105,94,99,97,92,487
"Mid Sussex 009F","E01032838","0-4 years","Male",77,68,65,69,72,351
"Mid Sussex 009F","E01032838","5-9 years","Male",83,82,74,60,57,356
"Mid Sussex 009F","E01032838","10-14 years","Male",39,44,50,47,42,222
"Mid Sussex 009F","E01032838","15-19 years","Male",28,27,30,40,44,169
"Mid Sussex 009F","E01032838","20-24 years","Male",28,22,23,23,25,121
"Mid Sussex 009F","E01032838","25-29 years","Male",59,55,53,45,44,256
"Mid Sussex 009F","E01032838","30-34 years","Male",93,81,75,59,63,371
"Mid Sussex 009F","E01032838","35-39 years","Male",77,88,101,90,79,435
"Mid Sussex 009F","E01032838","40-44 years","Male",93,86,83,84,88,434
"Mid Sussex 009F","E01032838","45-49 years","Male",63,55,69,65,72,324
"Mid Sussex 009F","E01032838","50-54 years","Male",60,70,71,75,71,347
"Mid Sussex 009F","E01032838","55-59 years","Male",32,37,38,36,37,180
"Mid Sussex 009F","E01032838","60-64 years","Male",18,20,20,20,25,103
"Mid Sussex 009F","E01032838","65-69 years","Male",27,23,25,27,20,122
"Mid Sussex 009F","E01032838","70-74 years","Male",13,16,18,21,20,88
"Mid Sussex 009F","E01032838","75-79 years","Male",9,16,16,16,14,71
"Mid Sussex 009F","E01032838","80-84 years","Male",8,6,11,5,11,41
"Mid Sussex 009F","E01032838","85+ years","Male",2,3,4,6,7,22
"Mid Sussex 009F","E01032838","0-4 years","Female",85,82,77,68,63,375
"Mid Sussex 009F","E01032838","5-9 years","Female",70,69,81,79,76,375
"Mid Sussex 009F","E01032838","10-14 years","Female",65,61,60,66,69,321
"Mid Sussex 009F","E01032838","15-19 years","Female",25,29,31,37,44,166
"Mid Sussex 009F","E01032838","20-24 years","Female",28,36,41,38,34,177
"Mid Sussex 009F","E01032838","25-29 years","Female",83,72,58,52,56,321
"Mid Sussex 009F","E01032838","30-34 years","Female",77,76,79,77,70,379
"Mid Sussex 009F","E01032838","35-39 years","Female",111,106,108,98,89,512
"Mid Sussex 009F","E01032838","40-44 years","Female",66,67,72,72,77,354
"Mid Sussex 009F","E01032838","45-49 years","Female",47,49,56,56,60,268
"Mid Sussex 009F","E01032838","50-54 years","Female",49,51,45,44,51,240
"Mid Sussex 009F","E01032838","55-59 years","Female",22,26,35,37,37,157
"Mid Sussex 009F","E01032838","60-64 years","Female",23,26,22,25,22,118
"Mid Sussex 009F","E01032838","65-69 years","Female",17,19,23,20,21,100
"Mid Sussex 009F","E01032838","70-74 years","Female",19,18,21,28,27,113
"Mid Sussex 009F","E01032838","75-79 years","Female",5,7,7,6,9,34
"Mid Sussex 009F","E01032838","80-84 years","Female",8,10,12,14,9,53
"Mid Sussex 009F","E01032838","85+ years","Female",4,5,8,11,21,49
"Mid Sussex 009G","E01032839","0-4 years","Male",36,36,39,40,40,191
"Mid Sussex 009G","E01032839","5-9 years","Male",30,31,32,33,37,163
"Mid Sussex 009G","E01032839","10-14 years","Male",22,27,32,38,38,157
"Mid Sussex 009G","E01032839","15-19 years","Male",18,17,21,19,15,90
"Mid Sussex 009G","E01032839","20-24 years","Male",33,25,28,33,29,148
"Mid Sussex 009G","E01032839","25-29 years","Male",39,37,32,35,36,179
"Mid Sussex 009G","E01032839","30-34 years","Male",59,52,45,50,48,254
"Mid Sussex 009G","E01032839","35-39 years","Male",46,45,51,63,69,274
"Mid Sussex 009G","E01032839","40-44 years","Male",51,51,51,55,62,270
"Mid Sussex 009G","E01032839","45-49 years","Male",44,53,60,52,47,256
"Mid Sussex 009G","E01032839","50-54 years","Male",53,53,48,55,51,260
"Mid Sussex 009G","E01032839","55-59 years","Male",31,30,35,38,44,178
"Mid Sussex 009G","E01032839","60-64 years","Male",27,23,20,30,40,140
"Mid Sussex 009G","E01032839","65-69 years","Male",40,35,33,30,25,163
"Mid Sussex 009G","E01032839","70-74 years","Male",33,31,36,33,29,162
"Mid Sussex 009G","E01032839","75-79 years","Male",18,20,22,22,31,113
"Mid Sussex 009G","E01032839","80-84 years","Male",23,24,22,23,24,116
"Mid Sussex 009G","E01032839","85+ years","Male",9,13,16,14,15,67
"Mid Sussex 009G","E01032839","0-4 years","Female",38,36,43,43,38,198
"Mid Sussex 009G","E01032839","5-9 years","Female",28,32,32,32,34,158
"Mid Sussex 009G","E01032839","10-14 years","Female",24,22,21,23,26,116
"Mid Sussex 009G","E01032839","15-19 years","Female",11,10,11,13,11,56
"Mid Sussex 009G","E01032839","20-24 years","Female",19,11,16,19,15,80
"Mid Sussex 009G","E01032839","25-29 years","Female",49,50,53,55,60,267
"Mid Sussex 009G","E01032839","30-34 years","Female",64,56,61,59,64,304
"Mid Sussex 009G","E01032839","35-39 years","Female",35,41,44,42,47,209
"Mid Sussex 009G","E01032839","40-44 years","Female",48,44,43,50,47,232
"Mid Sussex 009G","E01032839","45-49 years","Female",43,49,54,49,46,241
"Mid Sussex 009G","E01032839","50-54 years","Female",34,37,32,38,44,185
"Mid Sussex 009G","E01032839","55-59 years","Female",36,34,33,39,38,180
"Mid Sussex 009G","E01032839","60-64 years","Female",25,30,30,28,41,154
"Mid Sussex 009G","E01032839","65-69 years","Female",48,33,33,30,28,172
"Mid Sussex 009G","E01032839","70-74 years","Female",21,28,25,26,32,132
"Mid Sussex 009G","E01032839","75-79 years","Female",19,19,25,26,21,110
"Mid Sussex 009G","E01032839","80-84 years","Female",17,15,13,10,10,65
"Mid Sussex 009G","E01032839","85+ years","Female",33,39,31,28,23,154
"Mid Sussex 010A","E01031752","0-4 years","Male",100,98,95,90,86,469
"Mid Sussex 010A","E01031752","5-9 years","Male",120,128,114,112,99,573
"Mid Sussex 010A","E01031752","10-14 years","Male",69,67,81,81,94,392
"Mid Sussex 010A","E01031752","15-19 years","Male",39,46,43,49,53,230
"Mid Sussex 010A","E01031752","20-24 years","Male",35,33,40,38,30,176
"Mid Sussex 010A","E01031752","25-29 years","Male",43,39,36,35,35,188
"Mid Sussex 010A","E01031752","30-34 years","Male",80,70,59,63,55,327
"Mid Sussex 010A","E01031752","35-39 years","Male",56,65,54,57,64,296
"Mid Sussex 010A","E01031752","40-44 years","Male",67,63,77,71,65,343
"Mid Sussex 010A","E01031752","45-49 years","Male",68,75,65,66,71,345
"Mid Sussex 010A","E01031752","50-54 years","Male",55,55,63,56,51,280
"Mid Sussex 010A","E01031752","55-59 years","Male",40,45,47,52,59,243
"Mid Sussex 010A","E01031752","60-64 years","Male",31,28,29,27,26,141
"Mid Sussex 010A","E01031752","65-69 years","Male",39,43,41,42,41,206
"Mid Sussex 010A","E01031752","70-74 years","Male",17,20,17,18,17,89
"Mid Sussex 010A","E01031752","75-79 years","Male",13,16,12,16,16,73
"Mid Sussex 010A","E01031752","80-84 years","Male",9,9,10,12,16,56
"Mid Sussex 010A","E01031752","85+ years","Male",10,11,15,9,5,50
"Mid Sussex 010A","E01031752","0-4 years","Female",103,92,76,80,77,428
"Mid Sussex 010A","E01031752","5-9 years","Female",92,94,103,105,93,487
"Mid Sussex 010A","E01031752","10-14 years","Female",76,72,78,78,76,380
"Mid Sussex 010A","E01031752","15-19 years","Female",46,49,54,54,57,260
"Mid Sussex 010A","E01031752","20-24 years","Female",44,40,41,34,40,199
"Mid Sussex 010A","E01031752","25-29 years","Female",101,95,80,73,63,412
"Mid Sussex 010A","E01031752","30-34 years","Female",104,93,98,102,104,501
"Mid Sussex 010A","E01031752","35-39 years","Female",95,92,88,96,90,461
"Mid Sussex 010A","E01031752","40-44 years","Female",71,73,85,87,96,412
"Mid Sussex 010A","E01031752","45-49 years","Female",65,67,65,64,67,328
"Mid Sussex 010A","E01031752","50-54 years","Female",54,55,55,58,52,274
"Mid Sussex 010A","E01031752","55-59 years","Female",52,55,54,54,52,267
"Mid Sussex 010A","E01031752","60-64 years","Female",31,37,36,37,42,183
"Mid Sussex 010A","E01031752","65-69 years","Female",39,33,35,39,39,185
"Mid Sussex 010A","E01031752","70-74 years","Female",28,35,35,32,31,161
"Mid Sussex 010A","E01031752","75-79 years","Female",20,15,14,19,23,91
"Mid Sussex 010A","E01031752","80-84 years","Female",9,14,15,14,16,68
"Mid Sussex 010A","E01031752","85+ years","Female",14,10,10,11,14,59
"Mid Sussex 010B","E01031753","0-4 years","Male",60,64,53,50,33,260
"Mid Sussex 010B","E01031753","5-9 years","Male",44,56,50,51,57,258
"Mid Sussex 010B","E01031753","10-14 years","Male",46,46,65,60,57,274
"Mid Sussex 010B","E01031753","15-19 years","Male",35,28,30,39,34,166
"Mid Sussex 010B","E01031753","20-24 years","Male",36,38,35,32,34,175
"Mid Sussex 010B","E01031753","25-29 years","Male",31,27,28,28,26,140
"Mid Sussex 010B","E01031753","30-34 years","Male",55,64,55,59,62,295
"Mid Sussex 010B","E01031753","35-39 years","Male",52,50,53,62,62,279
"Mid Sussex 010B","E01031753","40-44 years","Male",53,56,56,43,46,254
"Mid Sussex 010B","E01031753","45-49 years","Male",58,55,51,64,63,291
"Mid Sussex 010B","E01031753","50-54 years","Male",59,58,59,51,52,279
"Mid Sussex 010B","E01031753","55-59 years","Male",40,47,44,52,42,225
"Mid Sussex 010B","E01031753","60-64 years","Male",29,28,31,31,38,157
"Mid Sussex 010B","E01031753","65-69 years","Male",27,26,23,18,21,115
"Mid Sussex 010B","E01031753","70-74 years","Male",31,39,39,40,35,184
"Mid Sussex 010B","E01031753","75-79 years","Male",23,23,21,28,29,124
"Mid Sussex 010B","E01031753","80-84 years","Male",21,20,21,16,18,96
"Mid Sussex 010B","E01031753","85+ years","Male",24,21,16,23,27,111
"Mid Sussex 010B","E01031753","0-4 years","Female",41,46,42,36,33,198
"Mid Sussex 010B","E01031753","5-9 years","Female",59,65,58,71,68,321
"Mid Sussex 010B","E01031753","10-14 years","Female",45,39,44,55,57,240
"Mid Sussex 010B","E01031753","15-19 years","Female",33,31,35,31,36,166
"Mid Sussex 010B","E01031753","20-24 years","Female",21,27,30,28,27,133
"Mid Sussex 010B","E01031753","25-29 years","Female",52,47,37,45,38,219
"Mid Sussex 010B","E01031753","30-34 years","Female",40,39,38,51,47,215
"Mid Sussex 010B","E01031753","35-39 years","Female",48,54,57,50,57,266
"Mid Sussex 010B","E01031753","40-44 years","Female",62,70,52,59,56,299
"Mid Sussex 010B","E01031753","45-49 years","Female",44,41,48,46,47,226
"Mid Sussex 010B","E01031753","50-54 years","Female",52,50,53,55,56,266
"Mid Sussex 010B","E01031753","55-59 years","Female",47,54,48,52,55,256
"Mid Sussex 010B","E01031753","60-64 years","Female",34,34,36,32,35,171
"Mid Sussex 010B","E01031753","65-69 years","Female",38,39,38,30,25,170
"Mid Sussex 010B","E01031753","70-74 years","Female",32,32,30,38,37,169
"Mid Sussex 010B","E01031753","75-79 years","Female",34,34,29,30,35,162
"Mid Sussex 010B","E01031753","80-84 years","Female",28,30,37,29,30,154
"Mid Sussex 010B","E01031753","85+ years","Female",23,23,19,23,25,113
"Mid Sussex 010C","E01031754","0-4 years","Male",46,37,42,38,39,202
"Mid Sussex 010C","E01031754","5-9 years","Male",59,56,42,44,39,240
"Mid Sussex 010C","E01031754","10-14 years","Male",52,56,61,58,63,290
"Mid Sussex 010C","E01031754","15-19 years","Male",43,46,42,45,47,223
"Mid Sussex 010C","E01031754","20-24 years","Male",36,36,40,36,38,186
"Mid Sussex 010C","E01031754","25-29 years","Male",47,48,42,45,50,232
"Mid Sussex 010C","E01031754","30-34 years","Male",53,50,51,48,45,247
"Mid Sussex 010C","E01031754","35-39 years","Male",70,63,80,80,82,375
"Mid Sussex 010C","E01031754","40-44 years","Male",73,78,63,68,68,350
"Mid Sussex 010C","E01031754","45-49 years","Male",47,46,52,55,53,253
"Mid Sussex 010C","E01031754","50-54 years","Male",74,69,65,60,60,328
"Mid Sussex 010C","E01031754","55-59 years","Male",32,37,44,45,56,214
"Mid Sussex 010C","E01031754","60-64 years","Male",48,57,48,44,34,231
"Mid Sussex 010C","E01031754","65-69 years","Male",43,39,37,53,53,225
"Mid Sussex 010C","E01031754","70-74 years","Male",33,35,41,35,36,180
"Mid Sussex 010C","E01031754","75-79 years","Male",16,19,21,23,29,108
"Mid Sussex 010C","E01031754","80-84 years","Male",13,10,14,13,17,67
"Mid Sussex 010C","E01031754","85+ years","Male",13,11,11,9,7,51
"Mid Sussex 010C","E01031754","0-4 years","Female",38,38,36,37,37,186
"Mid Sussex 010C","E01031754","5-9 years","Female",62,56,59,50,41,268
"Mid Sussex 010C","E01031754","10-14 years","Female",43,45,45,53,62,248
"Mid Sussex 010C","E01031754","15-19 years","Female",43,35,31,34,37,180
"Mid Sussex 010C","E01031754","20-24 years","Female",34,29,28,22,23,136
"Mid Sussex 010C","E01031754","25-29 years","Female",56,54,58,64,62,294
"Mid Sussex 010C","E01031754","30-34 years","Female",56,58,57,62,68,301
"Mid Sussex 010C","E01031754","35-39 years","Female",69,64,68,65,61,327
"Mid Sussex 010C","E01031754","40-44 years","Female",61,58,60,54,61,294
"Mid Sussex 010C","E01031754","45-49 years","Female",66,69,55,62,63,315
"Mid Sussex 010C","E01031754","50-54 years","Female",68,67,67,65,61,328
"Mid Sussex 010C","E01031754","55-59 years","Female",48,47,50,57,60,262
"Mid Sussex 010C","E01031754","60-64 years","Female",46,55,61,53,52,267
"Mid Sussex 010C","E01031754","65-69 years","Female",51,52,50,56,54,263
"Mid Sussex 010C","E01031754","70-74 years","Female",37,42,45,45,52,221
"Mid Sussex 010C","E01031754","75-79 years","Female",15,18,23,28,27,111
"Mid Sussex 010C","E01031754","80-84 years","Female",26,22,17,16,17,98
"Mid Sussex 010C","E01031754","85+ years","Female",27,26,29,32,33,147
"Mid Sussex 010D","E01031755","0-4 years","Male",43,47,42,45,44,221
"Mid Sussex 010D","E01031755","5-9 years","Male",40,46,44,41,41,212
"Mid Sussex 010D","E01031755","10-14 years","Male",62,60,62,63,58,305
"Mid Sussex 010D","E01031755","15-19 years","Male",30,28,29,36,37,160
"Mid Sussex 010D","E01031755","20-24 years","Male",29,28,26,26,28,137
"Mid Sussex 010D","E01031755","25-29 years","Male",37,38,37,29,32,173
"Mid Sussex 010D","E01031755","30-34 years","Male",60,44,47,48,43,242
"Mid Sussex 010D","E01031755","35-39 years","Male",61,69,68,66,66,330
"Mid Sussex 010D","E01031755","40-44 years","Male",38,35,39,50,58,220
"Mid Sussex 010D","E01031755","45-49 years","Male",48,51,38,32,36,205
"Mid Sussex 010D","E01031755","50-54 years","Male",59,59,67,60,57,302
"Mid Sussex 010D","E01031755","55-59 years","Male",43,50,52,51,57,253
"Mid Sussex 010D","E01031755","60-64 years","Male",28,27,22,30,29,136
"Mid Sussex 010D","E01031755","65-69 years","Male",29,28,33,29,34,153
"Mid Sussex 010D","E01031755","70-74 years","Male",26,26,26,25,23,126
"Mid Sussex 010D","E01031755","75-79 years","Male",8,14,11,15,16,64
"Mid Sussex 010D","E01031755","80-84 years","Male",11,10,14,8,11,54
"Mid Sussex 010D","E01031755","85+ years","Male",6,4,4,8,7,29
"Mid Sussex 010D","E01031755","0-4 years","Female",45,38,43,48,47,221
"Mid Sussex 010D","E01031755","5-9 years","Female",50,52,46,49,53,250
"Mid Sussex 010D","E01031755","10-14 years","Female",32,33,40,45,46,196
"Mid Sussex 010D","E01031755","15-19 years","Female",36,39,41,36,38,190
"Mid Sussex 010D","E01031755","20-24 years","Female",38,33,33,31,27,162
"Mid Sussex 010D","E01031755","25-29 years","Female",30,26,33,30,38,157
"Mid Sussex 010D","E01031755","30-34 years","Female",49,46,40,41,32,208
"Mid Sussex 010D","E01031755","35-39 years","Female",58,56,51,53,57,275
"Mid Sussex 010D","E01031755","40-44 years","Female",56,52,52,58,62,280
"Mid Sussex 010D","E01031755","45-49 years","Female",47,47,42,44,47,227
"Mid Sussex 010D","E01031755","50-54 years","Female",54,54,56,51,50,265
"Mid Sussex 010D","E01031755","55-59 years","Female",41,41,43,41,40,206
"Mid Sussex 010D","E01031755","60-64 years","Female",39,37,38,44,47,205
"Mid Sussex 010D","E01031755","65-69 years","Female",35,34,30,27,22,148
"Mid Sussex 010D","E01031755","70-74 years","Female",28,34,40,40,38,180
"Mid Sussex 010D","E01031755","75-79 years","Female",12,13,15,21,24,85
"Mid Sussex 010D","E01031755","80-84 years","Female",26,25,26,20,21,118
"Mid Sussex 010D","E01031755","85+ years","Female",18,21,21,19,22,101
"Mid Sussex 010E","E01031757","0-4 years","Male",30,34,42,34,37,177
"Mid Sussex 010E","E01031757","5-9 years","Male",42,33,31,29,39,174
"Mid Sussex 010E","E01031757","10-14 years","Male",30,32,32,32,29,155
"Mid Sussex 010E","E01031757","15-19 years","Male",46,41,37,37,32,193
"Mid Sussex 010E","E01031757","20-24 years","Male",46,54,51,52,54,257
"Mid Sussex 010E","E01031757","25-29 years","Male",49,53,48,57,44,251
"Mid Sussex 010E","E01031757","30-34 years","Male",72,65,64,53,61,315
"Mid Sussex 010E","E01031757","35-39 years","Male",42,39,41,41,42,205
"Mid Sussex 010E","E01031757","40-44 years","Male",42,36,38,39,41,196
"Mid Sussex 010E","E01031757","45-49 years","Male",44,48,43,42,38,215
"Mid Sussex 010E","E01031757","50-54 years","Male",55,56,56,54,47,268
"Mid Sussex 010E","E01031757","55-59 years","Male",50,46,49,47,48,240
"Mid Sussex 010E","E01031757","60-64 years","Male",41,42,44,51,50,228
"Mid Sussex 010E","E01031757","65-69 years","Male",45,46,39,36,35,201
"Mid Sussex 010E","E01031757","70-74 years","Male",33,32,35,41,40,181
"Mid Sussex 010E","E01031757","75-79 years","Male",23,22,21,21,22,109
"Mid Sussex 010E","E01031757","80-84 years","Male",10,15,17,18,19,79
"Mid Sussex 010E","E01031757","85+ years","Male",10,8,9,8,7,42
"Mid Sussex 010E","E01031757","0-4 years","Female",50,48,46,48,47,239
"Mid Sussex 010E","E01031757","5-9 years","Female",54,49,46,41,50,240
"Mid Sussex 010E","E01031757","10-14 years","Female",47,46,45,44,37,219
"Mid Sussex 010E","E01031757","15-19 years","Female",33,42,32,34,34,175
"Mid Sussex 010E","E01031757","20-24 years","Female",35,30,33,27,28,153
"Mid Sussex 010E","E01031757","25-29 years","Female",51,52,48,49,43,243
"Mid Sussex 010E","E01031757","30-34 years","Female",44,37,30,36,42,189
"Mid Sussex 010E","E01031757","35-39 years","Female",69,76,80,74,64,363
"Mid Sussex 010E","E01031757","40-44 years","Female",55,45,48,53,61,262
"Mid Sussex 010E","E01031757","45-49 years","Female",55,55,59,58,52,279
"Mid Sussex 010E","E01031757","50-54 years","Female",51,53,48,49,56,257
"Mid Sussex 010E","E01031757","55-59 years","Female",62,61,60,62,58,303
"Mid Sussex 010E","E01031757","60-64 years","Female",37,44,40,49,49,219
"Mid Sussex 010E","E01031757","65-69 years","Female",54,46,49,39,43,231
"Mid Sussex 010E","E01031757","70-74 years","Female",24,27,28,32,37,148
"Mid Sussex 010E","E01031757","75-79 years","Female",32,34,33,23,20,142
"Mid Sussex 010E","E01031757","80-84 years","Female",20,26,23,31,21,121
"Mid Sussex 010E","E01031757","85+ years","Female",32,27,30,32,28,149
"Mid Sussex 011A","E01031726","0-4 years","Male",54,56,43,48,42,243
"Mid Sussex 011A","E01031726","5-9 years","Male",66,70,70,68,58,332
"Mid Sussex 011A","E01031726","10-14 years","Male",80,71,84,77,71,383
"Mid Sussex 011A","E01031726","15-19 years","Male",59,63,57,55,68,302
"Mid Sussex 011A","E01031726","20-24 years","Male",21,19,26,25,24,115
"Mid Sussex 011A","E01031726","25-29 years","Male",25,24,21,17,17,104
"Mid Sussex 011A","E01031726","30-34 years","Male",33,29,27,39,33,161
"Mid Sussex 011A","E01031726","35-39 years","Male",50,51,50,51,47,249
"Mid Sussex 011A","E01031726","40-44 years","Male",49,52,52,54,54,261
"Mid Sussex 011A","E01031726","45-49 years","Male",88,83,74,63,62,370
"Mid Sussex 011A","E01031726","50-54 years","Male",69,70,80,80,78,377
"Mid Sussex 011A","E01031726","55-59 years","Male",47,44,45,50,56,242
"Mid Sussex 011A","E01031726","60-64 years","Male",27,35,36,39,39,176
"Mid Sussex 011A","E01031726","65-69 years","Male",45,31,29,27,33,165
"Mid Sussex 011A","E01031726","70-74 years","Male",24,27,34,29,31,145
"Mid Sussex 011A","E01031726","75-79 years","Male",15,18,14,14,16,77
"Mid Sussex 011A","E01031726","80-84 years","Male",5,8,12,10,8,43
"Mid Sussex 011A","E01031726","85+ years","Male",12,4,8,8,11,43
"Mid Sussex 011A","E01031726","0-4 years","Female",66,66,48,43,51,274
"Mid Sussex 011A","E01031726","5-9 years","Female",59,63,72,80,79,353
"Mid Sussex 011A","E01031726","10-14 years","Female",73,79,76,83,78,389
"Mid Sussex 011A","E01031726","15-19 years","Female",40,44,53,48,54,239
"Mid Sussex 011A","E01031726","20-24 years","Female",30,30,34,36,33,163
"Mid Sussex 011A","E01031726","25-29 years","Female",40,44,34,27,25,170
"Mid Sussex 011A","E01031726","30-34 years","Female",46,45,60,83,77,311
"Mid Sussex 011A","E01031726","35-39 years","Female",50,55,59,56,59,279
"Mid Sussex 011A","E01031726","40-44 years","Female",83,76,58,61,62,340
"Mid Sussex 011A","E01031726","45-49 years","Female",85,92,101,96,80,454
"Mid Sussex 011A","E01031726","50-54 years","Female",65,70,75,73,88,371
"Mid Sussex 011A","E01031726","55-59 years","Female",49,55,55,57,60,276
"Mid Sussex 011A","E01031726","60-64 years","Female",36,31,35,38,39,179
"Mid Sussex 011A","E01031726","65-69 years","Female",42,48,39,41,45,215
"Mid Sussex 011A","E01031726","70-74 years","Female",35,31,34,33,29,162
"Mid Sussex 011A","E01031726","75-79 years","Female",34,32,35,33,35,169
"Mid Sussex 011A","E01031726","80-84 years","Female",12,11,12,16,16,67
"Mid Sussex 011A","E01031726","85+ years","Female",10,8,10,10,8,46
"Mid Sussex 011B","E01031728","0-4 years","Male",80,98,104,89,104,475
"Mid Sussex 011B","E01031728","5-9 years","Male",91,102,120,128,124,565
"Mid Sussex 011B","E01031728","10-14 years","Male",82,86,86,96,117,467
"Mid Sussex 011B","E01031728","15-19 years","Male",94,97,93,86,94,464
"Mid Sussex 011B","E01031728","20-24 years","Male",65,72,73,88,92,390
"Mid Sussex 011B","E01031728","25-29 years","Male",43,46,53,58,63,263
"Mid Sussex 011B","E01031728","30-34 years","Male",40,36,41,39,43,199
"Mid Sussex 011B","E01031728","35-39 years","Male",67,64,60,59,68,318
"Mid Sussex 011B","E01031728","40-44 years","Male",89,94,93,101,105,482
"Mid Sussex 011B","E01031728","45-49 years","Male",83,96,101,104,124,508
"Mid Sussex 011B","E01031728","50-54 years","Male",102,105,106,109,99,521
"Mid Sussex 011B","E01031728","55-59 years","Male",89,100,113,116,125,543
"Mid Sussex 011B","E01031728","60-64 years","Male",53,57,63,63,67,303
"Mid Sussex 011B","E01031728","65-69 years","Male",85,73,66,71,64,359
"Mid Sussex 011B","E01031728","70-74 years","Male",70,76,83,80,89,398
"Mid Sussex 011B","E01031728","75-79 years","Male",31,35,32,40,42,180
"Mid Sussex 011B","E01031728","80-84 years","Male",28,30,31,26,29,144
"Mid Sussex 011B","E01031728","85+ years","Male",41,35,36,32,31,175
"Mid Sussex 011B","E01031728","0-4 years","Female",78,77,82,70,87,394
"Mid Sussex 011B","E01031728","5-9 years","Female",64,77,78,75,89,383
"Mid Sussex 011B","E01031728","10-14 years","Female",102,120,106,116,114,558
"Mid Sussex 011B","E01031728","15-19 years","Female",63,55,69,68,88,343
"Mid Sussex 011B","E01031728","20-24 years","Female",45,46,50,53,64,258
"Mid Sussex 011B","E01031728","25-29 years","Female",37,47,34,46,60,224
"Mid Sussex 011B","E01031728","30-34 years","Female",70,80,76,70,77,373
"Mid Sussex 011B","E01031728","35-39 years","Female",73,80,95,95,108,451
"Mid Sussex 011B","E01031728","40-44 years","Female",107,108,93,105,114,527
"Mid Sussex 011B","E01031728","45-49 years","Female",99,106,110,99,106,520
"Mid Sussex 011B","E01031728","50-54 years","Female",96,105,117,123,117,558
"Mid Sussex 011B","E01031728","55-59 years","Female",58,69,72,80,92,371
"Mid Sussex 011B","E01031728","60-64 years","Female",65,61,61,62,64,313
"Mid Sussex 011B","E01031728","65-69 years","Female",99,84,89,92,85,449
"Mid Sussex 011B","E01031728","70-74 years","Female",78,92,89,83,84,426
"Mid Sussex 011B","E01031728","75-79 years","Female",49,51,57,54,61,272
"Mid Sussex 011B","E01031728","80-84 years","Female",46,42,40,41,38,207
"Mid Sussex 011B","E01031728","85+ years","Female",55,59,54,50,50,268
"Mid Sussex 011C","E01031749","0-4 years","Male",56,54,56,60,68,294
"Mid Sussex 011C","E01031749","5-9 years","Male",46,43,50,48,51,238
"Mid Sussex 011C","E01031749","10-14 years","Male",56,67,56,54,51,284
"Mid Sussex 011C","E01031749","15-19 years","Male",43,43,49,45,49,229
"Mid Sussex 011C","E01031749","20-24 years","Male",18,16,17,20,22,93
"Mid Sussex 011C","E01031749","25-29 years","Male",22,20,16,16,16,90
"Mid Sussex 011C","E01031749","30-34 years","Male",50,49,47,38,46,230
"Mid Sussex 011C","E01031749","35-39 years","Male",49,46,49,49,47,240
"Mid Sussex 011C","E01031749","40-44 years","Male",47,46,45,44,45,227
"Mid Sussex 011C","E01031749","45-49 years","Male",71,63,65,65,63,327
"Mid Sussex 011C","E01031749","50-54 years","Male",51,61,64,62,61,299
"Mid Sussex 011C","E01031749","55-59 years","Male",46,41,44,43,48,222
"Mid Sussex 011C","E01031749","60-64 years","Male",31,31,40,41,37,180
"Mid Sussex 011C","E01031749","65-69 years","Male",36,36,36,36,36,180
"Mid Sussex 011C","E01031749","70-74 years","Male",29,26,25,24,25,129
"Mid Sussex 011C","E01031749","75-79 years","Male",29,31,31,33,35,159
"Mid Sussex 011C","E01031749","80-84 years","Male",17,19,23,21,22,102
"Mid Sussex 011C","E01031749","85+ years","Male",14,13,12,18,18,75
"Mid Sussex 011C","E01031749","0-4 years","Female",55,46,34,40,46,221
"Mid Sussex 011C","E01031749","5-9 years","Female",45,48,40,44,39,216
"Mid Sussex 011C","E01031749","10-14 years","Female",38,36,38,37,39,188
"Mid Sussex 011C","E01031749","15-19 years","Female",34,35,36,36,39,180
"Mid Sussex 011C","E01031749","20-24 years","Female",25,28,29,29,32,143
"Mid Sussex 011C","E01031749","25-29 years","Female",35,31,25,29,32,152
"Mid Sussex 011C","E01031749","30-34 years","Female",55,46,45,38,49,233
"Mid Sussex 011C","E01031749","35-39 years","Female",66,69,68,64,69,336
"Mid Sussex 011C","E01031749","40-44 years","Female",66,66,66,71,75,344
"Mid Sussex 011C","E01031749","45-49 years","Female",65,68,65,62,60,320
"Mid Sussex 011C","E01031749","50-54 years","Female",57,62,64,63,59,305
"Mid Sussex 011C","E01031749","55-59 years","Female",51,57,59,51,57,275
"Mid Sussex 011C","E01031749","60-64 years","Female",43,38,38,41,43,203
"Mid Sussex 011C","E01031749","65-69 years","Female",52,49,55,56,52,264
"Mid Sussex 011C","E01031749","70-74 years","Female",52,48,43,41,39,223
"Mid Sussex 011C","E01031749","75-79 years","Female",20,29,30,32,40,151
"Mid Sussex 011C","E01031749","80-84 years","Female",23,15,13,16,13,80
"Mid Sussex 011C","E01031749","85+ years","Female",22,21,23,21,22,109
"Mid Sussex 011D","E01031750","0-4 years","Male",65,51,50,42,48,256
"Mid Sussex 011D","E01031750","5-9 years","Male",55,50,52,50,51,258
"Mid Sussex 011D","E01031750","10-14 years","Male",45,42,46,38,38,209
"Mid Sussex 011D","E01031750","15-19 years","Male",48,47,43,30,29,197
"Mid Sussex 011D","E01031750","20-24 years","Male",34,38,38,40,45,195
"Mid Sussex 011D","E01031750","25-29 years","Male",38,32,32,35,36,173
"Mid Sussex 011D","E01031750","30-34 years","Male",37,43,42,46,46,214
"Mid Sussex 011D","E01031750","35-39 years","Male",70,65,71,62,60,328
"Mid Sussex 011D","E01031750","40-44 years","Male",54,54,51,40,43,242
"Mid Sussex 011D","E01031750","45-49 years","Male",57,60,51,59,53,280
"Mid Sussex 011D","E01031750","50-54 years","Male",60,53,58,53,61,285
"Mid Sussex 011D","E01031750","55-59 years","Male",45,57,61,72,67,302
"Mid Sussex 011D","E01031750","60-64 years","Male",35,31,31,34,31,162
"Mid Sussex 011D","E01031750","65-69 years","Male",44,38,32,33,40,187
"Mid Sussex 011D","E01031750","70-74 years","Male",21,30,28,32,29,140
"Mid Sussex 011D","E01031750","75-79 years","Male",15,13,14,15,19,76
"Mid Sussex 011D","E01031750","80-84 years","Male",21,23,28,22,20,114
"Mid Sussex 011D","E01031750","85+ years","Male",11,9,9,12,17,58
"Mid Sussex 011D","E01031750","0-4 years","Female",50,49,45,37,41,222
"Mid Sussex 011D","E01031750","5-9 years","Female",42,39,39,44,43,207
"Mid Sussex 011D","E01031750","10-14 years","Female",43,42,46,52,50,233
"Mid Sussex 011D","E01031750","15-19 years","Female",37,39,39,38,33,186
"Mid Sussex 011D","E01031750","20-24 years","Female",46,51,47,40,39,223
"Mid Sussex 011D","E01031750","25-29 years","Female",37,34,40,41,33,185
"Mid Sussex 011D","E01031750","30-34 years","Female",50,46,56,62,69,283
"Mid Sussex 011D","E01031750","35-39 years","Female",63,58,58,49,43,271
"Mid Sussex 011D","E01031750","40-44 years","Female",65,65,62,61,60,313
"Mid Sussex 011D","E01031750","45-49 years","Female",66,68,66,61,57,318
"Mid Sussex 011D","E01031750","50-54 years","Female",46,49,50,54,61,260
"Mid Sussex 011D","E01031750","55-59 years","Female",43,46,46,44,39,218
"Mid Sussex 011D","E01031750","60-64 years","Female",41,39,36,42,46,204
"Mid Sussex 011D","E01031750","65-69 years","Female",33,34,33,33,27,160
"Mid Sussex 011D","E01031750","70-74 years","Female",32,28,28,30,33,151
"Mid Sussex 011D","E01031750","75-79 years","Female",30,31,31,29,29,150
"Mid Sussex 011D","E01031750","80-84 years","Female",22,22,24,27,25,120
"Mid Sussex 011D","E01031750","85+ years","Female",18,16,22,23,21,100
"Mid Sussex 011E","E01031756","0-4 years","Male",87,82,80,89,97,435
"Mid Sussex 011E","E01031756","5-9 years","Male",63,70,75,75,81,364
"Mid Sussex 011E","E01031756","10-14 years","Male",73,80,78,87,99,417
"Mid Sussex 011E","E01031756","15-19 years","Male",49,54,52,59,56,270
"Mid Sussex 011E","E01031756","20-24 years","Male",53,64,57,67,72,313
"Mid Sussex 011E","E01031756","25-29 years","Male",84,92,75,82,87,420
"Mid Sussex 011E","E01031756","30-34 years","Male",80,81,99,94,89,443
"Mid Sussex 011E","E01031756","35-39 years","Male",89,90,87,97,101,464
"Mid Sussex 011E","E01031756","40-44 years","Male",85,98,101,103,98,485
"Mid Sussex 011E","E01031756","45-49 years","Male",89,101,107,106,110,513
"Mid Sussex 011E","E01031756","50-54 years","Male",104,104,95,108,118,529
"Mid Sussex 011E","E01031756","55-59 years","Male",72,73,87,94,99,425
"Mid Sussex 011E","E01031756","60-64 years","Male",75,73,71,72,79,370
"Mid Sussex 011E","E01031756","65-69 years","Male",44,43,39,41,45,212
"Mid Sussex 011E","E01031756","70-74 years","Male",67,70,62,58,60,317
"Mid Sussex 011E","E01031756","75-79 years","Male",22,21,32,36,38,149
"Mid Sussex 011E","E01031756","80-84 years","Male",21,19,22,26,27,115
"Mid Sussex 011E","E01031756","85+ years","Male",22,19,18,22,25,106
"Mid Sussex 011E","E01031756","0-4 years","Female",76,88,94,100,98,456
"Mid Sussex 011E","E01031756","5-9 years","Female",101,107,122,110,108,548
"Mid Sussex 011E","E01031756","10-14 years","Female",54,61,60,71,79,325
"Mid Sussex 011E","E01031756","15-19 years","Female",67,75,72,73,78,365
"Mid Sussex 011E","E01031756","20-24 years","Female",56,61,61,59,60,297
"Mid Sussex 011E","E01031756","25-29 years","Female",94,110,104,94,86,488
"Mid Sussex 011E","E01031756","30-34 years","Female",85,86,99,96,103,469
"Mid Sussex 011E","E01031756","35-39 years","Female",82,91,94,95,102,464
"Mid Sussex 011E","E01031756","40-44 years","Female",88,90,79,97,92,446
"Mid Sussex 011E","E01031756","45-49 years","Female",107,121,124,118,125,595
"Mid Sussex 011E","E01031756","50-54 years","Female",79,96,92,106,97,470
"Mid Sussex 011E","E01031756","55-59 years","Female",83,82,85,84,98,432
"Mid Sussex 011E","E01031756","60-64 years","Female",60,66,69,71,78,344
"Mid Sussex 011E","E01031756","65-69 years","Female",65,55,53,53,47,273
"Mid Sussex 011E","E01031756","70-74 years","Female",56,63,59,63,72,313
"Mid Sussex 011E","E01031756","75-79 years","Female",32,36,45,44,38,195
"Mid Sussex 011E","E01031756","80-84 years","Female",23,20,18,22,24,107
"Mid Sussex 011E","E01031756","85+ years","Female",17,19,20,22,25,103
"Mid Sussex 011F","E01031763","0-4 years","Male",57,65,61,72,72,327
"Mid Sussex 011F","E01031763","5-9 years","Male",56,57,56,64,70,303
"Mid Sussex 011F","E01031763","10-14 years","Male",50,53,53,58,63,277
"Mid Sussex 011F","E01031763","15-19 years","Male",61,58,54,45,48,266
"Mid Sussex 011F","E01031763","20-24 years","Male",23,28,33,34,35,153
"Mid Sussex 011F","E01031763","25-29 years","Male",37,38,39,40,42,196
"Mid Sussex 011F","E01031763","30-34 years","Male",42,47,52,60,66,267
"Mid Sussex 011F","E01031763","35-39 years","Male",49,37,41,53,58,238
"Mid Sussex 011F","E01031763","40-44 years","Male",52,61,62,53,57,285
"Mid Sussex 011F","E01031763","45-49 years","Male",74,68,56,59,57,314
"Mid Sussex 011F","E01031763","50-54 years","Male",60,57,61,73,75,326
"Mid Sussex 011F","E01031763","55-59 years","Male",67,65,68,63,61,324
"Mid Sussex 011F","E01031763","60-64 years","Male",61,59,67,71,79,337
"Mid Sussex 011F","E01031763","65-69 years","Male",53,55,51,46,55,260
"Mid Sussex 011F","E01031763","70-74 years","Male",41,38,41,51,45,216
"Mid Sussex 011F","E01031763","75-79 years","Male",33,31,27,32,32,155
"Mid Sussex 011F","E01031763","80-84 years","Male",39,38,32,29,29,167
"Mid Sussex 011F","E01031763","85+ years","Male",21,17,19,26,24,107
"Mid Sussex 011F","E01031763","0-4 years","Female",37,53,46,59,62,257
"Mid Sussex 011F","E01031763","5-9 years","Female",58,53,50,56,58,275
"Mid Sussex 011F","E01031763","10-14 years","Female",47,47,49,57,58,258
"Mid Sussex 011F","E01031763","15-19 years","Female",47,39,40,37,35,198
"Mid Sussex 011F","E01031763","20-24 years","Female",28,35,33,37,35,168
"Mid Sussex 011F","E01031763","25-29 years","Female",44,42,39,33,37,195
"Mid Sussex 011F","E01031763","30-34 years","Female",37,39,37,46,61,220
"Mid Sussex 011F","E01031763","35-39 years","Female",53,57,59,68,68,305
"Mid Sussex 011F","E01031763","40-44 years","Female",68,67,66,65,75,341
"Mid Sussex 011F","E01031763","45-49 years","Female",70,73,68,67,69,347
"Mid Sussex 011F","E01031763","50-54 years","Female",63,62,60,66,66,317
"Mid Sussex 011F","E01031763","55-59 years","Female",60,59,68,76,72,335
"Mid Sussex 011F","E01031763","60-64 years","Female",59,50,47,45,57,258
"Mid Sussex 011F","E01031763","65-69 years","Female",69,72,65,55,47,308
"Mid Sussex 011F","E01031763","70-74 years","Female",50,49,61,61,60,281
"Mid Sussex 011F","E01031763","75-79 years","Female",38,44,44,50,47,223
"Mid Sussex 011F","E01031763","80-84 years","Female",37,36,38,36,31,178
"Mid Sussex 011F","E01031763","85+ years","Female",30,29,25,30,28,142
"Mid Sussex 012A","E01031699","0-4 years","Male",67,50,41,49,47,254
"Mid Sussex 012A","E01031699","5-9 years","Male",41,43,50,52,49,235
"Mid Sussex 012A","E01031699","10-14 years","Male",56,58,57,52,48,271
"Mid Sussex 012A","E01031699","15-19 years","Male",49,44,41,40,42,216
"Mid Sussex 012A","E01031699","20-24 years","Male",45,44,50,47,45,231
"Mid Sussex 012A","E01031699","25-29 years","Male",51,54,41,48,56,250
"Mid Sussex 012A","E01031699","30-34 years","Male",58,48,50,47,40,243
"Mid Sussex 012A","E01031699","35-39 years","Male",74,70,66,54,57,321
"Mid Sussex 012A","E01031699","40-44 years","Male",61,59,53,60,55,288
"Mid Sussex 012A","E01031699","45-49 years","Male",69,66,65,64,60,324
"Mid Sussex 012A","E01031699","50-54 years","Male",92,96,89,85,79,441
"Mid Sussex 012A","E01031699","55-59 years","Male",57,56,60,67,69,309
"Mid Sussex 012A","E01031699","60-64 years","Male",42,39,38,40,43,202
"Mid Sussex 012A","E01031699","65-69 years","Male",36,36,46,40,40,198
"Mid Sussex 012A","E01031699","70-74 years","Male",20,23,23,26,25,117
"Mid Sussex 012A","E01031699","75-79 years","Male",7,6,8,9,23,53
"Mid Sussex 012A","E01031699","80-84 years","Male",7,10,13,11,17,58
"Mid Sussex 012A","E01031699","85+ years","Male",5,3,3,1,3,15
"Mid Sussex 012A","E01031699","0-4 years","Female",47,43,44,48,47,229
"Mid Sussex 012A","E01031699","5-9 years","Female",54,57,56,49,40,256
"Mid Sussex 012A","E01031699","10-14 years","Female",44,44,51,53,53,245
"Mid Sussex 012A","E01031699","15-19 years","Female",48,40,35,29,28,180
"Mid Sussex 012A","E01031699","20-24 years","Female",34,33,30,32,36,165
"Mid Sussex 012A","E01031699","25-29 years","Female",61,49,54,59,60,283
"Mid Sussex 012A","E01031699","30-34 years","Female",71,71,69,70,60,341
"Mid Sussex 012A","E01031699","35-39 years","Female",49,49,56,51,57,262
"Mid Sussex 012A","E01031699","40-44 years","Female",64,63,50,42,35,254
"Mid Sussex 012A","E01031699","45-49 years","Female",84,79,81,84,75,403
"Mid Sussex 012A","E01031699","50-54 years","Female",88,96,98,94,93,469
"Mid Sussex 012A","E01031699","55-59 years","Female",63,52,54,61,64,294
"Mid Sussex 012A","E01031699","60-64 years","Female",47,60,63,64,74,308
"Mid Sussex 012A","E01031699","65-69 years","Female",42,42,43,48,50,225
"Mid Sussex 012A","E01031699","70-74 years","Female",27,34,42,38,41,182
"Mid Sussex 012A","E01031699","75-79 years","Female",7,9,11,13,14,54
"Mid Sussex 012A","E01031699","80-84 years","Female",11,12,7,5,6,41
"Mid Sussex 012A","E01031699","85+ years","Female",9,9,9,9,8,44
"Mid Sussex 012B","E01031700","0-4 years","Male",50,40,38,40,32,200
"Mid Sussex 012B","E01031700","5-9 years","Male",49,53,49,53,59,263
"Mid Sussex 012B","E01031700","10-14 years","Male",71,72,64,54,60,321
"Mid Sussex 012B","E01031700","15-19 years","Male",70,68,63,56,55,312
"Mid Sussex 012B","E01031700","20-24 years","Male",39,47,46,50,48,230
"Mid Sussex 012B","E01031700","25-29 years","Male",33,31,37,42,44,187
"Mid Sussex 012B","E01031700","30-34 years","Male",55,55,44,42,37,233
"Mid Sussex 012B","E01031700","35-39 years","Male",45,38,40,37,45,205
"Mid Sussex 012B","E01031700","40-44 years","Male",70,67,68,63,50,318
"Mid Sussex 012B","E01031700","45-49 years","Male",90,79,77,77,81,404
"Mid Sussex 012B","E01031700","50-54 years","Male",75,81,74,69,67,366
"Mid Sussex 012B","E01031700","55-59 years","Male",54,52,59,57,58,280
"Mid Sussex 012B","E01031700","60-64 years","Male",39,46,44,49,47,225
"Mid Sussex 012B","E01031700","65-69 years","Male",36,36,41,36,32,181
"Mid Sussex 012B","E01031700","70-74 years","Male",22,30,27,37,40,156
"Mid Sussex 012B","E01031700","75-79 years","Male",12,14,17,21,23,87
"Mid Sussex 012B","E01031700","80-84 years","Male",4,3,1,1,0,9
"Mid Sussex 012B","E01031700","85+ years","Male",12,8,8,9,7,44
"Mid Sussex 012B","E01031700","0-4 years","Female",44,40,45,37,46,212
"Mid Sussex 012B","E01031700","5-9 years","Female",71,61,49,47,41,269
"Mid Sussex 012B","E01031700","10-14 years","Female",52,50,54,55,59,270
"Mid Sussex 012B","E01031700","15-19 years","Female",75,69,62,64,63,333
"Mid Sussex 012B","E01031700","20-24 years","Female",38,38,44,47,43,210
"Mid Sussex 012B","E01031700","25-29 years","Female",55,52,54,62,59,282
"Mid Sussex 012B","E01031700","30-34 years","Female",47,42,41,35,45,210
"Mid Sussex 012B","E01031700","35-39 years","Female",57,63,59,52,43,274
"Mid Sussex 012B","E01031700","40-44 years","Female",81,68,61,70,74,354
"Mid Sussex 012B","E01031700","45-49 years","Female",112,106,105,98,87,508
"Mid Sussex 012B","E01031700","50-54 years","Female",87,98,92,90,90,457
"Mid Sussex 012B","E01031700","55-59 years","Female",60,65,75,85,87,372
"Mid Sussex 012B","E01031700","60-64 years","Female",31,31,34,38,42,176
"Mid Sussex 012B","E01031700","65-69 years","Female",35,33,28,26,24,146
"Mid Sussex 012B","E01031700","70-74 years","Female",27,33,36,34,34,164
"Mid Sussex 012B","E01031700","75-79 years","Female",8,7,12,16,22,65
"Mid Sussex 012B","E01031700","80-84 years","Female",11,13,7,14,15,60
"Mid Sussex 012B","E01031700","85+ years","Female",3,3,2,2,5,15
"Mid Sussex 012C","E01031701","0-4 years","Male",58,69,73,74,70,344
"Mid Sussex 012C","E01031701","5-9 years","Male",56,56,63,64,60,299
"Mid Sussex 012C","E01031701","10-14 years","Male",56,56,58,61,64,295
"Mid Sussex 012C","E01031701","15-19 years","Male",59,50,44,37,43,233
"Mid Sussex 012C","E01031701","20-24 years","Male",43,45,45,45,46,224
"Mid Sussex 012C","E01031701","25-29 years","Male",59,55,49,54,52,269
"Mid Sussex 012C","E01031701","30-34 years","Male",76,80,85,92,89,422
"Mid Sussex 012C","E01031701","35-39 years","Male",66,64,60,59,54,303
"Mid Sussex 012C","E01031701","40-44 years","Male",51,47,56,59,68,281
"Mid Sussex 012C","E01031701","45-49 years","Male",87,89,79,77,76,408
"Mid Sussex 012C","E01031701","50-54 years","Male",83,71,84,75,74,387
"Mid Sussex 012C","E01031701","55-59 years","Male",39,48,46,54,52,239
"Mid Sussex 012C","E01031701","60-64 years","Male",44,41,39,33,32,189
"Mid Sussex 012C","E01031701","65-69 years","Male",44,38,46,52,52,232
"Mid Sussex 012C","E01031701","70-74 years","Male",37,39,32,27,34,169
"Mid Sussex 012C","E01031701","75-79 years","Male",21,23,25,27,26,122
"Mid Sussex 012C","E01031701","80-84 years","Male",15,16,13,13,12,69
"Mid Sussex 012C","E01031701","85+ years","Male",7,7,8,7,8,37
"Mid Sussex 012C","E01031701","0-4 years","Female",45,53,59,54,56,267
"Mid Sussex 012C","E01031701","5-9 years","Female",69,61,55,61,65,311
"Mid Sussex 012C","E01031701","10-14 years","Female",75,79,84,78,82,398
"Mid Sussex 012C","E01031701","15-19 years","Female",55,55,57,59,58,284
"Mid Sussex 012C","E01031701","20-24 years","Female",19,23,21,24,33,120
"Mid Sussex 012C","E01031701","25-29 years","Female",74,70,70,59,52,325
"Mid Sussex 012C","E01031701","30-34 years","Female",53,56,63,73,74,319
"Mid Sussex 012C","E01031701","35-39 years","Female",65,70,77,82,77,371
"Mid Sussex 012C","E01031701","40-44 years","Female",64,70,63,55,60,312
"Mid Sussex 012C","E01031701","45-49 years","Female",92,93,85,84,80,434
"Mid Sussex 012C","E01031701","50-54 years","Female",68,67,78,77,79,369
"Mid Sussex 012C","E01031701","55-59 years","Female",63,57,59,61,65,305
"Mid Sussex 012C","E01031701","60-64 years","Female",46,47,53,52,52,250
"Mid Sussex 012C","E01031701","65-69 years","Female",43,39,37,44,50,213
"Mid Sussex 012C","E01031701","70-74 years","Female",38,45,40,42,37,202
"Mid Sussex 012C","E01031701","75-79 years","Female",26,18,24,28,34,130
"Mid Sussex 012C","E01031701","80-84 years","Female",15,18,22,18,14,87
"Mid Sussex 012C","E01031701","85+ years","Female",10,8,11,10,9,48
"Mid Sussex 012D","E01031714","0-4 years","Male",81,73,65,65,67,351
"Mid Sussex 012D","E01031714","5-9 years","Male",77,78,84,80,65,384
"Mid Sussex 012D","E01031714","10-14 years","Male",51,58,54,64,75,302
"Mid Sussex 012D","E01031714","15-19 years","Male",82,86,88,78,73,407
"Mid Sussex 012D","E01031714","20-24 years","Male",52,49,52,50,58,261
"Mid Sussex 012D","E01031714","25-29 years","Male",42,39,47,53,58,239
"Mid Sussex 012D","E01031714","30-34 years","Male",56,54,40,35,34,219
"Mid Sussex 012D","E01031714","35-39 years","Male",67,74,73,74,74,362
"Mid Sussex 012D","E01031714","40-44 years","Male",60,50,52,61,61,284
"Mid Sussex 012D","E01031714","45-49 years","Male",53,51,51,54,53,262
"Mid Sussex 012D","E01031714","50-54 years","Male",57,62,59,67,67,312
"Mid Sussex 012D","E01031714","55-59 years","Male",55,54,58,58,70,295
"Mid Sussex 012D","E01031714","60-64 years","Male",32,34,37,36,36,175
"Mid Sussex 012D","E01031714","65-69 years","Male",39,36,34,33,37,179
"Mid Sussex 012D","E01031714","70-74 years","Male",36,38,36,36,36,182
"Mid Sussex 012D","E01031714","75-79 years","Male",14,15,15,12,15,71
"Mid Sussex 012D","E01031714","80-84 years","Male",32,21,19,24,19,115
"Mid Sussex 012D","E01031714","85+ years","Male",13,25,27,28,31,124
"Mid Sussex 012D","E01031714","0-4 years","Female",53,53,58,55,56,275
"Mid Sussex 012D","E01031714","5-9 years","Female",79,71,75,77,73,375
"Mid Sussex 012D","E01031714","10-14 years","Female",53,56,50,53,61,273
"Mid Sussex 012D","E01031714","15-19 years","Female",38,44,48,49,38,217
"Mid Sussex 012D","E01031714","20-24 years","Female",50,41,45,42,44,222
"Mid Sussex 012D","E01031714","25-29 years","Female",48,51,45,49,46,239
"Mid Sussex 012D","E01031714","30-34 years","Female",84,68,64,68,74,358
"Mid Sussex 012D","E01031714","35-39 years","Female",81,93,95,88,88,445
"Mid Sussex 012D","E01031714","40-44 years","Female",53,47,52,48,52,252
"Mid Sussex 012D","E01031714","45-49 years","Female",79,81,74,78,75,387
"Mid Sussex 012D","E01031714","50-54 years","Female",55,50,63,61,67,296
"Mid Sussex 012D","E01031714","55-59 years","Female",58,66,56,60,58,298
"Mid Sussex 012D","E01031714","60-64 years","Female",46,44,47,47,46,230
"Mid Sussex 012D","E01031714","65-69 years","Female",45,36,37,36,39,193
"Mid Sussex 012D","E01031714","70-74 years","Female",31,37,36,37,39,180
"Mid Sussex 012D","E01031714","75-79 years","Female",28,29,33,40,43,173
"Mid Sussex 012D","E01031714","80-84 years","Female",38,33,37,34,32,174
"Mid Sussex 012D","E01031714","85+ years","Female",53,50,47,49,47,246
"Mid Sussex 013A","E01031704","0-4 years","Male",61,76,76,67,53,333
"Mid Sussex 013A","E01031704","5-9 years","Male",76,72,69,68,71,356
"Mid Sussex 013A","E01031704","10-14 years","Male",41,35,42,43,46,207
"Mid Sussex 013A","E01031704","15-19 years","Male",52,51,50,45,52,250
"Mid Sussex 013A","E01031704","20-24 years","Male",38,39,41,31,30,179
"Mid Sussex 013A","E01031704","25-29 years","Male",62,60,53,54,45,274
"Mid Sussex 013A","E01031704","30-34 years","Male",51,47,47,43,41,229
"Mid Sussex 013A","E01031704","35-39 years","Male",75,76,86,89,82,408
"Mid Sussex 013A","E01031704","40-44 years","Male",59,60,58,55,72,304
"Mid Sussex 013A","E01031704","45-49 years","Male",59,48,54,47,48,256
"Mid Sussex 013A","E01031704","50-54 years","Male",58,61,56,58,53,286
"Mid Sussex 013A","E01031704","55-59 years","Male",44,40,46,57,65,252
"Mid Sussex 013A","E01031704","60-64 years","Male",45,44,41,46,46,222
"Mid Sussex 013A","E01031704","65-69 years","Male",52,48,51,39,32,222
"Mid Sussex 013A","E01031704","70-74 years","Male",36,37,40,39,45,197
"Mid Sussex 013A","E01031704","75-79 years","Male",27,31,37,40,36,171
"Mid Sussex 013A","E01031704","80-84 years","Male",19,17,19,13,16,84
"Mid Sussex 013A","E01031704","85+ years","Male",15,22,24,33,30,124
"Mid Sussex 013A","E01031704","0-4 years","Female",55,50,62,58,56,281
"Mid Sussex 013A","E01031704","5-9 years","Female",61,60,59,52,51,283
"Mid Sussex 013A","E01031704","10-14 years","Female",37,29,31,31,38,166
"Mid Sussex 013A","E01031704","15-19 years","Female",40,44,42,39,30,195
"Mid Sussex 013A","E01031704","20-24 years","Female",33,33,30,21,28,145
"Mid Sussex 013A","E01031704","25-29 years","Female",64,57,57,59,54,291
"Mid Sussex 013A","E01031704","30-34 years","Female",58,59,68,57,62,304
"Mid Sussex 013A","E01031704","35-39 years","Female",86,88,86,83,84,427
"Mid Sussex 013A","E01031704","40-44 years","Female",62,55,61,58,53,289
"Mid Sussex 013A","E01031704","45-49 years","Female",63,58,54,51,45,271
"Mid Sussex 013A","E01031704","50-54 years","Female",64,63,66,67,70,330
"Mid Sussex 013A","E01031704","55-59 years","Female",57,59,55,54,51,276
"Mid Sussex 013A","E01031704","60-64 years","Female",43,48,54,50,48,243
"Mid Sussex 013A","E01031704","65-69 years","Female",53,56,52,53,58,272
"Mid Sussex 013A","E01031704","70-74 years","Female",57,61,55,52,52,277
"Mid Sussex 013A","E01031704","75-79 years","Female",35,33,36,42,42,188
"Mid Sussex 013A","E01031704","80-84 years","Female",29,32,38,38,45,182
"Mid Sussex 013A","E01031704","85+ years","Female",20,20,21,20,18,99
"Mid Sussex 013B","E01031706","0-4 years","Male",26,23,25,24,27,125
"Mid Sussex 013B","E01031706","5-9 years","Male",44,46,45,35,30,200
"Mid Sussex 013B","E01031706","10-14 years","Male",58,55,52,47,48,260
"Mid Sussex 013B","E01031706","15-19 years","Male",46,41,43,42,41,213
"Mid Sussex 013B","E01031706","20-24 years","Male",45,42,39,30,31,187
"Mid Sussex 013B","E01031706","25-29 years","Male",43,52,48,46,46,235
"Mid Sussex 013B","E01031706","30-34 years","Male",31,29,32,38,38,168
"Mid Sussex 013B","E01031706","35-39 years","Male",47,48,49,47,43,234
"Mid Sussex 013B","E01031706","40-44 years","Male",56,52,55,53,49,265
"Mid Sussex 013B","E01031706","45-49 years","Male",54,55,59,49,44,261
"Mid Sussex 013B","E01031706","50-54 years","Male",56,55,52,51,54,268
"Mid Sussex 013B","E01031706","55-59 years","Male",55,59,56,55,59,284
"Mid Sussex 013B","E01031706","60-64 years","Male",49,46,51,46,39,231
"Mid Sussex 013B","E01031706","65-69 years","Male",69,55,47,58,57,286
"Mid Sussex 013B","E01031706","70-74 years","Male",54,65,68,59,63,309
"Mid Sussex 013B","E01031706","75-79 years","Male",32,30,35,40,38,175
"Mid Sussex 013B","E01031706","80-84 years","Male",37,42,41,43,38,201
"Mid Sussex 013B","E01031706","85+ years","Male",18,20,25,29,33,125
"Mid Sussex 013B","E01031706","0-4 years","Female",34,36,44,39,41,194
"Mid Sussex 013B","E01031706","5-9 years","Female",42,43,45,45,37,212
"Mid Sussex 013B","E01031706","10-14 years","Female",54,58,48,46,44,250
"Mid Sussex 013B","E01031706","15-19 years","Female",50,47,42,41,43,223
"Mid Sussex 013B","E01031706","20-24 years","Female",37,41,47,46,47,218
"Mid Sussex 013B","E01031706","25-29 years","Female",30,27,26,27,32,142
"Mid Sussex 013B","E01031706","30-34 years","Female",32,29,35,33,32,161
"Mid Sussex 013B","E01031706","35-39 years","Female",54,64,54,47,47,266
"Mid Sussex 013B","E01031706","40-44 years","Female",62,50,46,42,48,248
"Mid Sussex 013B","E01031706","45-49 years","Female",60,71,73,69,57,330
"Mid Sussex 013B","E01031706","50-54 years","Female",74,64,74,67,62,341
"Mid Sussex 013B","E01031706","55-59 years","Female",58,69,61,61,66,315
"Mid Sussex 013B","E01031706","60-64 years","Female",61,53,55,53,54,276
"Mid Sussex 013B","E01031706","65-69 years","Female",61,53,54,58,62,288
"Mid Sussex 013B","E01031706","70-74 years","Female",52,68,63,64,64,311
"Mid Sussex 013B","E01031706","75-79 years","Female",34,33,40,43,41,191
"Mid Sussex 013B","E01031706","80-84 years","Female",31,32,32,27,27,149
"Mid Sussex 013B","E01031706","85+ years","Female",32,24,24,25,24,129
"Mid Sussex 013C","E01031711","0-4 years","Male",49,67,84,104,121,425
"Mid Sussex 013C","E01031711","5-9 years","Male",48,59,81,99,104,391
"Mid Sussex 013C","E01031711","10-14 years","Male",60,61,58,78,93,350
"Mid Sussex 013C","E01031711","15-19 years","Male",58,61,64,66,70,319
"Mid Sussex 013C","E01031711","20-24 years","Male",51,58,69,70,70,318
"Mid Sussex 013C","E01031711","25-29 years","Male",41,47,53,73,74,288
"Mid Sussex 013C","E01031711","30-34 years","Male",59,58,69,82,92,360
"Mid Sussex 013C","E01031711","35-39 years","Male",59,86,97,115,135,492
"Mid Sussex 013C","E01031711","40-44 years","Male",53,45,53,72,91,314
"Mid Sussex 013C","E01031711","45-49 years","Male",65,74,72,82,80,373
"Mid Sussex 013C","E01031711","50-54 years","Male",83,77,86,87,88,421
"Mid Sussex 013C","E01031711","55-59 years","Male",32,38,49,56,66,241
"Mid Sussex 013C","E01031711","60-64 years","Male",57,52,51,53,47,260
"Mid Sussex 013C","E01031711","65-69 years","Male",39,34,33,34,41,181
"Mid Sussex 013C","E01031711","70-74 years","Male",38,51,53,56,43,241
"Mid Sussex 013C","E01031711","75-79 years","Male",25,18,25,26,36,130
"Mid Sussex 013C","E01031711","80-84 years","Male",10,17,20,21,22,90
"Mid Sussex 013C","E01031711","85+ years","Male",25,21,19,18,22,105
"Mid Sussex 013C","E01031711","0-4 years","Female",56,67,79,113,143,458
"Mid Sussex 013C","E01031711","5-9 years","Female",54,60,67,85,90,356
"Mid Sussex 013C","E01031711","10-14 years","Female",45,52,62,75,94,328
"Mid Sussex 013C","E01031711","15-19 years","Female",38,35,48,53,59,233
"Mid Sussex 013C","E01031711","20-24 years","Female",40,40,48,50,46,224
"Mid Sussex 013C","E01031711","25-29 years","Female",50,63,75,93,108,389
"Mid Sussex 013C","E01031711","30-34 years","Female",60,79,84,135,153,511
"Mid Sussex 013C","E01031711","35-39 years","Female",55,61,86,102,121,425
"Mid Sussex 013C","E01031711","40-44 years","Female",83,96,89,114,117,499
"Mid Sussex 013C","E01031711","45-49 years","Female",81,75,84,89,97,426
"Mid Sussex 013C","E01031711","50-54 years","Female",72,79,79,83,96,409
"Mid Sussex 013C","E01031711","55-59 years","Female",61,60,65,71,73,330
"Mid Sussex 013C","E01031711","60-64 years","Female",50,60,58,63,66,297
"Mid Sussex 013C","E01031711","65-69 years","Female",47,43,44,41,50,225
"Mid Sussex 013C","E01031711","70-74 years","Female",37,41,41,48,46,213
"Mid Sussex 013C","E01031711","75-79 years","Female",31,31,32,29,30,153
"Mid Sussex 013C","E01031711","80-84 years","Female",27,28,28,34,30,147
"Mid Sussex 013C","E01031711","85+ years","Female",30,28,27,26,33,144
"Mid Sussex 013D","E01031712","0-4 years","Male",62,65,64,59,62,312
"Mid Sussex 013D","E01031712","5-9 years","Male",35,45,39,40,34,193
"Mid Sussex 013D","E01031712","10-14 years","Male",40,40,47,49,55,231
"Mid Sussex 013D","E01031712","15-19 years","Male",36,33,36,37,41,183
"Mid Sussex 013D","E01031712","20-24 years","Male",43,41,43,33,29,189
"Mid Sussex 013D","E01031712","25-29 years","Male",35,38,40,43,46,202
"Mid Sussex 013D","E01031712","30-34 years","Male",53,52,55,50,48,258
"Mid Sussex 013D","E01031712","35-39 years","Male",47,63,66,63,62,301
"Mid Sussex 013D","E01031712","40-44 years","Male",38,31,37,40,42,188
"Mid Sussex 013D","E01031712","45-49 years","Male",57,60,54,55,48,274
"Mid Sussex 013D","E01031712","50-54 years","Male",41,36,41,38,37,193
"Mid Sussex 013D","E01031712","55-59 years","Male",44,42,46,47,49,228
"Mid Sussex 013D","E01031712","60-64 years","Male",43,36,31,36,43,189
"Mid Sussex 013D","E01031712","65-69 years","Male",43,37,36,41,41,198
"Mid Sussex 013D","E01031712","70-74 years","Male",17,25,28,30,30,130
"Mid Sussex 013D","E01031712","75-79 years","Male",12,9,12,11,14,58
"Mid Sussex 013D","E01031712","80-84 years","Male",13,16,11,14,14,68
"Mid Sussex 013D","E01031712","85+ years","Male",11,13,13,15,14,66
"Mid Sussex 013D","E01031712","0-4 years","Female",54,59,54,64,56,287
"Mid Sussex 013D","E01031712","5-9 years","Female",46,50,48,46,54,244
"Mid Sussex 013D","E01031712","10-14 years","Female",37,25,26,26,33,147
"Mid Sussex 013D","E01031712","15-19 years","Female",37,38,38,36,33,182
"Mid Sussex 013D","E01031712","20-24 years","Female",41,43,41,33,31,189
"Mid Sussex 013D","E01031712","25-29 years","Female",54,58,58,57,56,283
"Mid Sussex 013D","E01031712","30-34 years","Female",60,60,54,49,51,274
"Mid Sussex 013D","E01031712","35-39 years","Female",53,53,62,65,77,310
"Mid Sussex 013D","E01031712","40-44 years","Female",42,37,43,49,50,221
"Mid Sussex 013D","E01031712","45-49 years","Female",83,72,64,53,50,322
"Mid Sussex 013D","E01031712","50-54 years","Female",39,49,60,58,54,260
"Mid Sussex 013D","E01031712","55-59 years","Female",37,35,38,39,39,188
"Mid Sussex 013D","E01031712","60-64 years","Female",42,47,42,47,53,231
"Mid Sussex 013D","E01031712","65-69 years","Female",48,31,34,37,31,181
"Mid Sussex 013D","E01031712","70-74 years","Female",37,47,45,44,46,219
"Mid Sussex 013D","E01031712","75-79 years","Female",20,17,16,18,18,89
"Mid Sussex 013D","E01031712","80-84 years","Female",23,20,20,17,18,98
"Mid Sussex 013D","E01031712","85+ years","Female",22,26,22,26,30,126
"Mid Sussex 013E","E01031713","0-4 years","Male",56,53,53,57,45,264
"Mid Sussex 013E","E01031713","5-9 years","Male",48,47,53,58,53,259
"Mid Sussex 013E","E01031713","10-14 years","Male",46,52,49,49,57,253
"Mid Sussex 013E","E01031713","15-19 years","Male",61,56,56,50,62,285
"Mid Sussex 013E","E01031713","20-24 years","Male",23,23,27,28,31,132
"Mid Sussex 013E","E01031713","25-29 years","Male",60,53,46,49,51,259
"Mid Sussex 013E","E01031713","30-34 years","Male",39,50,52,51,49,241
"Mid Sussex 013E","E01031713","35-39 years","Male",42,41,37,36,37,193
"Mid Sussex 013E","E01031713","40-44 years","Male",59,44,46,45,40,234
"Mid Sussex 013E","E01031713","45-49 years","Male",59,62,58,54,48,281
"Mid Sussex 013E","E01031713","50-54 years","Male",64,67,71,77,81,360
"Mid Sussex 013E","E01031713","55-59 years","Male",64,59,53,55,52,283
"Mid Sussex 013E","E01031713","60-64 years","Male",50,51,56,56,61,274
"Mid Sussex 013E","E01031713","65-69 years","Male",51,50,48,51,49,249
"Mid Sussex 013E","E01031713","70-74 years","Male",44,44,51,58,55,252
"Mid Sussex 013E","E01031713","75-79 years","Male",39,41,40,34,32,186
"Mid Sussex 013E","E01031713","80-84 years","Male",19,22,25,26,33,125
"Mid Sussex 013E","E01031713","85+ years","Male",12,13,14,22,21,82
"Mid Sussex 013E","E01031713","0-4 years","Female",39,38,27,32,32,168
"Mid Sussex 013E","E01031713","5-9 years","Female",60,61,57,58,53,289
"Mid Sussex 013E","E01031713","10-14 years","Female",47,57,62,62,62,290
"Mid Sussex 013E","E01031713","15-19 years","Female",44,39,38,42,47,210
"Mid Sussex 013E","E01031713","20-24 years","Female",27,32,32,31,29,151
"Mid Sussex 013E","E01031713","25-29 years","Female",23,23,21,19,15,101
"Mid Sussex 013E","E01031713","30-34 years","Female",52,44,49,48,52,245
"Mid Sussex 013E","E01031713","35-39 years","Female",41,39,39,40,41,200
"Mid Sussex 013E","E01031713","40-44 years","Female",64,66,61,56,53,300
"Mid Sussex 013E","E01031713","45-49 years","Female",67,71,72,69,75,354
"Mid Sussex 013E","E01031713","50-54 years","Female",72,78,80,84,80,394
"Mid Sussex 013E","E01031713","55-59 years","Female",51,44,48,55,63,261
"Mid Sussex 013E","E01031713","60-64 years","Female",44,50,54,49,48,245
"Mid Sussex 013E","E01031713","65-69 years","Female",59,51,44,40,40,234
"Mid Sussex 013E","E01031713","70-74 years","Female",55,59,63,73,72,322
"Mid Sussex 013E","E01031713","75-79 years","Female",55,61,60,47,41,264
"Mid Sussex 013E","E01031713","80-84 years","Female",19,21,32,39,41,152
"Mid Sussex 013E","E01031713","85+ years","Female",15,16,13,12,13,69
"Mid Sussex 014A","E01031705","0-4 years","Male",41,43,43,44,42,213
"Mid Sussex 014A","E01031705","5-9 years","Male",57,57,49,37,38,238
"Mid Sussex 014A","E01031705","10-14 years","Male",52,45,54,53,59,263
"Mid Sussex 014A","E01031705","15-19 years","Male",38,45,43,41,38,205
"Mid Sussex 014A","E01031705","20-24 years","Male",40,35,38,34,30,177
"Mid Sussex 014A","E01031705","25-29 years","Male",51,50,58,60,55,274
"Mid Sussex 014A","E01031705","30-34 years","Male",50,53,54,54,49,260
"Mid Sussex 014A","E01031705","35-39 years","Male",60,49,48,50,51,258
"Mid Sussex 014A","E01031705","40-44 years","Male",54,59,57,58,53,281
"Mid Sussex 014A","E01031705","45-49 years","Male",54,52,50,51,59,266
"Mid Sussex 014A","E01031705","50-54 years","Male",57,57,56,52,39,261
"Mid Sussex 014A","E01031705","55-59 years","Male",50,51,56,45,45,247
"Mid Sussex 014A","E01031705","60-64 years","Male",41,40,43,48,45,217
"Mid Sussex 014A","E01031705","65-69 years","Male",31,29,23,30,36,149
"Mid Sussex 014A","E01031705","70-74 years","Male",25,27,29,30,29,140
"Mid Sussex 014A","E01031705","75-79 years","Male",17,16,20,17,20,90
"Mid Sussex 014A","E01031705","80-84 years","Male",10,9,14,18,15,66
"Mid Sussex 014A","E01031705","85+ years","Male",9,15,11,9,9,53
"Mid Sussex 014A","E01031705","0-4 years","Female",59,63,59,56,56,293
"Mid Sussex 014A","E01031705","5-9 years","Female",51,47,41,43,40,222
"Mid Sussex 014A","E01031705","10-14 years","Female",44,46,48,51,53,242
"Mid Sussex 014A","E01031705","15-19 years","Female",46,52,52,56,56,262
"Mid Sussex 014A","E01031705","20-24 years","Female",44,34,31,31,30,170
"Mid Sussex 014A","E01031705","25-29 years","Female",55,62,62,68,56,303
"Mid Sussex 014A","E01031705","30-34 years","Female",56,61,59,52,56,284
"Mid Sussex 014A","E01031705","35-39 years","Female",67,61,62,59,59,308
"Mid Sussex 014A","E01031705","40-44 years","Female",56,59,61,56,57,289
"Mid Sussex 014A","E01031705","45-49 years","Female",75,59,57,70,65,326
"Mid Sussex 014A","E01031705","50-54 years","Female",43,41,40,39,40,203
"Mid Sussex 014A","E01031705","55-59 years","Female",58,62,64,62,55,301
"Mid Sussex 014A","E01031705","60-64 years","Female",52,55,50,53,64,274
"Mid Sussex 014A","E01031705","65-69 years","Female",43,39,41,39,39,201
"Mid Sussex 014A","E01031705","70-74 years","Female",31,31,37,38,38,175
"Mid Sussex 014A","E01031705","75-79 years","Female",10,12,14,14,14,64
"Mid Sussex 014A","E01031705","80-84 years","Female",8,9,10,18,16,61
"Mid Sussex 014A","E01031705","85+ years","Female",15,18,16,19,15,83
"Mid Sussex 014B","E01031707","0-4 years","Male",31,32,36,30,36,165
"Mid Sussex 014B","E01031707","5-9 years","Male",32,29,31,34,30,156
"Mid Sussex 014B","E01031707","10-14 years","Male",39,38,28,33,30,168
"Mid Sussex 014B","E01031707","15-19 years","Male",48,41,42,32,30,193
"Mid Sussex 014B","E01031707","20-24 years","Male",31,39,34,36,42,182
"Mid Sussex 014B","E01031707","25-29 years","Male",41,42,41,31,28,183
"Mid Sussex 014B","E01031707","30-34 years","Male",33,29,31,29,30,152
"Mid Sussex 014B","E01031707","35-39 years","Male",36,53,45,43,39,216
"Mid Sussex 014B","E01031707","40-44 years","Male",43,36,43,41,40,203
"Mid Sussex 014B","E01031707","45-49 years","Male",69,69,52,60,63,313
"Mid Sussex 014B","E01031707","50-54 years","Male",45,52,52,48,47,244
"Mid Sussex 014B","E01031707","55-59 years","Male",53,57,58,55,48,271
"Mid Sussex 014B","E01031707","60-64 years","Male",60,59,58,48,53,278
"Mid Sussex 014B","E01031707","65-69 years","Male",61,52,61,60,54,288
"Mid Sussex 014B","E01031707","70-74 years","Male",42,50,48,47,45,232
"Mid Sussex 014B","E01031707","75-79 years","Male",40,43,46,43,45,217
"Mid Sussex 014B","E01031707","80-84 years","Male",21,19,21,22,22,105
"Mid Sussex 014B","E01031707","85+ years","Male",22,28,28,25,23,126
"Mid Sussex 014B","E01031707","0-4 years","Female",36,34,39,34,32,175
"Mid Sussex 014B","E01031707","5-9 years","Female",36,44,39,45,41,205
"Mid Sussex 014B","E01031707","10-14 years","Female",33,32,32,27,28,152
"Mid Sussex 014B","E01031707","15-19 years","Female",27,23,21,22,20,113
"Mid Sussex 014B","E01031707","20-24 years","Female",27,30,27,22,25,131
"Mid Sussex 014B","E01031707","25-29 years","Female",29,33,36,37,30,165
"Mid Sussex 014B","E01031707","30-34 years","Female",47,44,40,43,45,219
"Mid Sussex 014B","E01031707","35-39 years","Female",44,45,50,44,44,227
"Mid Sussex 014B","E01031707","40-44 years","Female",46,46,43,47,53,235
"Mid Sussex 014B","E01031707","45-49 years","Female",77,74,73,63,54,341
"Mid Sussex 014B","E01031707","50-54 years","Female",53,53,47,49,54,256
"Mid Sussex 014B","E01031707","55-59 years","Female",61,53,65,63,57,299
"Mid Sussex 014B","E01031707","60-64 years","Female",40,53,53,56,63,265
"Mid Sussex 014B","E01031707","65-69 years","Female",81,72,64,55,48,320
"Mid Sussex 014B","E01031707","70-74 years","Female",57,64,68,71,67,327
"Mid Sussex 014B","E01031707","75-79 years","Female",44,40,52,45,48,229
"Mid Sussex 014B","E01031707","80-84 years","Female",39,41,38,40,43,201
"Mid Sussex 014B","E01031707","85+ years","Female",39,36,37,38,40,190
"Mid Sussex 014C","E01031708","0-4 years","Male",49,45,49,53,56,252
"Mid Sussex 014C","E01031708","5-9 years","Male",59,53,58,52,57,279
"Mid Sussex 014C","E01031708","10-14 years","Male",41,44,38,48,58,229
"Mid Sussex 014C","E01031708","15-19 years","Male",52,51,52,54,45,254
"Mid Sussex 014C","E01031708","20-24 years","Male",43,42,45,41,34,205
"Mid Sussex 014C","E01031708","25-29 years","Male",94,95,82,75,64,410
"Mid Sussex 014C","E01031708","30-34 years","Male",99,120,136,129,116,600
"Mid Sussex 014C","E01031708","35-39 years","Male",76,73,78,96,118,441
"Mid Sussex 014C","E01031708","40-44 years","Male",57,56,60,54,63,290
"Mid Sussex 014C","E01031708","45-49 years","Male",61,69,71,71,69,341
"Mid Sussex 014C","E01031708","50-54 years","Male",85,78,76,84,84,407
"Mid Sussex 014C","E01031708","55-59 years","Male",40,44,42,43,48,217
"Mid Sussex 014C","E01031708","60-64 years","Male",33,37,49,43,39,201
"Mid Sussex 014C","E01031708","65-69 years","Male",30,30,25,26,30,141
"Mid Sussex 014C","E01031708","70-74 years","Male",31,33,36,37,38,175
"Mid Sussex 014C","E01031708","75-79 years","Male",13,13,13,21,27,87
"Mid Sussex 014C","E01031708","80-84 years","Male",19,26,22,23,19,109
"Mid Sussex 014C","E01031708","85+ years","Male",10,13,12,8,9,52
"Mid Sussex 014C","E01031708","0-4 years","Female",48,57,70,67,58,300
"Mid Sussex 014C","E01031708","5-9 years","Female",35,46,48,54,64,247
"Mid Sussex 014C","E01031708","10-14 years","Female",32,35,43,40,37,187
"Mid Sussex 014C","E01031708","15-19 years","Female",32,25,26,19,23,125
"Mid Sussex 014C","E01031708","20-24 years","Female",69,64,69,51,44,297
"Mid Sussex 014C","E01031708","25-29 years","Female",64,83,76,83,73,379
"Mid Sussex 014C","E01031708","30-34 years","Female",81,79,94,102,112,468
"Mid Sussex 014C","E01031708","35-39 years","Female",71,82,77,66,77,373
"Mid Sussex 014C","E01031708","40-44 years","Female",68,71,79,78,74,370
"Mid Sussex 014C","E01031708","45-49 years","Female",50,39,37,44,50,220
"Mid Sussex 014C","E01031708","50-54 years","Female",49,49,54,55,57,264
"Mid Sussex 014C","E01031708","55-59 years","Female",41,50,50,48,43,232
"Mid Sussex 014C","E01031708","60-64 years","Female",36,36,35,31,40,178
"Mid Sussex 014C","E01031708","65-69 years","Female",42,47,39,41,36,205
"Mid Sussex 014C","E01031708","70-74 years","Female",41,42,44,43,38,208
"Mid Sussex 014C","E01031708","75-79 years","Female",27,25,25,28,32,137
"Mid Sussex 014C","E01031708","80-84 years","Female",23,23,22,22,23,113
"Mid Sussex 014C","E01031708","85+ years","Female",49,51,49,42,40,231
"Mid Sussex 014D","E01031709","0-4 years","Male",32,33,40,41,40,186
"Mid Sussex 014D","E01031709","5-9 years","Male",41,40,39,41,40,201
"Mid Sussex 014D","E01031709","10-14 years","Male",45,43,37,42,40,207
"Mid Sussex 014D","E01031709","15-19 years","Male",38,29,30,29,32,158
"Mid Sussex 014D","E01031709","20-24 years","Male",41,46,40,39,42,208
"Mid Sussex 014D","E01031709","25-29 years","Male",41,39,44,52,53,229
"Mid Sussex 014D","E01031709","30-34 years","Male",57,71,70,64,58,320
"Mid Sussex 014D","E01031709","35-39 years","Male",44,45,55,60,70,274
"Mid Sussex 014D","E01031709","40-44 years","Male",64,61,57,54,54,290
"Mid Sussex 014D","E01031709","45-49 years","Male",66,62,65,68,62,323
"Mid Sussex 014D","E01031709","50-54 years","Male",56,55,57,56,71,295
"Mid Sussex 014D","E01031709","55-59 years","Male",60,57,57,57,48,279
"Mid Sussex 014D","E01031709","60-64 years","Male",48,48,44,47,52,239
"Mid Sussex 014D","E01031709","65-69 years","Male",44,45,50,42,43,224
"Mid Sussex 014D","E01031709","70-74 years","Male",41,37,40,43,48,209
"Mid Sussex 014D","E01031709","75-79 years","Male",20,25,25,31,28,129
"Mid Sussex 014D","E01031709","80-84 years","Male",27,29,37,32,40,165
"Mid Sussex 014D","E01031709","85+ years","Male",28,29,26,25,22,130
"Mid Sussex 014D","E01031709","0-4 years","Female",37,31,34,39,49,190
"Mid Sussex 014D","E01031709","5-9 years","Female",62,59,50,48,45,264
"Mid Sussex 014D","E01031709","10-14 years","Female",34,38,47,51,52,222
"Mid Sussex 014D","E01031709","15-19 years","Female",33,31,33,25,24,146
"Mid Sussex 014D","E01031709","20-24 years","Female",50,50,50,50,50,250
"Mid Sussex 014D","E01031709","25-29 years","Female",45,58,55,58,53,269
"Mid Sussex 014D","E01031709","30-34 years","Female",39,30,37,46,49,201
"Mid Sussex 014D","E01031709","35-39 years","Female",53,54,46,44,47,244
"Mid Sussex 014D","E01031709","40-44 years","Female",66,58,57,48,53,282
"Mid Sussex 014D","E01031709","45-49 years","Female",55,49,46,46,50,246
"Mid Sussex 014D","E01031709","50-54 years","Female",62,68,69,66,73,338
"Mid Sussex 014D","E01031709","55-59 years","Female",54,52,64,60,58,288
"Mid Sussex 014D","E01031709","60-64 years","Female",45,52,51,50,53,251
"Mid Sussex 014D","E01031709","65-69 years","Female",57,51,50,49,43,250
"Mid Sussex 014D","E01031709","70-74 years","Female",47,54,56,56,52,265
"Mid Sussex 014D","E01031709","75-79 years","Female",45,44,47,49,53,238
"Mid Sussex 014D","E01031709","80-84 years","Female",47,45,39,42,44,217
"Mid Sussex 014D","E01031709","85+ years","Female",78,74,77,69,65,363
"Mid Sussex 014E","E01031716","0-4 years","Male",43,38,35,34,35,185
"Mid Sussex 014E","E01031716","5-9 years","Male",58,52,51,45,41,247
"Mid Sussex 014E","E01031716","10-14 years","Male",60,58,62,63,56,299
"Mid Sussex 014E","E01031716","15-19 years","Male",24,27,28,25,29,133
"Mid Sussex 014E","E01031716","20-24 years","Male",33,28,24,28,29,142
"Mid Sussex 014E","E01031716","25-29 years","Male",37,41,44,44,43,209
"Mid Sussex 014E","E01031716","30-34 years","Male",40,34,35,31,28,168
"Mid Sussex 014E","E01031716","35-39 years","Male",38,38,46,42,44,208
"Mid Sussex 014E","E01031716","40-44 years","Male",46,51,37,41,41,216
"Mid Sussex 014E","E01031716","45-49 years","Male",41,39,43,38,38,199
"Mid Sussex 014E","E01031716","50-54 years","Male",37,42,43,43,36,201
"Mid Sussex 014E","E01031716","55-59 years","Male",34,29,30,26,39,158
"Mid Sussex 014E","E01031716","60-64 years","Male",14,15,16,17,18,80
"Mid Sussex 014E","E01031716","65-69 years","Male",22,18,21,25,22,108
"Mid Sussex 014E","E01031716","70-74 years","Male",27,27,21,26,21,122
"Mid Sussex 014E","E01031716","75-79 years","Male",15,17,17,21,19,89
"Mid Sussex 014E","E01031716","80-84 years","Male",13,14,14,11,11,63
"Mid Sussex 014E","E01031716","85+ years","Male",9,8,10,11,6,44
"Mid Sussex 014E","E01031716","0-4 years","Female",65,65,61,52,49,292
"Mid Sussex 014E","E01031716","5-9 years","Female",54,51,55,61,57,278
"Mid Sussex 014E","E01031716","10-14 years","Female",49,44,44,39,49,225
"Mid Sussex 014E","E01031716","15-19 years","Female",35,30,30,32,30,157
"Mid Sussex 014E","E01031716","20-24 years","Female",27,32,29,31,32,151
"Mid Sussex 014E","E01031716","25-29 years","Female",51,45,43,36,41,216
"Mid Sussex 014E","E01031716","30-34 years","Female",64,52,52,51,46,265
"Mid Sussex 014E","E01031716","35-39 years","Female",41,42,50,48,50,231
"Mid Sussex 014E","E01031716","40-44 years","Female",40,39,40,41,46,206
"Mid Sussex 014E","E01031716","45-49 years","Female",56,48,51,45,35,235
"Mid Sussex 014E","E01031716","50-54 years","Female",32,42,47,46,52,219
"Mid Sussex 014E","E01031716","55-59 years","Female",41,42,38,41,36,198
"Mid Sussex 014E","E01031716","60-64 years","Female",27,21,25,34,37,144
"Mid Sussex 014E","E01031716","65-69 years","Female",22,18,21,19,18,98
"Mid Sussex 014E","E01031716","70-74 years","Female",33,39,34,28,22,156
"Mid Sussex 014E","E01031716","75-79 years","Female",18,19,18,15,20,90
"Mid Sussex 014E","E01031716","80-84 years","Female",5,5,5,5,5,25
"Mid Sussex 014E","E01031716","85+ years","Female",11,15,18,20,18,82
"Mid Sussex 014F","E01031717","0-4 years","Male",35,35,36,36,42,184
"Mid Sussex 014F","E01031717","5-9 years","Male",57,46,44,42,37,226
"Mid Sussex 014F","E01031717","10-14 years","Male",45,46,46,44,36,217
"Mid Sussex 014F","E01031717","15-19 years","Male",35,30,30,29,36,160
"Mid Sussex 014F","E01031717","20-24 years","Male",33,28,33,36,33,163
"Mid Sussex 014F","E01031717","25-29 years","Male",50,50,58,53,50,261
"Mid Sussex 014F","E01031717","30-34 years","Male",74,70,74,75,66,359
"Mid Sussex 014F","E01031717","35-39 years","Male",69,70,63,68,72,342
"Mid Sussex 014F","E01031717","40-44 years","Male",76,81,76,78,73,384
"Mid Sussex 014F","E01031717","45-49 years","Male",42,49,49,51,47,238
"Mid Sussex 014F","E01031717","50-54 years","Male",47,47,46,45,54,239
"Mid Sussex 014F","E01031717","55-59 years","Male",42,47,46,45,44,224
"Mid Sussex 014F","E01031717","60-64 years","Male",32,31,37,42,38,180
"Mid Sussex 014F","E01031717","65-69 years","Male",31,30,30,28,30,149
"Mid Sussex 014F","E01031717","70-74 years","Male",32,36,37,37,35,177
"Mid Sussex 014F","E01031717","75-79 years","Male",7,6,5,8,12,38
"Mid Sussex 014F","E01031717","80-84 years","Male",19,16,11,11,8,65
"Mid Sussex 014F","E01031717","85+ years","Male",13,14,15,16,12,70
"Mid Sussex 014F","E01031717","0-4 years","Female",44,39,39,37,38,197
"Mid Sussex 014F","E01031717","5-9 years","Female",37,41,39,41,36,194
"Mid Sussex 014F","E01031717","10-14 years","Female",37,30,38,41,43,189
"Mid Sussex 014F","E01031717","15-19 years","Female",39,36,39,37,36,187
"Mid Sussex 014F","E01031717","20-24 years","Female",33,27,20,20,22,122
"Mid Sussex 014F","E01031717","25-29 years","Female",44,46,47,45,41,223
"Mid Sussex 014F","E01031717","30-34 years","Female",42,39,40,46,44,211
"Mid Sussex 014F","E01031717","35-39 years","Female",58,66,63,63,63,313
"Mid Sussex 014F","E01031717","40-44 years","Female",64,54,60,59,51,288
"Mid Sussex 014F","E01031717","45-49 years","Female",48,44,45,45,42,224
"Mid Sussex 014F","E01031717","50-54 years","Female",55,49,45,46,55,250
"Mid Sussex 014F","E01031717","55-59 years","Female",47,51,57,58,51,264
"Mid Sussex 014F","E01031717","60-64 years","Female",47,40,35,36,41,199
"Mid Sussex 014F","E01031717","65-69 years","Female",24,35,39,47,44,189
"Mid Sussex 014F","E01031717","70-74 years","Female",31,35,35,28,28,157
"Mid Sussex 014F","E01031717","75-79 years","Female",17,16,19,24,28,104
"Mid Sussex 014F","E01031717","80-84 years","Female",5,6,6,6,9,32
"Mid Sussex 014F","E01031717","85+ years","Female",22,20,20,20,20,102
"Mid Sussex 015A","E01031702","0-4 years","Male",72,63,67,53,39,294
"Mid Sussex 015A","E01031702","5-9 years","Male",38,40,42,49,43,212
"Mid Sussex 015A","E01031702","10-14 years","Male",47,49,41,38,41,216
"Mid Sussex 015A","E01031702","15-19 years","Male",47,47,43,45,46,228
"Mid Sussex 015A","E01031702","20-24 years","Male",33,39,36,32,29,169
"Mid Sussex 015A","E01031702","25-29 years","Male",27,23,24,25,26,125
"Mid Sussex 015A","E01031702","30-34 years","Male",32,30,28,28,24,142
"Mid Sussex 015A","E01031702","35-39 years","Male",41,42,44,39,45,211
"Mid Sussex 015A","E01031702","40-44 years","Male",46,40,41,47,47,221
"Mid Sussex 015A","E01031702","45-49 years","Male",68,65,64,60,44,301
"Mid Sussex 015A","E01031702","50-54 years","Male",56,60,52,55,59,282
"Mid Sussex 015A","E01031702","55-59 years","Male",66,71,80,72,68,357
"Mid Sussex 015A","E01031702","60-64 years","Male",57,53,44,51,59,264
"Mid Sussex 015A","E01031702","65-69 years","Male",50,46,60,65,61,282
"Mid Sussex 015A","E01031702","70-74 years","Male",61,69,63,63,55,311
"Mid Sussex 015A","E01031702","75-79 years","Male",27,25,34,45,53,184
"Mid Sussex 015A","E01031702","80-84 years","Male",27,24,26,19,18,114
"Mid Sussex 015A","E01031702","85+ years","Male",15,14,13,9,10,61
"Mid Sussex 015A","E01031702","0-4 years","Female",26,29,37,38,39,169
"Mid Sussex 015A","E01031702","5-9 years","Female",65,47,49,49,51,261
"Mid Sussex 015A","E01031702","10-14 years","Female",29,39,33,36,35,172
"Mid Sussex 015A","E01031702","15-19 years","Female",51,40,40,31,28,190
"Mid Sussex 015A","E01031702","20-24 years","Female",30,39,41,37,31,178
"Mid Sussex 015A","E01031702","25-29 years","Female",33,33,31,31,28,156
"Mid Sussex 015A","E01031702","30-34 years","Female",33,32,35,37,39,176
"Mid Sussex 015A","E01031702","35-39 years","Female",44,41,43,47,45,220
"Mid Sussex 015A","E01031702","40-44 years","Female",49,52,47,44,47,239
"Mid Sussex 015A","E01031702","45-49 years","Female",69,64,71,72,65,341
"Mid Sussex 015A","E01031702","50-54 years","Female",54,54,53,46,49,256
"Mid Sussex 015A","E01031702","55-59 years","Female",65,71,57,65,64,322
"Mid Sussex 015A","E01031702","60-64 years","Female",67,65,70,74,64,340
"Mid Sussex 015A","E01031702","65-69 years","Female",73,68,62,67,66,336
"Mid Sussex 015A","E01031702","70-74 years","Female",43,55,62,58,65,283
"Mid Sussex 015A","E01031702","75-79 years","Female",29,26,27,25,27,134
"Mid Sussex 015A","E01031702","80-84 years","Female",32,38,34,36,36,176
"Mid Sussex 015A","E01031702","85+ years","Female",51,43,48,40,30,212
"Mid Sussex 015B","E01031703","0-4 years","Male",29,30,26,22,21,128
"Mid Sussex 015B","E01031703","5-9 years","Male",35,29,34,41,49,188
"Mid Sussex 015B","E01031703","10-14 years","Male",41,43,43,41,40,208
"Mid Sussex 015B","E01031703","15-19 years","Male",51,46,32,34,35,198
"Mid Sussex 015B","E01031703","20-24 years","Male",35,39,41,35,38,188
"Mid Sussex 015B","E01031703","25-29 years","Male",30,26,23,21,20,120
"Mid Sussex 015B","E01031703","30-34 years","Male",17,19,21,21,23,101
"Mid Sussex 015B","E01031703","35-39 years","Male",30,30,26,32,23,141
"Mid Sussex 015B","E01031703","40-44 years","Male",33,34,37,31,22,157
"Mid Sussex 015B","E01031703","45-49 years","Male",68,68,56,54,60,306
"Mid Sussex 015B","E01031703","50-54 years","Male",52,52,55,59,52,270
"Mid Sussex 015B","E01031703","55-59 years","Male",73,68,66,66,65,338
"Mid Sussex 015B","E01031703","60-64 years","Male",70,66,74,65,67,342
"Mid Sussex 015B","E01031703","65-69 years","Male",57,58,59,54,54,282
"Mid Sussex 015B","E01031703","70-74 years","Male",50,56,51,58,54,269
"Mid Sussex 015B","E01031703","75-79 years","Male",61,55,53,46,50,265
"Mid Sussex 015B","E01031703","80-84 years","Male",43,47,47,49,53,239
"Mid Sussex 015B","E01031703","85+ years","Male",37,37,40,50,46,210
"Mid Sussex 015B","E01031703","0-4 years","Female",44,41,32,25,25,167
"Mid Sussex 015B","E01031703","5-9 years","Female",29,31,34,40,43,177
"Mid Sussex 015B","E01031703","10-14 years","Female",53,65,55,55,65,293
"Mid Sussex 015B","E01031703","15-19 years","Female",87,80,73,72,64,376
"Mid Sussex 015B","E01031703","20-24 years","Female",39,31,35,33,31,169
"Mid Sussex 015B","E01031703","25-29 years","Female",22,20,19,17,16,94
"Mid Sussex 015B","E01031703","30-34 years","Female",28,35,27,31,39,160
"Mid Sussex 015B","E01031703","35-39 years","Female",25,26,32,28,30,141
"Mid Sussex 015B","E01031703","40-44 years","Female",48,42,41,47,35,213
"Mid Sussex 015B","E01031703","45-49 years","Female",58,61,55,53,54,281
"Mid Sussex 015B","E01031703","50-54 years","Female",80,76,78,71,65,370
"Mid Sussex 015B","E01031703","55-59 years","Female",58,63,63,64,67,315
"Mid Sussex 015B","E01031703","60-64 years","Female",71,68,72,70,66,347
"Mid Sussex 015B","E01031703","65-69 years","Female",76,62,60,59,52,309
"Mid Sussex 015B","E01031703","70-74 years","Female",74,86,87,80,78,405
"Mid Sussex 015B","E01031703","75-79 years","Female",58,60,62,60,67,307
"Mid Sussex 015B","E01031703","80-84 years","Female",49,45,36,43,39,212
"Mid Sussex 015B","E01031703","85+ years","Female",83,78,80,88,88,417
"Mid Sussex 015C","E01031710","0-4 years","Male",22,27,23,20,18,110
"Mid Sussex 015C","E01031710","5-9 years","Male",36,34,32,37,41,180
"Mid Sussex 015C","E01031710","10-14 years","Male",34,29,27,23,21,134
"Mid Sussex 015C","E01031710","15-19 years","Male",48,44,45,43,40,220
"Mid Sussex 015C","E01031710","20-24 years","Male",29,31,31,31,34,156
"Mid Sussex 015C","E01031710","25-29 years","Male",37,34,36,30,33,170
"Mid Sussex 015C","E01031710","30-34 years","Male",31,30,32,37,30,160
"Mid Sussex 015C","E01031710","35-39 years","Male",43,38,41,42,46,210
"Mid Sussex 015C","E01031710","40-44 years","Male",36,39,40,36,39,190
"Mid Sussex 015C","E01031710","45-49 years","Male",47,45,33,35,33,193
"Mid Sussex 015C","E01031710","50-54 years","Male",56,57,60,58,54,285
"Mid Sussex 015C","E01031710","55-59 years","Male",37,40,38,41,39,195
"Mid Sussex 015C","E01031710","60-64 years","Male",48,46,48,42,37,221
"Mid Sussex 015C","E01031710","65-69 years","Male",60,53,47,48,50,258
"Mid Sussex 015C","E01031710","70-74 years","Male",41,44,41,40,47,213
"Mid Sussex 015C","E01031710","75-79 years","Male",31,34,36,31,27,159
"Mid Sussex 015C","E01031710","80-84 years","Male",33,33,33,35,43,177
"Mid Sussex 015C","E01031710","85+ years","Male",27,28,29,28,24,136
"Mid Sussex 015C","E01031710","0-4 years","Female",26,20,20,25,25,116
"Mid Sussex 015C","E01031710","5-9 years","Female",47,48,45,42,45,227
"Mid Sussex 015C","E01031710","10-14 years","Female",37,37,44,42,41,201
"Mid Sussex 015C","E01031710","15-19 years","Female",35,32,27,28,26,148
"Mid Sussex 015C","E01031710","20-24 years","Female",29,28,31,32,33,153
"Mid Sussex 015C","E01031710","25-29 years","Female",25,24,19,28,32,128
"Mid Sussex 015C","E01031710","30-34 years","Female",33,27,29,26,31,146
"Mid Sussex 015C","E01031710","35-39 years","Female",40,42,45,47,44,218
"Mid Sussex 015C","E01031710","40-44 years","Female",51,49,45,37,37,219
"Mid Sussex 015C","E01031710","45-49 years","Female",43,49,47,51,54,244
"Mid Sussex 015C","E01031710","50-54 years","Female",53,49,47,48,39,236
"Mid Sussex 015C","E01031710","55-59 years","Female",46,47,53,53,55,254
"Mid Sussex 015C","E01031710","60-64 years","Female",58,57,43,43,49,250
"Mid Sussex 015C","E01031710","65-69 years","Female",60,54,57,56,52,279
"Mid Sussex 015C","E01031710","70-74 years","Female",54,53,55,44,43,249
"Mid Sussex 015C","E01031710","75-79 years","Female",47,49,53,57,56,262
"Mid Sussex 015C","E01031710","80-84 years","Female",33,29,26,28,31,147
"Mid Sussex 015C","E01031710","85+ years","Female",38,41,38,43,43,203
"Mid Sussex 015D","E01031715","0-4 years","Male",37,34,34,43,52,200
"Mid Sussex 015D","E01031715","5-9 years","Male",54,47,51,46,44,242
"Mid Sussex 015D","E01031715","10-14 years","Male",71,68,62,60,62,323
"Mid Sussex 015D","E01031715","15-19 years","Male",54,52,58,53,58,275
"Mid Sussex 015D","E01031715","20-24 years","Male",23,27,33,37,37,157
"Mid Sussex 015D","E01031715","25-29 years","Male",47,38,36,43,45,209
"Mid Sussex 015D","E01031715","30-34 years","Male",38,36,34,43,50,201
"Mid Sussex 015D","E01031715","35-39 years","Male",45,54,46,38,48,231
"Mid Sussex 015D","E01031715","40-44 years","Male",68,53,58,44,47,270
"Mid Sussex 015D","E01031715","45-49 years","Male",75,79,75,71,68,368
"Mid Sussex 015D","E01031715","50-54 years","Male",80,87,91,106,106,470
"Mid Sussex 015D","E01031715","55-59 years","Male",52,55,55,59,59,280
"Mid Sussex 015D","E01031715","60-64 years","Male",43,38,40,38,49,208
"Mid Sussex 015D","E01031715","65-69 years","Male",35,34,39,38,39,185
"Mid Sussex 015D","E01031715","70-74 years","Male",8,12,12,11,12,55
"Mid Sussex 015D","E01031715","75-79 years","Male",15,14,10,10,12,61
"Mid Sussex 015D","E01031715","80-84 years","Male",10,10,14,16,15,65
"Mid Sussex 015D","E01031715","85+ years","Male",6,7,8,7,8,36
"Mid Sussex 015D","E01031715","0-4 years","Female",53,41,39,39,33,205
"Mid Sussex 015D","E01031715","5-9 years","Female",56,50,48,44,49,247
"Mid Sussex 015D","E01031715","10-14 years","Female",70,70,57,63,55,315
"Mid Sussex 015D","E01031715","15-19 years","Female",39,44,51,49,60,243
"Mid Sussex 015D","E01031715","20-24 years","Female",28,31,28,30,28,145
"Mid Sussex 015D","E01031715","25-29 years","Female",28,27,27,27,30,139
"Mid Sussex 015D","E01031715","30-34 years","Female",55,49,54,63,63,284
"Mid Sussex 015D","E01031715","35-39 years","Female",52,53,47,41,44,237
"Mid Sussex 015D","E01031715","40-44 years","Female",82,70,70,61,54,337
"Mid Sussex 015D","E01031715","45-49 years","Female",87,86,87,93,86,439
"Mid Sussex 015D","E01031715","50-54 years","Female",71,69,68,61,75,344
"Mid Sussex 015D","E01031715","55-59 years","Female",61,63,65,70,73,332
"Mid Sussex 015D","E01031715","60-64 years","Female",40,45,47,51,59,242
"Mid Sussex 015D","E01031715","65-69 years","Female",22,21,28,30,30,131
"Mid Sussex 015D","E01031715","70-74 years","Female",22,28,27,22,23,122
"Mid Sussex 015D","E01031715","75-79 years","Female",17,14,16,20,22,89
"Mid Sussex 015D","E01031715","80-84 years","Female",20,21,25,24,22,112
"Mid Sussex 015D","E01031715","85+ years","Female",15,17,13,18,19,82
"Mid Sussex 016A","E01031698","0-4 years","Male",40,34,29,43,44,190
"Mid Sussex 016A","E01031698","5-9 years","Male",78,80,79,65,67,369
"Mid Sussex 016A","E01031698","10-14 years","Male",63,67,66,64,71,331
"Mid Sussex 016A","E01031698","15-19 years","Male",62,52,50,54,56,274
"Mid Sussex 016A","E01031698","20-24 years","Male",42,52,56,54,46,250
"Mid Sussex 016A","E01031698","25-29 years","Male",49,40,35,40,44,208
"Mid Sussex 016A","E01031698","30-34 years","Male",16,22,21,21,23,103
"Mid Sussex 016A","E01031698","35-39 years","Male",50,44,44,43,46,227
"Mid Sussex 016A","E01031698","40-44 years","Male",52,52,50,50,50,254
"Mid Sussex 016A","E01031698","45-49 years","Male",55,63,58,56,58,290
"Mid Sussex 016A","E01031698","50-54 years","Male",87,82,85,82,69,405
"Mid Sussex 016A","E01031698","55-59 years","Male",78,69,70,88,96,401
"Mid Sussex 016A","E01031698","60-64 years","Male",53,56,58,54,68,289
"Mid Sussex 016A","E01031698","65-69 years","Male",75,77,78,71,58,359
"Mid Sussex 016A","E01031698","70-74 years","Male",38,38,44,46,54,220
"Mid Sussex 016A","E01031698","75-79 years","Male",23,26,24,32,38,143
"Mid Sussex 016A","E01031698","80-84 years","Male",21,25,30,32,26,134
"Mid Sussex 016A","E01031698","85+ years","Male",24,20,21,19,17,101
"Mid Sussex 016A","E01031698","0-4 years","Female",49,55,49,46,45,244
"Mid Sussex 016A","E01031698","5-9 years","Female",55,43,40,42,37,217
"Mid Sussex 016A","E01031698","10-14 years","Female",55,54,54,59,67,289
"Mid Sussex 016A","E01031698","15-19 years","Female",56,55,59,57,53,280
"Mid Sussex 016A","E01031698","20-24 years","Female",27,24,29,26,24,130
"Mid Sussex 016A","E01031698","25-29 years","Female",29,28,25,30,30,142
"Mid Sussex 016A","E01031698","30-34 years","Female",33,37,39,38,41,188
"Mid Sussex 016A","E01031698","35-39 years","Female",47,51,47,46,39,230
"Mid Sussex 016A","E01031698","40-44 years","Female",66,64,56,55,71,312
"Mid Sussex 016A","E01031698","45-49 years","Female",62,62,77,80,73,354
"Mid Sussex 016A","E01031698","50-54 years","Female",87,83,72,68,73,383
"Mid Sussex 016A","E01031698","55-59 years","Female",61,73,80,78,79,371
"Mid Sussex 016A","E01031698","60-64 years","Female",62,59,56,61,66,304
"Mid Sussex 016A","E01031698","65-69 years","Female",47,42,46,52,51,238
"Mid Sussex 016A","E01031698","70-74 years","Female",32,34,35,39,38,178
"Mid Sussex 016A","E01031698","75-79 years","Female",25,30,28,29,33,145
"Mid Sussex 016A","E01031698","80-84 years","Female",20,20,20,20,19,99
"Mid Sussex 016A","E01031698","85+ years","Female",14,18,21,17,15,85
"Mid Sussex 016B","E01031767","0-4 years","Male",42,51,56,63,61,273
"Mid Sussex 016B","E01031767","5-9 years","Male",65,73,66,66,74,344
"Mid Sussex 016B","E01031767","10-14 years","Male",56,62,69,74,81,342
"Mid Sussex 016B","E01031767","15-19 years","Male",82,73,79,70,73,377
"Mid Sussex 016B","E01031767","20-24 years","Male",18,26,30,32,32,138
"Mid Sussex 016B","E01031767","25-29 years","Male",39,39,40,36,46,200
"Mid Sussex 016B","E01031767","30-34 years","Male",37,35,41,52,50,215
"Mid Sussex 016B","E01031767","35-39 years","Male",44,59,56,59,70,288
"Mid Sussex 016B","E01031767","40-44 years","Male",65,70,71,69,74,349
"Mid Sussex 016B","E01031767","45-49 years","Male",51,65,72,76,74,338
"Mid Sussex 016B","E01031767","50-54 years","Male",55,55,59,58,66,293
"Mid Sussex 016B","E01031767","55-59 years","Male",44,46,49,50,54,243
"Mid Sussex 016B","E01031767","60-64 years","Male",47,47,50,51,52,247
"Mid Sussex 016B","E01031767","65-69 years","Male",53,48,52,50,52,255
"Mid Sussex 016B","E01031767","70-74 years","Male",41,42,40,46,48,217
"Mid Sussex 016B","E01031767","75-79 years","Male",26,26,25,21,23,121
"Mid Sussex 016B","E01031767","80-84 years","Male",23,27,23,32,35,140
"Mid Sussex 016B","E01031767","85+ years","Male",24,30,35,32,34,155
"Mid Sussex 016B","E01031767","0-4 years","Female",65,63,62,58,71,319
"Mid Sussex 016B","E01031767","5-9 years","Female",57,68,80,105,112,422
"Mid Sussex 016B","E01031767","10-14 years","Female",43,55,50,61,74,283
"Mid Sussex 016B","E01031767","15-19 years","Female",72,66,67,60,59,324
"Mid Sussex 016B","E01031767","20-24 years","Female",27,27,31,33,28,146
"Mid Sussex 016B","E01031767","25-29 years","Female",37,36,31,32,44,180
"Mid Sussex 016B","E01031767","30-34 years","Female",51,48,49,46,64,258
"Mid Sussex 016B","E01031767","35-39 years","Female",57,76,79,85,84,381
"Mid Sussex 016B","E01031767","40-44 years","Female",74,78,75,80,93,400
"Mid Sussex 016B","E01031767","45-49 years","Female",64,75,81,83,81,384
"Mid Sussex 016B","E01031767","50-54 years","Female",62,68,69,70,85,354
"Mid Sussex 016B","E01031767","55-59 years","Female",46,47,60,58,53,264
"Mid Sussex 016B","E01031767","60-64 years","Female",50,56,54,57,51,268
"Mid Sussex 016B","E01031767","65-69 years","Female",43,38,45,45,48,219
"Mid Sussex 016B","E01031767","70-74 years","Female",42,46,41,44,50,223
"Mid Sussex 016B","E01031767","75-79 years","Female",28,30,28,28,29,143
"Mid Sussex 016B","E01031767","80-84 years","Female",17,17,18,23,25,100
"Mid Sussex 016B","E01031767","85+ years","Female",19,20,18,18,23,98
"Mid Sussex 016C","E01031769","0-4 years","Male",74,65,58,41,44,282
"Mid Sussex 016C","E01031769","5-9 years","Male",82,88,85,86,75,416
"Mid Sussex 016C","E01031769","10-14 years","Male",63,79,82,83,95,402
"Mid Sussex 016C","E01031769","15-19 years","Male",72,64,66,72,66,340
"Mid Sussex 016C","E01031769","20-24 years","Male",29,29,32,33,35,158
"Mid Sussex 016C","E01031769","25-29 years","Male",40,38,37,37,36,188
"Mid Sussex 016C","E01031769","30-34 years","Male",49,53,46,47,46,241
"Mid Sussex 016C","E01031769","35-39 years","Male",58,57,54,52,41,262
"Mid Sussex 016C","E01031769","40-44 years","Male",75,59,66,82,70,352
"Mid Sussex 016C","E01031769","45-49 years","Male",69,73,73,63,59,337
"Mid Sussex 016C","E01031769","50-54 years","Male",70,68,72,71,70,351
"Mid Sussex 016C","E01031769","55-59 years","Male",47,55,46,54,61,263
"Mid Sussex 016C","E01031769","60-64 years","Male",45,41,50,47,51,234
"Mid Sussex 016C","E01031769","65-69 years","Male",52,47,37,37,34,207
"Mid Sussex 016C","E01031769","70-74 years","Male",33,38,45,46,51,213
"Mid Sussex 016C","E01031769","75-79 years","Male",14,16,17,13,13,73
"Mid Sussex 016C","E01031769","80-84 years","Male",11,14,14,17,18,74
"Mid Sussex 016C","E01031769","85+ years","Male",18,14,12,18,13,75
"Mid Sussex 016C","E01031769","0-4 years","Female",56,56,52,41,31,236
"Mid Sussex 016C","E01031769","5-9 years","Female",81,79,69,72,71,372
"Mid Sussex 016C","E01031769","10-14 years","Female",67,63,78,74,88,370
"Mid Sussex 016C","E01031769","15-19 years","Female",51,53,50,55,50,259
"Mid Sussex 016C","E01031769","20-24 years","Female",26,24,22,22,28,122
"Mid Sussex 016C","E01031769","25-29 years","Female",34,35,34,29,29,161
"Mid Sussex 016C","E01031769","30-34 years","Female",63,51,46,42,40,242
"Mid Sussex 016C","E01031769","35-39 years","Female",73,76,84,77,64,374
"Mid Sussex 016C","E01031769","40-44 years","Female",92,77,74,70,71,384
"Mid Sussex 016C","E01031769","45-49 years","Female",88,98,89,101,88,464
"Mid Sussex 016C","E01031769","50-54 years","Female",55,58,69,67,79,328
"Mid Sussex 016C","E01031769","55-59 years","Female",59,59,57,61,59,295
"Mid Sussex 016C","E01031769","60-64 years","Female",53,48,58,63,68,290
"Mid Sussex 016C","E01031769","65-69 years","Female",47,49,44,37,39,216
"Mid Sussex 016C","E01031769","70-74 years","Female",43,43,44,55,53,238
"Mid Sussex 016C","E01031769","75-79 years","Female",28,35,37,34,38,172
"Mid Sussex 016C","E01031769","80-84 years","Female",18,16,16,22,22,94
"Mid Sussex 016C","E01031769","85+ years","Female",28,28,28,27,23,134
"Mid Sussex 016D","E01031770","0-4 years","Male",36,29,30,25,20,140
"Mid Sussex 016D","E01031770","5-9 years","Male",65,65,70,65,62,327
"Mid Sussex 016D","E01031770","10-14 years","Male",42,40,51,71,71,275
"Mid Sussex 016D","E01031770","15-19 years","Male",48,47,40,37,46,218
"Mid Sussex 016D","E01031770","20-24 years","Male",18,21,26,27,33,125
"Mid Sussex 016D","E01031770","25-29 years","Male",15,16,16,18,20,85
"Mid Sussex 016D","E01031770","30-34 years","Male",39,37,33,30,36,175
"Mid Sussex 016D","E01031770","35-39 years","Male",48,42,41,39,37,207
"Mid Sussex 016D","E01031770","40-44 years","Male",64,67,62,54,58,305
"Mid Sussex 016D","E01031770","45-49 years","Male",74,73,92,98,84,421
"Mid Sussex 016D","E01031770","50-54 years","Male",77,67,73,66,88,371
"Mid Sussex 016D","E01031770","55-59 years","Male",53,59,58,60,61,291
"Mid Sussex 016D","E01031770","60-64 years","Male",79,75,63,67,63,347
"Mid Sussex 016D","E01031770","65-69 years","Male",65,61,67,66,61,320
"Mid Sussex 016D","E01031770","70-74 years","Male",48,54,59,60,58,279
"Mid Sussex 016D","E01031770","75-79 years","Male",22,30,30,35,45,162
"Mid Sussex 016D","E01031770","80-84 years","Male",16,14,12,16,13,71
"Mid Sussex 016D","E01031770","85+ years","Male",18,18,19,17,17,89
"Mid Sussex 016D","E01031770","0-4 years","Female",31,30,35,38,39,173
"Mid Sussex 016D","E01031770","5-9 years","Female",59,64,58,46,40,267
"Mid Sussex 016D","E01031770","10-14 years","Female",61,63,62,76,72,334
"Mid Sussex 016D","E01031770","15-19 years","Female",45,46,52,53,65,261
"Mid Sussex 016D","E01031770","20-24 years","Female",19,19,23,21,19,101
"Mid Sussex 016D","E01031770","25-29 years","Female",25,23,25,29,33,135
"Mid Sussex 016D","E01031770","30-34 years","Female",37,36,43,46,48,210
"Mid Sussex 016D","E01031770","35-39 years","Female",54,49,50,44,39,236
"Mid Sussex 016D","E01031770","40-44 years","Female",71,63,69,67,60,330
"Mid Sussex 016D","E01031770","45-49 years","Female",63,62,69,77,78,349
"Mid Sussex 016D","E01031770","50-54 years","Female",85,88,74,78,89,414
"Mid Sussex 016D","E01031770","55-59 years","Female",63,66,69,72,77,347
"Mid Sussex 016D","E01031770","60-64 years","Female",66,70,73,76,69,354
"Mid Sussex 016D","E01031770","65-69 years","Female",60,59,47,55,51,272
"Mid Sussex 016D","E01031770","70-74 years","Female",40,43,53,63,59,258
"Mid Sussex 016D","E01031770","75-79 years","Female",30,30,32,29,28,149
"Mid Sussex 016D","E01031770","80-84 years","Female",29,32,33,36,40,170
"Mid Sussex 016D","E01031770","85+ years","Female",25,26,26,25,25,127
"Mid Sussex 016E","E01031771","0-4 years","Male",54,55,51,60,61,281
"Mid Sussex 016E","E01031771","5-9 years","Male",72,62,67,61,58,320
"Mid Sussex 016E","E01031771","10-14 years","Male",75,78,81,80,81,395
"Mid Sussex 016E","E01031771","15-19 years","Male",62,53,57,55,57,284
"Mid Sussex 016E","E01031771","20-24 years","Male",34,30,30,34,32,160
"Mid Sussex 016E","E01031771","25-29 years","Male",41,39,37,30,24,171
"Mid Sussex 016E","E01031771","30-34 years","Male",21,26,30,33,29,139
"Mid Sussex 016E","E01031771","35-39 years","Male",44,44,43,39,45,215
"Mid Sussex 016E","E01031771","40-44 years","Male",49,46,38,43,42,218
"Mid Sussex 016E","E01031771","45-49 years","Male",83,86,85,75,69,398
"Mid Sussex 016E","E01031771","50-54 years","Male",60,64,60,62,64,310
"Mid Sussex 016E","E01031771","55-59 years","Male",56,61,72,67,68,324
"Mid Sussex 016E","E01031771","60-64 years","Male",57,54,63,57,55,286
"Mid Sussex 016E","E01031771","65-69 years","Male",45,37,34,42,47,205
"Mid Sussex 016E","E01031771","70-74 years","Male",21,25,24,24,25,119
"Mid Sussex 016E","E01031771","75-79 years","Male",18,24,24,25,22,113
"Mid Sussex 016E","E01031771","80-84 years","Male",10,10,12,13,16,61
"Mid Sussex 016E","E01031771","85+ years","Male",8,8,11,11,11,49
"Mid Sussex 016E","E01031771","0-4 years","Female",51,41,53,46,39,230
"Mid Sussex 016E","E01031771","5-9 years","Female",55,55,50,50,64,274
"Mid Sussex 016E","E01031771","10-14 years","Female",43,45,44,41,42,215
"Mid Sussex 016E","E01031771","15-19 years","Female",50,48,45,37,36,216
"Mid Sussex 016E","E01031771","20-24 years","Female",56,53,62,58,55,284
"Mid Sussex 016E","E01031771","25-29 years","Female",39,41,35,36,27,178
"Mid Sussex 016E","E01031771","30-34 years","Female",43,49,62,57,66,277
"Mid Sussex 016E","E01031771","35-39 years","Female",56,53,51,55,40,255
"Mid Sussex 016E","E01031771","40-44 years","Female",61,51,47,49,53,261
"Mid Sussex 016E","E01031771","45-49 years","Female",77,73,74,62,56,342
"Mid Sussex 016E","E01031771","50-54 years","Female",89,86,92,84,79,430
"Mid Sussex 016E","E01031771","55-59 years","Female",47,51,52,62,78,290
"Mid Sussex 016E","E01031771","60-64 years","Female",48,54,50,50,56,258
"Mid Sussex 016E","E01031771","65-69 years","Female",39,33,31,35,36,174
"Mid Sussex 016E","E01031771","70-74 years","Female",25,34,37,37,35,168
"Mid Sussex 016E","E01031771","75-79 years","Female",15,14,16,18,21,84
"Mid Sussex 016E","E01031771","80-84 years","Female",14,10,11,13,13,61
"Mid Sussex 016E","E01031771","85+ years","Female",21,20,16,19,19,95
"Mid Sussex 017A","E01031744","0-4 years","Male",41,47,40,39,42,209
"Mid Sussex 017A","E01031744","5-9 years","Male",25,23,28,35,45,156
"Mid Sussex 017A","E01031744","10-14 years","Male",42,40,31,35,37,185
"Mid Sussex 017A","E01031744","15-19 years","Male",47,46,44,42,46,225
"Mid Sussex 017A","E01031744","20-24 years","Male",23,27,34,27,19,130
"Mid Sussex 017A","E01031744","25-29 years","Male",27,26,19,21,21,114
"Mid Sussex 017A","E01031744","30-34 years","Male",20,20,21,21,26,108
"Mid Sussex 017A","E01031744","35-39 years","Male",36,37,37,38,36,184
"Mid Sussex 017A","E01031744","40-44 years","Male",46,41,39,41,38,205
"Mid Sussex 017A","E01031744","45-49 years","Male",55,58,55,64,71,303
"Mid Sussex 017A","E01031744","50-54 years","Male",71,67,71,63,59,331
"Mid Sussex 017A","E01031744","55-59 years","Male",52,49,57,64,62,284
"Mid Sussex 017A","E01031744","60-64 years","Male",48,52,53,57,51,261
"Mid Sussex 017A","E01031744","65-69 years","Male",51,42,37,36,40,206
"Mid Sussex 017A","E01031744","70-74 years","Male",55,62,69,60,53,299
"Mid Sussex 017A","E01031744","75-79 years","Male",29,34,28,30,40,161
"Mid Sussex 017A","E01031744","80-84 years","Male",30,30,30,29,25,144
"Mid Sussex 017A","E01031744","85+ years","Male",20,19,21,22,26,108
"Mid Sussex 017A","E01031744","0-4 years","Female",47,40,33,40,43,203
"Mid Sussex 017A","E01031744","5-9 years","Female",41,46,51,43,39,220
"Mid Sussex 017A","E01031744","10-14 years","Female",43,44,38,45,37,207
"Mid Sussex 017A","E01031744","15-19 years","Female",59,48,44,48,56,255
"Mid Sussex 017A","E01031744","20-24 years","Female",22,19,24,25,27,117
"Mid Sussex 017A","E01031744","25-29 years","Female",16,21,17,15,22,91
"Mid Sussex 017A","E01031744","30-34 years","Female",48,46,42,37,29,202
"Mid Sussex 017A","E01031744","35-39 years","Female",45,39,43,47,58,232
"Mid Sussex 017A","E01031744","40-44 years","Female",42,44,44,51,47,228
"Mid Sussex 017A","E01031744","45-49 years","Female",63,68,62,73,69,335
"Mid Sussex 017A","E01031744","50-54 years","Female",71,78,78,75,71,373
"Mid Sussex 017A","E01031744","55-59 years","Female",47,46,44,43,49,229
"Mid Sussex 017A","E01031744","60-64 years","Female",44,44,48,51,42,229
"Mid Sussex 017A","E01031744","65-69 years","Female",53,53,53,48,53,260
"Mid Sussex 017A","E01031744","70-74 years","Female",55,58,54,64,64,295
"Mid Sussex 017A","E01031744","75-79 years","Female",43,40,45,37,40,205
"Mid Sussex 017A","E01031744","80-84 years","Female",26,32,33,41,36,168
"Mid Sussex 017A","E01031744","85+ years","Female",24,20,22,24,22,112
"Mid Sussex 017B","E01031745","0-4 years","Male",69,60,45,44,39,257
"Mid Sussex 017B","E01031745","5-9 years","Male",74,73,81,89,86,403
"Mid Sussex 017B","E01031745","10-14 years","Male",52,60,66,71,68,317
"Mid Sussex 017B","E01031745","15-19 years","Male",65,61,57,50,57,290
"Mid Sussex 017B","E01031745","20-24 years","Male",20,26,28,31,33,138
"Mid Sussex 017B","E01031745","25-29 years","Male",40,31,33,29,28,161
"Mid Sussex 017B","E01031745","30-34 years","Male",46,42,49,39,36,212
"Mid Sussex 017B","E01031745","35-39 years","Male",80,76,68,59,55,338
"Mid Sussex 017B","E01031745","40-44 years","Male",87,89,83,96,97,452
"Mid Sussex 017B","E01031745","45-49 years","Male",66,63,72,74,70,345
"Mid Sussex 017B","E01031745","50-54 years","Male",62,76,70,64,62,334
"Mid Sussex 017B","E01031745","55-59 years","Male",52,47,51,56,66,272
"Mid Sussex 017B","E01031745","60-64 years","Male",53,55,52,54,47,261
"Mid Sussex 017B","E01031745","65-69 years","Male",45,40,41,42,47,215
"Mid Sussex 017B","E01031745","70-74 years","Male",52,54,54,44,47,251
"Mid Sussex 017B","E01031745","75-79 years","Male",44,48,50,53,52,247
"Mid Sussex 017B","E01031745","80-84 years","Male",33,33,32,31,29,158
"Mid Sussex 017B","E01031745","85+ years","Male",49,47,42,52,49,239
"Mid Sussex 017B","E01031745","0-4 years","Female",59,57,53,38,41,248
"Mid Sussex 017B","E01031745","5-9 years","Female",89,87,78,79,67,400
"Mid Sussex 017B","E01031745","10-14 years","Female",51,52,61,76,91,331
"Mid Sussex 017B","E01031745","15-19 years","Female",48,54,48,50,49,249
"Mid Sussex 017B","E01031745","20-24 years","Female",23,24,30,26,27,130
"Mid Sussex 017B","E01031745","25-29 years","Female",38,35,25,22,25,145
"Mid Sussex 017B","E01031745","30-34 years","Female",46,40,39,40,37,202
"Mid Sussex 017B","E01031745","35-39 years","Female",70,75,76,59,54,334
"Mid Sussex 017B","E01031745","40-44 years","Female",78,69,64,81,77,369
"Mid Sussex 017B","E01031745","45-49 years","Female",81,77,87,85,88,418
"Mid Sussex 017B","E01031745","50-54 years","Female",85,98,93,92,93,461
"Mid Sussex 017B","E01031745","55-59 years","Female",54,59,66,70,73,322
"Mid Sussex 017B","E01031745","60-64 years","Female",54,52,50,48,50,254
"Mid Sussex 017B","E01031745","65-69 years","Female",65,61,54,53,51,284
"Mid Sussex 017B","E01031745","70-74 years","Female",82,84,84,76,69,395
"Mid Sussex 017B","E01031745","75-79 years","Female",65,63,68,65,69,330
"Mid Sussex 017B","E01031745","80-84 years","Female",56,59,55,64,66,300
"Mid Sussex 017B","E01031745","85+ years","Female",77,67,71,73,79,367
"Mid Sussex 017C","E01031746","0-4 years","Male",54,46,43,40,31,214
"Mid Sussex 017C","E01031746","5-9 years","Male",58,65,70,71,70,334
"Mid Sussex 017C","E01031746","10-14 years","Male",56,60,54,62,66,298
"Mid Sussex 017C","E01031746","15-19 years","Male",70,65,65,55,55,310
"Mid Sussex 017C","E01031746","20-24 years","Male",28,32,33,32,28,153
"Mid Sussex 017C","E01031746","25-29 years","Male",46,42,37,42,38,205
"Mid Sussex 017C","E01031746","30-34 years","Male",55,60,59,52,52,278
"Mid Sussex 017C","E01031746","35-39 years","Male",57,61,58,67,71,314
"Mid Sussex 017C","E01031746","40-44 years","Male",67,59,54,54,52,286
"Mid Sussex 017C","E01031746","45-49 years","Male",53,59,66,70,66,314
"Mid Sussex 017C","E01031746","50-54 years","Male",90,83,78,77,76,404
"Mid Sussex 017C","E01031746","55-59 years","Male",66,63,59,67,77,332
"Mid Sussex 017C","E01031746","60-64 years","Male",42,51,63,63,54,273
"Mid Sussex 017C","E01031746","65-69 years","Male",30,26,25,27,31,139
"Mid Sussex 017C","E01031746","70-74 years","Male",21,20,26,25,26,118
"Mid Sussex 017C","E01031746","75-79 years","Male",19,16,13,10,10,68
"Mid Sussex 017C","E01031746","80-84 years","Male",18,15,15,18,18,84
"Mid Sussex 017C","E01031746","85+ years","Male",22,21,22,20,16,101
"Mid Sussex 017C","E01031746","0-4 years","Female",54,61,66,58,51,290
"Mid Sussex 017C","E01031746","5-9 years","Female",57,61,56,60,61,295
"Mid Sussex 017C","E01031746","10-14 years","Female",41,44,39,42,56,222
"Mid Sussex 017C","E01031746","15-19 years","Female",44,36,37,36,32,185
"Mid Sussex 017C","E01031746","20-24 years","Female",45,40,40,34,30,189
"Mid Sussex 017C","E01031746","25-29 years","Female",50,57,60,59,59,285
"Mid Sussex 017C","E01031746","30-34 years","Female",49,54,46,50,47,246
"Mid Sussex 017C","E01031746","35-39 years","Female",74,80,81,83,81,399
"Mid Sussex 017C","E01031746","40-44 years","Female",63,58,61,61,67,310
"Mid Sussex 017C","E01031746","45-49 years","Female",56,57,62,63,78,316
"Mid Sussex 017C","E01031746","50-54 years","Female",81,88,84,81,68,402
"Mid Sussex 017C","E01031746","55-59 years","Female",55,49,58,58,59,279
"Mid Sussex 017C","E01031746","60-64 years","Female",56,52,48,51,45,252
"Mid Sussex 017C","E01031746","65-69 years","Female",33,39,37,43,43,195
"Mid Sussex 017C","E01031746","70-74 years","Female",32,30,38,41,39,180
"Mid Sussex 017C","E01031746","75-79 years","Female",24,25,26,23,19,117
"Mid Sussex 017C","E01031746","80-84 years","Female",17,19,19,21,19,95
"Mid Sussex 017C","E01031746","85+ years","Female",45,40,35,32,34,186
"Mid Sussex 017D","E01031747","0-4 years","Male",34,33,34,28,31,160
"Mid Sussex 017D","E01031747","5-9 years","Male",42,41,39,42,43,207
"Mid Sussex 017D","E01031747","10-14 years","Male",35,35,48,48,44,210
"Mid Sussex 017D","E01031747","15-19 years","Male",33,34,33,27,25,152
"Mid Sussex 017D","E01031747","20-24 years","Male",13,12,12,11,11,59
"Mid Sussex 017D","E01031747","25-29 years","Male",31,30,27,24,24,136
"Mid Sussex 017D","E01031747","30-34 years","Male",26,39,35,34,30,164
"Mid Sussex 017D","E01031747","35-39 years","Male",26,28,28,32,33,147
"Mid Sussex 017D","E01031747","40-44 years","Male",42,47,58,50,44,241
"Mid Sussex 017D","E01031747","45-49 years","Male",53,54,56,60,62,285
"Mid Sussex 017D","E01031747","50-54 years","Male",52,55,45,47,54,253
"Mid Sussex 017D","E01031747","55-59 years","Male",57,57,63,66,66,309
"Mid Sussex 017D","E01031747","60-64 years","Male",48,53,52,52,49,254
"Mid Sussex 017D","E01031747","65-69 years","Male",59,59,49,51,56,274
"Mid Sussex 017D","E01031747","70-74 years","Male",27,30,37,37,42,173
"Mid Sussex 017D","E01031747","75-79 years","Male",40,35,33,34,30,172
"Mid Sussex 017D","E01031747","80-84 years","Male",44,36,43,44,34,201
"Mid Sussex 017D","E01031747","85+ years","Male",24,28,23,29,28,132
"Mid Sussex 017D","E01031747","0-4 years","Female",28,25,28,33,34,148
"Mid Sussex 017D","E01031747","5-9 years","Female",42,41,53,49,47,232
"Mid Sussex 017D","E01031747","10-14 years","Female",44,48,50,51,48,241
"Mid Sussex 017D","E01031747","15-19 years","Female",38,42,42,38,37,197
"Mid Sussex 017D","E01031747","20-24 years","Female",21,23,26,34,29,133
"Mid Sussex 017D","E01031747","25-29 years","Female",20,20,14,12,11,77
"Mid Sussex 017D","E01031747","30-34 years","Female",27,33,28,24,26,138
"Mid Sussex 017D","E01031747","35-39 years","Female",47,51,55,52,49,254
"Mid Sussex 017D","E01031747","40-44 years","Female",41,41,53,59,53,247
"Mid Sussex 017D","E01031747","45-49 years","Female",66,64,63,57,58,308
"Mid Sussex 017D","E01031747","50-54 years","Female",60,53,48,52,50,263
"Mid Sussex 017D","E01031747","55-59 years","Female",74,77,64,60,55,330
"Mid Sussex 017D","E01031747","60-64 years","Female",44,47,63,71,82,307
"Mid Sussex 017D","E01031747","65-69 years","Female",65,64,54,56,57,296
"Mid Sussex 017D","E01031747","70-74 years","Female",56,54,57,53,55,275
"Mid Sussex 017D","E01031747","75-79 years","Female",68,77,72,63,59,339
"Mid Sussex 017D","E01031747","80-84 years","Female",51,51,60,63,63,288
"Mid Sussex 017D","E01031747","85+ years","Female",60,64,61,66,64,315
"Mid Sussex 017E","E01031748","0-4 years","Male",37,49,43,38,35,202
"Mid Sussex 017E","E01031748","5-9 years","Male",56,49,55,60,54,274
"Mid Sussex 017E","E01031748","10-14 years","Male",36,37,36,33,39,181
"Mid Sussex 017E","E01031748","15-19 years","Male",51,51,49,52,49,252
"Mid Sussex 017E","E01031748","20-24 years","Male",20,22,26,19,20,107
"Mid Sussex 017E","E01031748","25-29 years","Male",25,25,21,31,29,131
"Mid Sussex 017E","E01031748","30-34 years","Male",23,26,25,21,23,118
"Mid Sussex 017E","E01031748","35-39 years","Male",35,34,31,36,35,171
"Mid Sussex 017E","E01031748","40-44 years","Male",52,44,40,43,43,222
"Mid Sussex 017E","E01031748","45-49 years","Male",44,53,55,58,59,269
"Mid Sussex 017E","E01031748","50-54 years","Male",57,55,58,54,53,277
"Mid Sussex 017E","E01031748","55-59 years","Male",35,35,39,41,40,190
"Mid Sussex 017E","E01031748","60-64 years","Male",46,52,54,54,55,261
"Mid Sussex 017E","E01031748","65-69 years","Male",46,38,32,32,35,183
"Mid Sussex 017E","E01031748","70-74 years","Male",33,41,37,42,42,195
"Mid Sussex 017E","E01031748","75-79 years","Male",21,20,23,28,24,116
"Mid Sussex 017E","E01031748","80-84 years","Male",38,39,34,31,23,165
"Mid Sussex 017E","E01031748","85+ years","Male",26,29,28,32,36,151
"Mid Sussex 017E","E01031748","0-4 years","Female",21,24,27,26,29,127
"Mid Sussex 017E","E01031748","5-9 years","Female",52,63,62,62,56,295
"Mid Sussex 017E","E01031748","10-14 years","Female",38,37,44,42,37,198
"Mid Sussex 017E","E01031748","15-19 years","Female",39,34,39,35,33,180
"Mid Sussex 017E","E01031748","20-24 years","Female",22,22,20,20,27,111
"Mid Sussex 017E","E01031748","25-29 years","Female",13,11,12,15,11,62
"Mid Sussex 017E","E01031748","30-34 years","Female",20,22,18,15,15,90
"Mid Sussex 017E","E01031748","35-39 years","Female",49,55,53,47,48,252
"Mid Sussex 017E","E01031748","40-44 years","Female",52,53,57,55,63,280
"Mid Sussex 017E","E01031748","45-49 years","Female",55,55,58,65,63,296
"Mid Sussex 017E","E01031748","50-54 years","Female",59,61,60,51,51,282
"Mid Sussex 017E","E01031748","55-59 years","Female",42,45,49,57,55,248
"Mid Sussex 017E","E01031748","60-64 years","Female",41,34,36,37,25,173
"Mid Sussex 017E","E01031748","65-69 years","Female",47,49,39,39,45,219
"Mid Sussex 017E","E01031748","70-74 years","Female",52,50,50,44,44,240
"Mid Sussex 017E","E01031748","75-79 years","Female",32,32,42,46,48,200
"Mid Sussex 017E","E01031748","80-84 years","Female",35,35,35,33,32,170
"Mid Sussex 017E","E01031748","85+ years","Female",27,30,28,28,23,136
"Mid Sussex 017F","E01031768","0-4 years","Male",32,36,27,31,33,159
"Mid Sussex 017F","E01031768","5-9 years","Male",42,37,52,53,54,238
"Mid Sussex 017F","E01031768","10-14 years","Male",69,65,58,47,44,283
"Mid Sussex 017F","E01031768","15-19 years","Male",36,45,49,48,58,236
"Mid Sussex 017F","E01031768","20-24 years","Male",19,21,23,25,29,117
"Mid Sussex 017F","E01031768","25-29 years","Male",10,7,9,9,8,43
"Mid Sussex 017F","E01031768","30-34 years","Male",7,9,8,10,12,46
"Mid Sussex 017F","E01031768","35-39 years","Male",31,31,22,19,17,120
"Mid Sussex 017F","E01031768","40-44 years","Male",61,59,52,56,58,286
"Mid Sussex 017F","E01031768","45-49 years","Male",58,52,67,58,59,294
"Mid Sussex 017F","E01031768","50-54 years","Male",56,63,67,67,74,327
"Mid Sussex 017F","E01031768","55-59 years","Male",33,36,42,47,54,212
"Mid Sussex 017F","E01031768","60-64 years","Male",28,26,26,23,23,126
"Mid Sussex 017F","E01031768","65-69 years","Male",71,62,49,52,51,285
"Mid Sussex 017F","E01031768","70-74 years","Male",47,57,66,59,60,289
"Mid Sussex 017F","E01031768","75-79 years","Male",46,47,42,55,51,241
"Mid Sussex 017F","E01031768","80-84 years","Male",39,41,45,41,46,212
"Mid Sussex 017F","E01031768","85+ years","Male",34,28,29,33,37,161
"Mid Sussex 017F","E01031768","0-4 years","Female",21,28,27,28,21,125
"Mid Sussex 017F","E01031768","5-9 years","Female",60,50,53,48,48,259
"Mid Sussex 017F","E01031768","10-14 years","Female",35,42,40,41,42,200
"Mid Sussex 017F","E01031768","15-19 years","Female",50,45,47,50,45,237
"Mid Sussex 017F","E01031768","20-24 years","Female",6,10,13,13,16,58
"Mid Sussex 017F","E01031768","25-29 years","Female",12,14,13,10,9,58
"Mid Sussex 017F","E01031768","30-34 years","Female",25,24,22,21,23,115
"Mid Sussex 017F","E01031768","35-39 years","Female",30,35,32,35,35,167
"Mid Sussex 017F","E01031768","40-44 years","Female",72,69,62,56,57,316
"Mid Sussex 017F","E01031768","45-49 years","Female",54,50,58,61,67,290
"Mid Sussex 017F","E01031768","50-54 years","Female",57,67,60,60,49,293
"Mid Sussex 017F","E01031768","55-59 years","Female",65,59,63,61,68,316
"Mid Sussex 017F","E01031768","60-64 years","Female",53,50,50,51,60,264
"Mid Sussex 017F","E01031768","65-69 years","Female",75,71,67,66,58,337
"Mid Sussex 017F","E01031768","70-74 years","Female",50,57,72,67,74,320
"Mid Sussex 017F","E01031768","75-79 years","Female",62,59,47,52,47,267
"Mid Sussex 017F","E01031768","80-84 years","Female",51,48,46,47,53,245
"Mid Sussex 017F","E01031768","85+ years","Female",59,64,68,72,69,332
"Worthing 001A","E01031793","0-4 years","Male",29,24,27,26,19,125
"Worthing 001A","E01031793","5-9 years","Male",19,21,22,20,30,112
"Worthing 001A","E01031793","10-14 years","Male",26,26,26,26,19,123
"Worthing 001A","E01031793","15-19 years","Male",36,38,31,28,31,164
"Worthing 001A","E01031793","20-24 years","Male",12,12,15,14,12,65
"Worthing 001A","E01031793","25-29 years","Male",14,13,11,16,19,73
"Worthing 001A","E01031793","30-34 years","Male",27,33,28,29,29,146
"Worthing 001A","E01031793","35-39 years","Male",32,29,25,32,35,153
"Worthing 001A","E01031793","40-44 years","Male",41,41,44,46,37,209
"Worthing 001A","E01031793","45-49 years","Male",62,60,61,50,49,282
"Worthing 001A","E01031793","50-54 years","Male",41,43,42,49,53,228
"Worthing 001A","E01031793","55-59 years","Male",47,51,43,43,42,226
"Worthing 001A","E01031793","60-64 years","Male",56,53,60,59,54,282
"Worthing 001A","E01031793","65-69 years","Male",57,54,53,51,52,267
"Worthing 001A","E01031793","70-74 years","Male",36,34,34,34,35,173
"Worthing 001A","E01031793","75-79 years","Male",50,49,49,45,45,238
"Worthing 001A","E01031793","80-84 years","Male",33,32,33,39,39,176
"Worthing 001A","E01031793","85+ years","Male",24,25,22,24,24,119
"Worthing 001A","E01031793","0-4 years","Female",24,23,20,24,28,119
"Worthing 001A","E01031793","5-9 years","Female",27,26,29,25,27,134
"Worthing 001A","E01031793","10-14 years","Female",30,28,32,36,30,156
"Worthing 001A","E01031793","15-19 years","Female",30,25,18,18,20,111
"Worthing 001A","E01031793","20-24 years","Female",12,9,13,11,12,57
"Worthing 001A","E01031793","25-29 years","Female",12,13,14,13,13,65
"Worthing 001A","E01031793","30-34 years","Female",24,21,18,23,21,107
"Worthing 001A","E01031793","35-39 years","Female",43,34,32,35,42,186
"Worthing 001A","E01031793","40-44 years","Female",34,39,47,49,49,218
"Worthing 001A","E01031793","45-49 years","Female",40,40,42,41,42,205
"Worthing 001A","E01031793","50-54 years","Female",57,51,50,45,40,243
"Worthing 001A","E01031793","55-59 years","Female",50,52,55,61,64,282
"Worthing 001A","E01031793","60-64 years","Female",57,48,53,55,48,261
"Worthing 001A","E01031793","65-69 years","Female",72,74,70,64,61,341
"Worthing 001A","E01031793","70-74 years","Female",63,60,67,72,77,339
"Worthing 001A","E01031793","75-79 years","Female",53,52,52,54,56,267
"Worthing 001A","E01031793","80-84 years","Female",32,39,41,43,42,197
"Worthing 001A","E01031793","85+ years","Female",36,30,32,34,41,173
"Worthing 001B","E01031820","0-4 years","Male",21,25,28,30,28,132
"Worthing 001B","E01031820","5-9 years","Male",24,29,31,30,30,144
"Worthing 001B","E01031820","10-14 years","Male",40,38,35,32,35,180
"Worthing 001B","E01031820","15-19 years","Male",46,43,48,46,43,226
"Worthing 001B","E01031820","20-24 years","Male",23,17,22,22,25,109
"Worthing 001B","E01031820","25-29 years","Male",14,19,17,17,17,84
"Worthing 001B","E01031820","30-34 years","Male",17,21,24,28,29,119
"Worthing 001B","E01031820","35-39 years","Male",14,13,14,16,15,72
"Worthing 001B","E01031820","40-44 years","Male",34,41,43,34,46,198
"Worthing 001B","E01031820","45-49 years","Male",71,61,53,53,46,284
"Worthing 001B","E01031820","50-54 years","Male",62,66,68,69,62,327
"Worthing 001B","E01031820","55-59 years","Male",57,66,56,68,69,316
"Worthing 001B","E01031820","60-64 years","Male",52,54,62,55,56,279
"Worthing 001B","E01031820","65-69 years","Male",89,77,67,59,60,352
"Worthing 001B","E01031820","70-74 years","Male",94,97,109,115,112,527
"Worthing 001B","E01031820","75-79 years","Male",58,69,69,67,74,337
"Worthing 001B","E01031820","80-84 years","Male",50,50,46,47,44,237
"Worthing 001B","E01031820","85+ years","Male",46,40,42,51,50,229
"Worthing 001B","E01031820","0-4 years","Female",12,18,20,19,20,89
"Worthing 001B","E01031820","5-9 years","Female",19,13,18,21,21,92
"Worthing 001B","E01031820","10-14 years","Female",31,34,31,30,27,153
"Worthing 001B","E01031820","15-19 years","Female",33,31,30,28,27,149
"Worthing 001B","E01031820","20-24 years","Female",33,31,28,30,32,154
"Worthing 001B","E01031820","25-29 years","Female",18,22,22,21,25,108
"Worthing 001B","E01031820","30-34 years","Female",22,16,15,21,24,98
"Worthing 001B","E01031820","35-39 years","Female",24,27,28,28,23,130
"Worthing 001B","E01031820","40-44 years","Female",44,40,43,42,49,218
"Worthing 001B","E01031820","45-49 years","Female",54,56,50,50,43,253
"Worthing 001B","E01031820","50-54 years","Female",65,70,72,71,65,343
"Worthing 001B","E01031820","55-59 years","Female",54,56,65,70,75,320
"Worthing 001B","E01031820","60-64 years","Female",73,67,62,56,57,315
"Worthing 001B","E01031820","65-69 years","Female",109,98,86,87,88,468
"Worthing 001B","E01031820","70-74 years","Female",114,122,125,117,107,585
"Worthing 001B","E01031820","75-79 years","Female",67,75,72,84,91,389
"Worthing 001B","E01031820","80-84 years","Female",62,62,72,60,55,311
"Worthing 001B","E01031820","85+ years","Female",63,61,60,63,63,310
"Worthing 001C","E01031821","0-4 years","Male",30,29,24,29,29,141
"Worthing 001C","E01031821","5-9 years","Male",46,42,33,32,36,189
"Worthing 001C","E01031821","10-14 years","Male",49,48,52,54,53,256
"Worthing 001C","E01031821","15-19 years","Male",40,47,45,41,46,219
"Worthing 001C","E01031821","20-24 years","Male",30,29,29,36,27,151
"Worthing 001C","E01031821","25-29 years","Male",40,50,47,40,45,222
"Worthing 001C","E01031821","30-34 years","Male",23,19,22,24,21,109
"Worthing 001C","E01031821","35-39 years","Male",34,36,40,41,38,189
"Worthing 001C","E01031821","40-44 years","Male",48,43,35,33,36,195
"Worthing 001C","E01031821","45-49 years","Male",71,73,76,68,59,347
"Worthing 001C","E01031821","50-54 years","Male",60,60,63,70,70,323
"Worthing 001C","E01031821","55-59 years","Male",61,70,69,62,72,334
"Worthing 001C","E01031821","60-64 years","Male",63,61,49,50,47,270
"Worthing 001C","E01031821","65-69 years","Male",51,51,61,57,54,274
"Worthing 001C","E01031821","70-74 years","Male",54,65,52,60,66,297
"Worthing 001C","E01031821","75-79 years","Male",39,40,43,43,41,206
"Worthing 001C","E01031821","80-84 years","Male",31,30,34,40,39,174
"Worthing 001C","E01031821","85+ years","Male",23,19,18,19,22,101
"Worthing 001C","E01031821","0-4 years","Female",42,45,42,37,29,195
"Worthing 001C","E01031821","5-9 years","Female",53,45,47,47,52,244
"Worthing 001C","E01031821","10-14 years","Female",44,55,51,52,51,253
"Worthing 001C","E01031821","15-19 years","Female",33,32,35,30,40,170
"Worthing 001C","E01031821","20-24 years","Female",32,31,37,42,36,178
"Worthing 001C","E01031821","25-29 years","Female",19,18,19,20,17,93
"Worthing 001C","E01031821","30-34 years","Female",27,27,29,27,30,140
"Worthing 001C","E01031821","35-39 years","Female",32,35,33,33,28,161
"Worthing 001C","E01031821","40-44 years","Female",66,69,56,55,52,298
"Worthing 001C","E01031821","45-49 years","Female",78,80,86,69,69,382
"Worthing 001C","E01031821","50-54 years","Female",52,54,51,66,64,287
"Worthing 001C","E01031821","55-59 years","Female",77,78,75,75,72,377
"Worthing 001C","E01031821","60-64 years","Female",54,46,54,59,53,266
"Worthing 001C","E01031821","65-69 years","Female",73,71,72,67,71,354
"Worthing 001C","E01031821","70-74 years","Female",62,72,79,80,75,368
"Worthing 001C","E01031821","75-79 years","Female",63,63,62,71,64,323
"Worthing 001C","E01031821","80-84 years","Female",31,37,35,38,38,179
"Worthing 001C","E01031821","85+ years","Female",50,47,48,43,41,229
"Worthing 001D","E01031828","0-4 years","Male",23,19,17,17,17,93
"Worthing 001D","E01031828","5-9 years","Male",16,10,14,16,16,72
"Worthing 001D","E01031828","10-14 years","Male",34,33,34,27,26,154
"Worthing 001D","E01031828","15-19 years","Male",36,30,32,28,24,150
"Worthing 001D","E01031828","20-24 years","Male",30,34,33,37,41,175
"Worthing 001D","E01031828","25-29 years","Male",17,17,17,23,26,100
"Worthing 001D","E01031828","30-34 years","Male",12,15,17,14,14,72
"Worthing 001D","E01031828","35-39 years","Male",24,23,18,12,9,86
"Worthing 001D","E01031828","40-44 years","Male",30,27,31,31,31,150
"Worthing 001D","E01031828","45-49 years","Male",45,43,46,45,42,221
"Worthing 001D","E01031828","50-54 years","Male",66,62,58,58,58,302
"Worthing 001D","E01031828","55-59 years","Male",56,57,51,48,51,263
"Worthing 001D","E01031828","60-64 years","Male",49,58,73,72,64,316
"Worthing 001D","E01031828","65-69 years","Male",70,65,64,75,73,347
"Worthing 001D","E01031828","70-74 years","Male",54,55,55,52,55,271
"Worthing 001D","E01031828","75-79 years","Male",39,37,36,39,46,197
"Worthing 001D","E01031828","80-84 years","Male",24,28,38,38,33,161
"Worthing 001D","E01031828","85+ years","Male",17,15,18,16,16,82
"Worthing 001D","E01031828","0-4 years","Female",9,8,9,13,12,51
"Worthing 001D","E01031828","5-9 years","Female",31,31,26,21,15,124
"Worthing 001D","E01031828","10-14 years","Female",20,17,27,30,37,131
"Worthing 001D","E01031828","15-19 years","Female",30,28,23,21,16,118
"Worthing 001D","E01031828","20-24 years","Female",22,24,24,32,26,128
"Worthing 001D","E01031828","25-29 years","Female",17,13,13,14,14,71
"Worthing 001D","E01031828","30-34 years","Female",11,12,12,14,14,63
"Worthing 001D","E01031828","35-39 years","Female",18,17,16,13,11,75
"Worthing 001D","E01031828","40-44 years","Female",40,38,32,27,27,164
"Worthing 001D","E01031828","45-49 years","Female",52,45,45,48,49,239
"Worthing 001D","E01031828","50-54 years","Female",59,61,63,56,56,295
"Worthing 001D","E01031828","55-59 years","Female",54,54,54,53,51,266
"Worthing 001D","E01031828","60-64 years","Female",60,60,61,61,59,301
"Worthing 001D","E01031828","65-69 years","Female",68,64,63,62,67,324
"Worthing 001D","E01031828","70-74 years","Female",53,59,62,63,60,297
"Worthing 001D","E01031828","75-79 years","Female",35,27,32,35,40,169
"Worthing 001D","E01031828","80-84 years","Female",22,26,28,27,25,128
"Worthing 001D","E01031828","85+ years","Female",51,44,43,46,49,233
"Worthing 001E","E01031829","0-4 years","Male",28,26,23,22,24,123
"Worthing 001E","E01031829","5-9 years","Male",38,36,41,42,40,197
"Worthing 001E","E01031829","10-14 years","Male",33,33,34,34,37,171
"Worthing 001E","E01031829","15-19 years","Male",37,43,37,33,37,187
"Worthing 001E","E01031829","20-24 years","Male",20,22,27,25,24,118
"Worthing 001E","E01031829","25-29 years","Male",13,15,14,15,15,72
"Worthing 001E","E01031829","30-34 years","Male",18,14,26,27,21,106
"Worthing 001E","E01031829","35-39 years","Male",28,27,17,24,24,120
"Worthing 001E","E01031829","40-44 years","Male",34,33,42,29,27,165
"Worthing 001E","E01031829","45-49 years","Male",69,77,64,67,63,340
"Worthing 001E","E01031829","50-54 years","Male",65,65,69,71,62,332
"Worthing 001E","E01031829","55-59 years","Male",65,67,67,73,75,347
"Worthing 001E","E01031829","60-64 years","Male",56,53,52,45,50,256
"Worthing 001E","E01031829","65-69 years","Male",88,86,68,67,65,374
"Worthing 001E","E01031829","70-74 years","Male",77,84,97,98,111,467
"Worthing 001E","E01031829","75-79 years","Male",47,47,48,52,53,247
"Worthing 001E","E01031829","80-84 years","Male",32,39,48,53,57,229
"Worthing 001E","E01031829","85+ years","Male",23,25,25,20,22,115
"Worthing 001E","E01031829","0-4 years","Female",37,32,26,31,19,145
"Worthing 001E","E01031829","5-9 years","Female",25,32,31,28,34,150
"Worthing 001E","E01031829","10-14 years","Female",36,36,40,33,32,177
"Worthing 001E","E01031829","15-19 years","Female",32,33,37,38,38,178
"Worthing 001E","E01031829","20-24 years","Female",29,28,26,21,22,126
"Worthing 001E","E01031829","25-29 years","Female",20,18,13,13,15,79
"Worthing 001E","E01031829","30-34 years","Female",16,16,16,18,17,83
"Worthing 001E","E01031829","35-39 years","Female",39,34,34,32,27,166
"Worthing 001E","E01031829","40-44 years","Female",47,47,41,42,44,221
"Worthing 001E","E01031829","45-49 years","Female",57,62,56,57,59,291
"Worthing 001E","E01031829","50-54 years","Female",58,54,60,62,63,297
"Worthing 001E","E01031829","55-59 years","Female",58,65,62,60,64,309
"Worthing 001E","E01031829","60-64 years","Female",64,60,56,51,55,286
"Worthing 001E","E01031829","65-69 years","Female",84,76,74,80,67,381
"Worthing 001E","E01031829","70-74 years","Female",54,65,68,78,82,347
"Worthing 001E","E01031829","75-79 years","Female",51,53,57,60,62,283
"Worthing 001E","E01031829","80-84 years","Female",32,32,37,39,34,174
"Worthing 001E","E01031829","85+ years","Female",58,52,46,43,44,243
"Worthing 002A","E01031822","0-4 years","Male",24,18,19,14,21,96
"Worthing 002A","E01031822","5-9 years","Male",35,39,39,39,39,191
"Worthing 002A","E01031822","10-14 years","Male",53,53,44,56,58,264
"Worthing 002A","E01031822","15-19 years","Male",56,57,60,52,47,272
"Worthing 002A","E01031822","20-24 years","Male",26,28,29,30,28,141
"Worthing 002A","E01031822","25-29 years","Male",30,31,34,36,37,168
"Worthing 002A","E01031822","30-34 years","Male",23,23,20,16,17,99
"Worthing 002A","E01031822","35-39 years","Male",38,36,30,36,35,175
"Worthing 002A","E01031822","40-44 years","Male",59,52,44,45,38,238
"Worthing 002A","E01031822","45-49 years","Male",75,68,69,71,66,349
"Worthing 002A","E01031822","50-54 years","Male",58,64,73,76,77,348
"Worthing 002A","E01031822","55-59 years","Male",44,45,40,44,44,217
"Worthing 002A","E01031822","60-64 years","Male",48,49,48,50,53,248
"Worthing 002A","E01031822","65-69 years","Male",74,67,60,51,48,300
"Worthing 002A","E01031822","70-74 years","Male",70,77,86,86,77,396
"Worthing 002A","E01031822","75-79 years","Male",23,32,34,38,51,178
"Worthing 002A","E01031822","80-84 years","Male",28,25,18,16,19,106
"Worthing 002A","E01031822","85+ years","Male",29,24,32,32,31,148
"Worthing 002A","E01031822","0-4 years","Female",41,33,27,26,28,155
"Worthing 002A","E01031822","5-9 years","Female",39,43,37,39,36,194
"Worthing 002A","E01031822","10-14 years","Female",40,39,46,45,47,217
"Worthing 002A","E01031822","15-19 years","Female",51,52,55,54,55,267
"Worthing 002A","E01031822","20-24 years","Female",30,32,28,32,33,155
"Worthing 002A","E01031822","25-29 years","Female",28,28,28,29,33,146
"Worthing 002A","E01031822","30-34 years","Female",26,27,33,22,22,130
"Worthing 002A","E01031822","35-39 years","Female",48,50,42,42,35,217
"Worthing 002A","E01031822","40-44 years","Female",51,52,51,48,47,249
"Worthing 002A","E01031822","45-49 years","Female",79,70,70,65,71,355
"Worthing 002A","E01031822","50-54 years","Female",51,59,59,61,54,284
"Worthing 002A","E01031822","55-59 years","Female",38,47,59,64,68,276
"Worthing 002A","E01031822","60-64 years","Female",67,61,53,51,49,281
"Worthing 002A","E01031822","65-69 years","Female",76,74,68,69,65,352
"Worthing 002A","E01031822","70-74 years","Female",58,73,71,74,75,351
"Worthing 002A","E01031822","75-79 years","Female",54,48,52,53,56,263
"Worthing 002A","E01031822","80-84 years","Female",33,36,39,45,44,197
"Worthing 002A","E01031822","85+ years","Female",63,66,56,55,52,292
"Worthing 002B","E01031825","0-4 years","Male",33,31,28,21,25,138
"Worthing 002B","E01031825","5-9 years","Male",31,35,34,32,28,160
"Worthing 002B","E01031825","10-14 years","Male",29,28,33,33,32,155
"Worthing 002B","E01031825","15-19 years","Male",22,19,15,21,19,96
"Worthing 002B","E01031825","20-24 years","Male",30,26,29,29,28,142
"Worthing 002B","E01031825","25-29 years","Male",21,27,30,29,28,135
"Worthing 002B","E01031825","30-34 years","Male",20,17,20,20,24,101
"Worthing 002B","E01031825","35-39 years","Male",47,40,44,49,37,217
"Worthing 002B","E01031825","40-44 years","Male",38,36,35,37,43,189
"Worthing 002B","E01031825","45-49 years","Male",63,60,50,46,43,262
"Worthing 002B","E01031825","50-54 years","Male",56,61,67,61,55,300
"Worthing 002B","E01031825","55-59 years","Male",65,59,58,63,73,318
"Worthing 002B","E01031825","60-64 years","Male",74,72,78,71,76,371
"Worthing 002B","E01031825","65-69 years","Male",80,74,65,78,75,372
"Worthing 002B","E01031825","70-74 years","Male",65,70,70,60,61,326
"Worthing 002B","E01031825","75-79 years","Male",67,58,62,71,63,321
"Worthing 002B","E01031825","80-84 years","Male",33,40,45,49,55,222
"Worthing 002B","E01031825","85+ years","Male",50,49,48,40,36,223
"Worthing 002B","E01031825","0-4 years","Female",31,25,32,36,30,154
"Worthing 002B","E01031825","5-9 years","Female",22,26,25,32,36,141
"Worthing 002B","E01031825","10-14 years","Female",21,19,23,23,23,109
"Worthing 002B","E01031825","15-19 years","Female",25,24,26,21,21,117
"Worthing 002B","E01031825","20-24 years","Female",19,11,13,16,13,72
"Worthing 002B","E01031825","25-29 years","Female",22,20,18,14,16,90
"Worthing 002B","E01031825","30-34 years","Female",30,37,34,28,25,154
"Worthing 002B","E01031825","35-39 years","Female",29,30,35,36,32,162
"Worthing 002B","E01031825","40-44 years","Female",39,33,33,37,44,186
"Worthing 002B","E01031825","45-49 years","Female",65,63,66,60,49,303
"Worthing 002B","E01031825","50-54 years","Female",73,69,66,63,64,335
"Worthing 002B","E01031825","55-59 years","Female",53,56,66,70,70,315
"Worthing 002B","E01031825","60-64 years","Female",75,73,67,74,72,361
"Worthing 002B","E01031825","65-69 years","Female",89,79,77,67,75,387
"Worthing 002B","E01031825","70-74 years","Female",67,74,75,78,78,372
"Worthing 002B","E01031825","75-79 years","Female",61,57,65,60,51,294
"Worthing 002B","E01031825","80-84 years","Female",57,60,57,61,61,296
"Worthing 002B","E01031825","85+ years","Female",53,56,56,56,65,286
"Worthing 002C","E01031826","0-4 years","Male",47,38,39,27,28,179
"Worthing 002C","E01031826","5-9 years","Male",35,39,38,49,47,208
"Worthing 002C","E01031826","10-14 years","Male",46,42,52,44,52,236
"Worthing 002C","E01031826","15-19 years","Male",31,34,30,31,34,160
"Worthing 002C","E01031826","20-24 years","Male",28,26,21,20,21,116
"Worthing 002C","E01031826","25-29 years","Male",32,33,34,27,26,152
"Worthing 002C","E01031826","30-34 years","Male",60,48,48,47,46,249
"Worthing 002C","E01031826","35-39 years","Male",35,40,39,39,35,188
"Worthing 002C","E01031826","40-44 years","Male",50,47,54,68,61,280
"Worthing 002C","E01031826","45-49 years","Male",58,63,54,46,45,266
"Worthing 002C","E01031826","50-54 years","Male",64,60,64,59,52,299
"Worthing 002C","E01031826","55-59 years","Male",30,35,39,41,52,197
"Worthing 002C","E01031826","60-64 years","Male",48,45,44,38,34,209
"Worthing 002C","E01031826","65-69 years","Male",50,38,37,34,39,198
"Worthing 002C","E01031826","70-74 years","Male",19,29,36,39,39,162
"Worthing 002C","E01031826","75-79 years","Male",19,18,18,14,14,83
"Worthing 002C","E01031826","80-84 years","Male",16,20,15,17,14,82
"Worthing 002C","E01031826","85+ years","Male",20,20,21,20,20,101
"Worthing 002C","E01031826","0-4 years","Female",58,57,60,61,58,294
"Worthing 002C","E01031826","5-9 years","Female",26,33,32,46,47,184
"Worthing 002C","E01031826","10-14 years","Female",31,35,37,34,33,170
"Worthing 002C","E01031826","15-19 years","Female",51,49,41,37,31,209
"Worthing 002C","E01031826","20-24 years","Female",26,28,28,26,26,134
"Worthing 002C","E01031826","25-29 years","Female",37,35,32,29,29,162
"Worthing 002C","E01031826","30-34 years","Female",44,44,42,48,38,216
"Worthing 002C","E01031826","35-39 years","Female",49,56,51,53,61,270
"Worthing 002C","E01031826","40-44 years","Female",57,58,64,62,55,296
"Worthing 002C","E01031826","45-49 years","Female",49,48,47,42,45,231
"Worthing 002C","E01031826","50-54 years","Female",69,71,77,79,71,367
"Worthing 002C","E01031826","55-59 years","Female",38,40,39,42,48,207
"Worthing 002C","E01031826","60-64 years","Female",35,31,35,31,35,167
"Worthing 002C","E01031826","65-69 years","Female",56,53,55,50,42,256
"Worthing 002C","E01031826","70-74 years","Female",29,32,37,42,51,191
"Worthing 002C","E01031826","75-79 years","Female",24,26,27,27,25,129
"Worthing 002C","E01031826","80-84 years","Female",25,24,21,22,27,119
"Worthing 002C","E01031826","85+ years","Female",22,24,22,21,23,112
"Worthing 002D","E01031827","0-4 years","Male",47,67,68,72,67,321
"Worthing 002D","E01031827","5-9 years","Male",49,46,48,48,46,237
"Worthing 002D","E01031827","10-14 years","Male",38,46,51,39,35,209
"Worthing 002D","E01031827","15-19 years","Male",35,32,34,40,41,182
"Worthing 002D","E01031827","20-24 years","Male",38,36,35,36,41,186
"Worthing 002D","E01031827","25-29 years","Male",37,37,40,42,46,202
"Worthing 002D","E01031827","30-34 years","Male",41,37,39,40,30,187
"Worthing 002D","E01031827","35-39 years","Male",53,54,49,41,39,236
"Worthing 002D","E01031827","40-44 years","Male",54,66,71,66,75,332
"Worthing 002D","E01031827","45-49 years","Male",35,30,32,31,31,159
"Worthing 002D","E01031827","50-54 years","Male",50,46,49,47,39,231
"Worthing 002D","E01031827","55-59 years","Male",38,41,37,40,45,201
"Worthing 002D","E01031827","60-64 years","Male",39,39,36,31,30,175
"Worthing 002D","E01031827","65-69 years","Male",48,45,53,41,42,229
"Worthing 002D","E01031827","70-74 years","Male",32,34,37,41,44,188
"Worthing 002D","E01031827","75-79 years","Male",31,34,33,37,41,176
"Worthing 002D","E01031827","80-84 years","Male",21,22,25,25,25,118
"Worthing 002D","E01031827","85+ years","Male",8,5,7,4,4,28
"Worthing 002D","E01031827","0-4 years","Female",43,42,42,41,33,201
"Worthing 002D","E01031827","5-9 years","Female",42,48,49,51,51,241
"Worthing 002D","E01031827","10-14 years","Female",41,41,41,46,43,212
"Worthing 002D","E01031827","15-19 years","Female",43,49,45,40,47,224
"Worthing 002D","E01031827","20-24 years","Female",28,36,39,39,41,183
"Worthing 002D","E01031827","25-29 years","Female",37,41,46,46,43,213
"Worthing 002D","E01031827","30-34 years","Female",47,37,35,30,31,180
"Worthing 002D","E01031827","35-39 years","Female",48,54,60,58,46,266
"Worthing 002D","E01031827","40-44 years","Female",43,42,41,44,57,227
"Worthing 002D","E01031827","45-49 years","Female",51,59,49,50,52,261
"Worthing 002D","E01031827","50-54 years","Female",53,58,64,66,57,298
"Worthing 002D","E01031827","55-59 years","Female",60,60,54,59,62,295
"Worthing 002D","E01031827","60-64 years","Female",41,36,46,38,42,203
"Worthing 002D","E01031827","65-69 years","Female",49,50,45,47,46,237
"Worthing 002D","E01031827","70-74 years","Female",40,50,57,57,55,259
"Worthing 002D","E01031827","75-79 years","Female",40,37,30,30,33,170
"Worthing 002D","E01031827","80-84 years","Female",15,15,25,32,30,117
"Worthing 002D","E01031827","85+ years","Female",43,43,40,34,34,194
"Worthing 002E","E01031839","0-4 years","Male",55,54,54,46,48,257
"Worthing 002E","E01031839","5-9 years","Male",85,82,81,71,74,393
"Worthing 002E","E01031839","10-14 years","Male",58,58,62,70,69,317
"Worthing 002E","E01031839","15-19 years","Male",47,46,47,49,52,241
"Worthing 002E","E01031839","20-24 years","Male",25,26,25,27,27,130
"Worthing 002E","E01031839","25-29 years","Male",40,47,42,34,30,193
"Worthing 002E","E01031839","30-34 years","Male",41,40,39,45,51,216
"Worthing 002E","E01031839","35-39 years","Male",53,52,53,48,51,257
"Worthing 002E","E01031839","40-44 years","Male",60,64,60,60,54,298
"Worthing 002E","E01031839","45-49 years","Male",56,50,52,52,54,264
"Worthing 002E","E01031839","50-54 years","Male",56,64,60,60,57,297
"Worthing 002E","E01031839","55-59 years","Male",72,63,66,68,70,339
"Worthing 002E","E01031839","60-64 years","Male",50,49,59,60,66,284
"Worthing 002E","E01031839","65-69 years","Male",48,37,31,31,30,177
"Worthing 002E","E01031839","70-74 years","Male",34,41,42,36,40,193
"Worthing 002E","E01031839","75-79 years","Male",26,28,31,29,23,137
"Worthing 002E","E01031839","80-84 years","Male",17,14,17,17,22,87
"Worthing 002E","E01031839","85+ years","Male",31,29,28,36,33,157
"Worthing 002E","E01031839","0-4 years","Female",50,55,46,43,40,234
"Worthing 002E","E01031839","5-9 years","Female",72,75,77,73,70,367
"Worthing 002E","E01031839","10-14 years","Female",49,46,54,62,71,282
"Worthing 002E","E01031839","15-19 years","Female",42,44,47,44,46,223
"Worthing 002E","E01031839","20-24 years","Female",31,29,29,29,27,145
"Worthing 002E","E01031839","25-29 years","Female",46,46,43,35,29,199
"Worthing 002E","E01031839","30-34 years","Female",63,61,55,59,59,297
"Worthing 002E","E01031839","35-39 years","Female",60,64,70,73,74,341
"Worthing 002E","E01031839","40-44 years","Female",61,62,62,53,55,293
"Worthing 002E","E01031839","45-49 years","Female",67,62,62,61,63,315
"Worthing 002E","E01031839","50-54 years","Female",69,67,63,55,53,307
"Worthing 002E","E01031839","55-59 years","Female",64,66,78,76,79,363
"Worthing 002E","E01031839","60-64 years","Female",45,51,48,46,46,236
"Worthing 002E","E01031839","65-69 years","Female",51,43,46,46,48,234
"Worthing 002E","E01031839","70-74 years","Female",38,37,32,36,39,182
"Worthing 002E","E01031839","75-79 years","Female",37,38,40,30,31,176
"Worthing 002E","E01031839","80-84 years","Female",23,25,31,33,39,151
"Worthing 002E","E01031839","85+ years","Female",36,35,35,37,31,174
"Worthing 003A","E01031792","0-4 years","Male",38,41,39,44,41,203
"Worthing 003A","E01031792","5-9 years","Male",34,29,30,36,39,168
"Worthing 003A","E01031792","10-14 years","Male",35,34,41,37,32,179
"Worthing 003A","E01031792","15-19 years","Male",38,29,22,34,34,157
"Worthing 003A","E01031792","20-24 years","Male",34,37,36,38,36,181
"Worthing 003A","E01031792","25-29 years","Male",23,25,24,27,24,123
"Worthing 003A","E01031792","30-34 years","Male",32,30,42,40,45,189
"Worthing 003A","E01031792","35-39 years","Male",28,31,28,24,30,141
"Worthing 003A","E01031792","40-44 years","Male",43,40,34,28,23,168
"Worthing 003A","E01031792","45-49 years","Male",68,69,70,67,56,330
"Worthing 003A","E01031792","50-54 years","Male",49,56,61,57,64,287
"Worthing 003A","E01031792","55-59 years","Male",45,47,45,52,51,240
"Worthing 003A","E01031792","60-64 years","Male",40,41,41,41,48,211
"Worthing 003A","E01031792","65-69 years","Male",65,53,45,37,31,231
"Worthing 003A","E01031792","70-74 years","Male",34,38,39,44,47,202
"Worthing 003A","E01031792","75-79 years","Male",37,38,38,39,37,189
"Worthing 003A","E01031792","80-84 years","Male",16,22,25,30,29,122
"Worthing 003A","E01031792","85+ years","Male",11,7,11,13,20,62
"Worthing 003A","E01031792","0-4 years","Female",36,39,37,42,40,194
"Worthing 003A","E01031792","5-9 years","Female",53,51,50,44,47,245
"Worthing 003A","E01031792","10-14 years","Female",37,42,42,45,42,208
"Worthing 003A","E01031792","15-19 years","Female",37,35,37,35,33,177
"Worthing 003A","E01031792","20-24 years","Female",24,23,29,26,25,127
"Worthing 003A","E01031792","25-29 years","Female",32,33,30,30,31,156
"Worthing 003A","E01031792","30-34 years","Female",48,43,49,49,47,236
"Worthing 003A","E01031792","35-39 years","Female",37,41,45,45,42,210
"Worthing 003A","E01031792","40-44 years","Female",47,40,39,40,33,199
"Worthing 003A","E01031792","45-49 years","Female",59,56,59,54,56,284
"Worthing 003A","E01031792","50-54 years","Female",48,40,46,51,61,246
"Worthing 003A","E01031792","55-59 years","Female",62,73,60,50,51,296
"Worthing 003A","E01031792","60-64 years","Female",56,59,62,62,57,296
"Worthing 003A","E01031792","65-69 years","Female",54,50,51,48,50,253
"Worthing 003A","E01031792","70-74 years","Female",54,55,56,55,51,271
"Worthing 003A","E01031792","75-79 years","Female",37,38,36,37,41,189
"Worthing 003A","E01031792","80-84 years","Female",30,31,31,36,41,169
"Worthing 003A","E01031792","85+ years","Female",34,25,22,21,21,123
"Worthing 003B","E01031794","0-4 years","Male",20,30,34,34,35,153
"Worthing 003B","E01031794","5-9 years","Male",38,41,45,41,29,194
"Worthing 003B","E01031794","10-14 years","Male",23,28,26,38,49,164
"Worthing 003B","E01031794","15-19 years","Male",24,20,30,29,20,123
"Worthing 003B","E01031794","20-24 years","Male",30,27,27,24,23,131
"Worthing 003B","E01031794","25-29 years","Male",22,26,27,27,27,129
"Worthing 003B","E01031794","30-34 years","Male",31,26,25,24,22,128
"Worthing 003B","E01031794","35-39 years","Male",27,25,28,34,38,152
"Worthing 003B","E01031794","40-44 years","Male",24,25,28,27,19,123
"Worthing 003B","E01031794","45-49 years","Male",34,34,32,35,36,171
"Worthing 003B","E01031794","50-54 years","Male",54,54,49,43,48,248
"Worthing 003B","E01031794","55-59 years","Male",38,37,39,41,44,199
"Worthing 003B","E01031794","60-64 years","Male",39,36,43,47,42,207
"Worthing 003B","E01031794","65-69 years","Male",54,53,44,50,54,255
"Worthing 003B","E01031794","70-74 years","Male",68,77,79,70,66,360
"Worthing 003B","E01031794","75-79 years","Male",51,49,45,48,54,247
"Worthing 003B","E01031794","80-84 years","Male",34,32,29,31,28,154
"Worthing 003B","E01031794","85+ years","Male",21,20,22,23,20,106
"Worthing 003B","E01031794","0-4 years","Female",23,18,21,27,29,118
"Worthing 003B","E01031794","5-9 years","Female",27,25,21,19,17,109
"Worthing 003B","E01031794","10-14 years","Female",23,27,34,37,34,155
"Worthing 003B","E01031794","15-19 years","Female",35,27,28,24,29,143
"Worthing 003B","E01031794","20-24 years","Female",18,19,26,24,20,107
"Worthing 003B","E01031794","25-29 years","Female",20,21,23,25,23,112
"Worthing 003B","E01031794","30-34 years","Female",23,18,19,20,21,101
"Worthing 003B","E01031794","35-39 years","Female",31,36,39,36,37,179
"Worthing 003B","E01031794","40-44 years","Female",41,34,31,30,27,163
"Worthing 003B","E01031794","45-49 years","Female",51,54,53,56,51,265
"Worthing 003B","E01031794","50-54 years","Female",39,46,50,58,54,247
"Worthing 003B","E01031794","55-59 years","Female",29,36,31,31,27,154
"Worthing 003B","E01031794","60-64 years","Female",68,51,54,53,47,273
"Worthing 003B","E01031794","65-69 years","Female",62,68,69,69,72,340
"Worthing 003B","E01031794","70-74 years","Female",64,61,61,57,59,302
"Worthing 003B","E01031794","75-79 years","Female",55,52,54,51,50,262
"Worthing 003B","E01031794","80-84 years","Female",47,48,49,54,54,252
"Worthing 003B","E01031794","85+ years","Female",49,40,39,34,35,197
"Worthing 003C","E01031795","0-4 years","Male",72,62,54,51,51,290
"Worthing 003C","E01031795","5-9 years","Male",106,116,99,90,90,501
"Worthing 003C","E01031795","10-14 years","Male",75,84,87,81,83,410
"Worthing 003C","E01031795","15-19 years","Male",46,48,52,48,49,243
"Worthing 003C","E01031795","20-24 years","Male",39,39,36,40,43,197
"Worthing 003C","E01031795","25-29 years","Male",33,33,25,26,27,144
"Worthing 003C","E01031795","30-34 years","Male",73,59,59,55,60,306
"Worthing 003C","E01031795","35-39 years","Male",72,73,65,69,64,343
"Worthing 003C","E01031795","40-44 years","Male",40,50,55,55,58,258
"Worthing 003C","E01031795","45-49 years","Male",47,45,39,44,45,220
"Worthing 003C","E01031795","50-54 years","Male",65,65,66,59,48,303
"Worthing 003C","E01031795","55-59 years","Male",26,36,41,44,57,204
"Worthing 003C","E01031795","60-64 years","Male",44,42,41,37,27,191
"Worthing 003C","E01031795","65-69 years","Male",34,39,38,41,41,193
"Worthing 003C","E01031795","70-74 years","Male",24,23,30,31,30,138
"Worthing 003C","E01031795","75-79 years","Male",13,11,12,11,16,63
"Worthing 003C","E01031795","80-84 years","Male",3,4,6,5,5,23
"Worthing 003C","E01031795","85+ years","Male",10,6,4,2,1,23
"Worthing 003C","E01031795","0-4 years","Female",74,66,70,75,75,360
"Worthing 003C","E01031795","5-9 years","Female",83,86,84,74,73,400
"Worthing 003C","E01031795","10-14 years","Female",46,60,67,65,71,309
"Worthing 003C","E01031795","15-19 years","Female",42,40,37,38,41,198
"Worthing 003C","E01031795","20-24 years","Female",22,21,26,25,25,119
"Worthing 003C","E01031795","25-29 years","Female",70,61,56,54,49,290
"Worthing 003C","E01031795","30-34 years","Female",99,77,80,78,74,408
"Worthing 003C","E01031795","35-39 years","Female",68,84,86,84,78,400
"Worthing 003C","E01031795","40-44 years","Female",54,52,46,55,67,274
"Worthing 003C","E01031795","45-49 years","Female",64,58,58,51,42,273
"Worthing 003C","E01031795","50-54 years","Female",62,71,71,64,61,329
"Worthing 003C","E01031795","55-59 years","Female",47,53,59,62,59,280
"Worthing 003C","E01031795","60-64 years","Female",45,44,43,46,45,223
"Worthing 003C","E01031795","65-69 years","Female",40,41,52,51,49,233
"Worthing 003C","E01031795","70-74 years","Female",23,27,30,34,42,156
"Worthing 003C","E01031795","75-79 years","Female",18,19,19,20,23,99
"Worthing 003C","E01031795","80-84 years","Female",12,12,11,13,14,62
"Worthing 003C","E01031795","85+ years","Female",21,21,18,15,17,92
"Worthing 003D","E01031818","0-4 years","Male",60,63,64,66,61,314
"Worthing 003D","E01031818","5-9 years","Male",63,75,76,81,79,374
"Worthing 003D","E01031818","10-14 years","Male",83,68,66,61,61,339
"Worthing 003D","E01031818","15-19 years","Male",75,77,71,71,73,367
"Worthing 003D","E01031818","20-24 years","Male",56,51,53,60,59,279
"Worthing 003D","E01031818","25-29 years","Male",82,79,76,71,61,369
"Worthing 003D","E01031818","30-34 years","Male",65,56,65,65,67,318
"Worthing 003D","E01031818","35-39 years","Male",62,59,57,53,48,279
"Worthing 003D","E01031818","40-44 years","Male",53,59,49,50,48,259
"Worthing 003D","E01031818","45-49 years","Male",71,65,69,70,78,353
"Worthing 003D","E01031818","50-54 years","Male",71,66,66,72,61,336
"Worthing 003D","E01031818","55-59 years","Male",64,65,58,54,55,296
"Worthing 003D","E01031818","60-64 years","Male",48,46,52,50,51,247
"Worthing 003D","E01031818","65-69 years","Male",64,58,54,51,43,270
"Worthing 003D","E01031818","70-74 years","Male",33,41,45,52,57,228
"Worthing 003D","E01031818","75-79 years","Male",22,25,28,24,28,127
"Worthing 003D","E01031818","80-84 years","Male",11,10,13,14,13,61
"Worthing 003D","E01031818","85+ years","Male",16,17,15,18,15,81
"Worthing 003D","E01031818","0-4 years","Female",56,51,62,63,54,286
"Worthing 003D","E01031818","5-9 years","Female",88,81,69,69,58,365
"Worthing 003D","E01031818","10-14 years","Female",69,78,84,81,78,390
"Worthing 003D","E01031818","15-19 years","Female",79,69,63,68,64,343
"Worthing 003D","E01031818","20-24 years","Female",66,64,69,61,64,324
"Worthing 003D","E01031818","25-29 years","Female",65,63,65,63,54,310
"Worthing 003D","E01031818","30-34 years","Female",61,55,62,69,63,310
"Worthing 003D","E01031818","35-39 years","Female",86,92,85,64,62,389
"Worthing 003D","E01031818","40-44 years","Female",59,56,56,62,70,303
"Worthing 003D","E01031818","45-49 years","Female",89,82,71,63,60,365
"Worthing 003D","E01031818","50-54 years","Female",83,78,81,79,78,399
"Worthing 003D","E01031818","55-59 years","Female",55,59,69,70,68,321
"Worthing 003D","E01031818","60-64 years","Female",54,53,51,55,66,279
"Worthing 003D","E01031818","65-69 years","Female",83,73,69,61,59,345
"Worthing 003D","E01031818","70-74 years","Female",42,51,48,51,55,247
"Worthing 003D","E01031818","75-79 years","Female",16,22,25,27,26,116
"Worthing 003D","E01031818","80-84 years","Female",6,5,7,7,10,35
"Worthing 003D","E01031818","85+ years","Female",20,19,17,16,16,88
"Worthing 003E","E01031830","0-4 years","Male",39,36,45,41,38,199
"Worthing 003E","E01031830","5-9 years","Male",65,61,63,59,57,305
"Worthing 003E","E01031830","10-14 years","Male",50,48,52,50,52,252
"Worthing 003E","E01031830","15-19 years","Male",46,45,41,43,46,221
"Worthing 003E","E01031830","20-24 years","Male",30,30,27,28,28,143
"Worthing 003E","E01031830","25-29 years","Male",26,30,33,35,30,154
"Worthing 003E","E01031830","30-34 years","Male",50,41,45,44,44,224
"Worthing 003E","E01031830","35-39 years","Male",47,42,41,49,48,227
"Worthing 003E","E01031830","40-44 years","Male",53,53,47,43,33,229
"Worthing 003E","E01031830","45-49 years","Male",53,46,39,38,46,222
"Worthing 003E","E01031830","50-54 years","Male",59,64,70,71,66,330
"Worthing 003E","E01031830","55-59 years","Male",56,50,51,52,58,267
"Worthing 003E","E01031830","60-64 years","Male",39,42,46,55,52,234
"Worthing 003E","E01031830","65-69 years","Male",37,35,31,28,30,161
"Worthing 003E","E01031830","70-74 years","Male",44,39,50,40,37,210
"Worthing 003E","E01031830","75-79 years","Male",38,35,32,38,42,185
"Worthing 003E","E01031830","80-84 years","Male",13,14,13,17,15,72
"Worthing 003E","E01031830","85+ years","Male",20,18,16,14,14,82
"Worthing 003E","E01031830","0-4 years","Female",59,60,61,53,56,289
"Worthing 003E","E01031830","5-9 years","Female",67,66,73,72,71,349
"Worthing 003E","E01031830","10-14 years","Female",38,46,49,51,49,233
"Worthing 003E","E01031830","15-19 years","Female",45,45,41,47,48,226
"Worthing 003E","E01031830","20-24 years","Female",23,23,23,24,29,122
"Worthing 003E","E01031830","25-29 years","Female",41,36,41,40,43,201
"Worthing 003E","E01031830","30-34 years","Female",47,44,50,46,44,231
"Worthing 003E","E01031830","35-39 years","Female",64,63,58,54,56,295
"Worthing 003E","E01031830","40-44 years","Female",59,59,61,58,56,293
"Worthing 003E","E01031830","45-49 years","Female",52,48,41,36,40,217
"Worthing 003E","E01031830","50-54 years","Female",56,50,53,50,48,257
"Worthing 003E","E01031830","55-59 years","Female",44,48,59,70,70,291
"Worthing 003E","E01031830","60-64 years","Female",42,46,44,46,43,221
"Worthing 003E","E01031830","65-69 years","Female",56,46,45,39,39,225
"Worthing 003E","E01031830","70-74 years","Female",47,55,48,46,47,243
"Worthing 003E","E01031830","75-79 years","Female",28,29,34,42,41,174
"Worthing 003E","E01031830","80-84 years","Female",25,24,26,27,23,125
"Worthing 003E","E01031830","85+ years","Female",35,37,31,35,35,173
"Worthing 004A","E01031778","0-4 years","Male",53,47,34,34,29,197
"Worthing 004A","E01031778","5-9 years","Male",50,47,42,36,40,215
"Worthing 004A","E01031778","10-14 years","Male",60,60,66,74,66,326
"Worthing 004A","E01031778","15-19 years","Male",47,44,48,57,58,254
"Worthing 004A","E01031778","20-24 years","Male",43,28,25,25,25,146
"Worthing 004A","E01031778","25-29 years","Male",42,47,37,34,33,193
"Worthing 004A","E01031778","30-34 years","Male",48,42,43,42,37,212
"Worthing 004A","E01031778","35-39 years","Male",50,45,43,43,51,232
"Worthing 004A","E01031778","40-44 years","Male",52,43,45,44,41,225
"Worthing 004A","E01031778","45-49 years","Male",60,64,68,74,69,335
"Worthing 004A","E01031778","50-54 years","Male",84,73,72,75,71,375
"Worthing 004A","E01031778","55-59 years","Male",56,60,53,55,66,290
"Worthing 004A","E01031778","60-64 years","Male",49,52,54,51,48,254
"Worthing 004A","E01031778","65-69 years","Male",36,35,39,43,40,193
"Worthing 004A","E01031778","70-74 years","Male",28,37,33,27,28,153
"Worthing 004A","E01031778","75-79 years","Male",31,21,26,27,31,136
"Worthing 004A","E01031778","80-84 years","Male",15,23,20,16,17,91
"Worthing 004A","E01031778","85+ years","Male",26,27,25,23,15,116
"Worthing 004A","E01031778","0-4 years","Female",38,37,42,34,33,184
"Worthing 004A","E01031778","5-9 years","Female",63,54,63,67,59,306
"Worthing 004A","E01031778","10-14 years","Female",36,36,42,39,53,206
"Worthing 004A","E01031778","15-19 years","Female",39,47,42,43,35,206
"Worthing 004A","E01031778","20-24 years","Female",51,40,42,51,46,230
"Worthing 004A","E01031778","25-29 years","Female",61,52,42,37,39,231
"Worthing 004A","E01031778","30-34 years","Female",45,43,46,43,34,211
"Worthing 004A","E01031778","35-39 years","Female",55,48,47,52,64,266
"Worthing 004A","E01031778","40-44 years","Female",52,58,61,63,59,293
"Worthing 004A","E01031778","45-49 years","Female",69,66,77,70,67,349
"Worthing 004A","E01031778","50-54 years","Female",48,51,53,71,71,294
"Worthing 004A","E01031778","55-59 years","Female",55,53,46,46,49,249
"Worthing 004A","E01031778","60-64 years","Female",35,34,35,35,37,176
"Worthing 004A","E01031778","65-69 years","Female",42,45,32,37,40,196
"Worthing 004A","E01031778","70-74 years","Female",47,52,60,51,48,258
"Worthing 004A","E01031778","75-79 years","Female",36,28,35,36,37,172
"Worthing 004A","E01031778","80-84 years","Female",19,31,30,27,23,130
"Worthing 004A","E01031778","85+ years","Female",27,19,17,16,12,91
"Worthing 004B","E01031797","0-4 years","Male",47,46,44,33,21,191
"Worthing 004B","E01031797","5-9 years","Male",39,45,48,53,55,240
"Worthing 004B","E01031797","10-14 years","Male",38,38,39,43,43,201
"Worthing 004B","E01031797","15-19 years","Male",40,38,41,40,37,196
"Worthing 004B","E01031797","20-24 years","Male",44,37,34,27,33,175
"Worthing 004B","E01031797","25-29 years","Male",38,31,38,38,33,178
"Worthing 004B","E01031797","30-34 years","Male",29,24,22,21,24,120
"Worthing 004B","E01031797","35-39 years","Male",37,41,44,46,38,206
"Worthing 004B","E01031797","40-44 years","Male",44,33,28,26,27,158
"Worthing 004B","E01031797","45-49 years","Male",66,68,65,64,60,323
"Worthing 004B","E01031797","50-54 years","Male",57,61,61,58,61,298
"Worthing 004B","E01031797","55-59 years","Male",52,53,48,54,46,253
"Worthing 004B","E01031797","60-64 years","Male",41,41,41,38,46,207
"Worthing 004B","E01031797","65-69 years","Male",35,30,29,29,34,157
"Worthing 004B","E01031797","70-74 years","Male",29,38,46,44,36,193
"Worthing 004B","E01031797","75-79 years","Male",15,17,19,19,14,84
"Worthing 004B","E01031797","80-84 years","Male",23,17,19,18,25,102
"Worthing 004B","E01031797","85+ years","Male",10,11,9,20,20,70
"Worthing 004B","E01031797","0-4 years","Female",34,31,31,30,26,152
"Worthing 004B","E01031797","5-9 years","Female",41,48,52,49,44,234
"Worthing 004B","E01031797","10-14 years","Female",41,34,38,45,40,198
"Worthing 004B","E01031797","15-19 years","Female",39,45,41,36,37,198
"Worthing 004B","E01031797","20-24 years","Female",29,31,32,30,32,154
"Worthing 004B","E01031797","25-29 years","Female",29,27,26,22,21,125
"Worthing 004B","E01031797","30-34 years","Female",35,37,32,27,30,161
"Worthing 004B","E01031797","35-39 years","Female",43,48,55,46,38,230
"Worthing 004B","E01031797","40-44 years","Female",65,63,47,61,65,301
"Worthing 004B","E01031797","45-49 years","Female",53,54,63,62,60,292
"Worthing 004B","E01031797","50-54 years","Female",53,45,51,54,53,256
"Worthing 004B","E01031797","55-59 years","Female",58,66,53,55,57,289
"Worthing 004B","E01031797","60-64 years","Female",39,47,51,55,53,245
"Worthing 004B","E01031797","65-69 years","Female",39,29,24,21,20,133
"Worthing 004B","E01031797","70-74 years","Female",41,49,51,47,46,234
"Worthing 004B","E01031797","75-79 years","Female",22,22,25,29,29,127
"Worthing 004B","E01031797","80-84 years","Female",14,19,15,13,15,76
"Worthing 004B","E01031797","85+ years","Female",30,26,28,30,27,141
"Worthing 004C","E01031800","0-4 years","Male",43,43,43,40,42,211
"Worthing 004C","E01031800","5-9 years","Male",57,58,65,57,51,288
"Worthing 004C","E01031800","10-14 years","Male",58,56,66,73,72,325
"Worthing 004C","E01031800","15-19 years","Male",75,68,59,42,46,290
"Worthing 004C","E01031800","20-24 years","Male",31,40,34,46,42,193
"Worthing 004C","E01031800","25-29 years","Male",18,15,20,19,15,87
"Worthing 004C","E01031800","30-34 years","Male",30,28,30,31,26,145
"Worthing 004C","E01031800","35-39 years","Male",48,47,41,52,55,243
"Worthing 004C","E01031800","40-44 years","Male",60,65,66,57,50,298
"Worthing 004C","E01031800","45-49 years","Male",74,73,74,74,69,364
"Worthing 004C","E01031800","50-54 years","Male",61,67,63,63,69,323
"Worthing 004C","E01031800","55-59 years","Male",41,38,44,44,49,216
"Worthing 004C","E01031800","60-64 years","Male",46,47,42,46,49,230
"Worthing 004C","E01031800","65-69 years","Male",37,35,36,33,33,174
"Worthing 004C","E01031800","70-74 years","Male",27,33,38,39,40,177
"Worthing 004C","E01031800","75-79 years","Male",28,25,22,24,32,131
"Worthing 004C","E01031800","80-84 years","Male",21,20,22,22,17,102
"Worthing 004C","E01031800","85+ years","Male",17,18,20,19,18,92
"Worthing 004C","E01031800","0-4 years","Female",37,39,42,39,36,193
"Worthing 004C","E01031800","5-9 years","Female",58,55,61,63,65,302
"Worthing 004C","E01031800","10-14 years","Female",52,59,69,64,67,311
"Worthing 004C","E01031800","15-19 years","Female",60,45,56,61,63,285
"Worthing 004C","E01031800","20-24 years","Female",20,26,24,24,28,122
"Worthing 004C","E01031800","25-29 years","Female",24,26,27,20,21,118
"Worthing 004C","E01031800","30-34 years","Female",39,33,40,40,30,182
"Worthing 004C","E01031800","35-39 years","Female",65,69,68,49,50,301
"Worthing 004C","E01031800","40-44 years","Female",72,65,65,68,62,332
"Worthing 004C","E01031800","45-49 years","Female",73,71,81,78,83,386
"Worthing 004C","E01031800","50-54 years","Female",63,65,61,61,66,316
"Worthing 004C","E01031800","55-59 years","Female",69,74,70,69,74,356
"Worthing 004C","E01031800","60-64 years","Female",32,35,37,36,40,180
"Worthing 004C","E01031800","65-69 years","Female",50,46,39,42,40,217
"Worthing 004C","E01031800","70-74 years","Female",27,31,33,37,35,163
"Worthing 004C","E01031800","75-79 years","Female",38,29,27,28,31,153
"Worthing 004C","E01031800","80-84 years","Female",23,36,44,43,40,186
"Worthing 004C","E01031800","85+ years","Female",32,25,26,30,29,142
"Worthing 004D","E01031823","0-4 years","Male",43,38,43,40,40,204
"Worthing 004D","E01031823","5-9 years","Male",63,58,59,55,57,292
"Worthing 004D","E01031823","10-14 years","Male",49,58,68,79,75,329
"Worthing 004D","E01031823","15-19 years","Male",52,41,41,43,44,221
"Worthing 004D","E01031823","20-24 years","Male",32,33,35,34,31,165
"Worthing 004D","E01031823","25-29 years","Male",25,22,21,21,26,115
"Worthing 004D","E01031823","30-34 years","Male",24,24,21,19,16,104
"Worthing 004D","E01031823","35-39 years","Male",31,20,24,21,24,120
"Worthing 004D","E01031823","40-44 years","Male",69,75,62,58,53,317
"Worthing 004D","E01031823","45-49 years","Male",69,71,73,74,71,358
"Worthing 004D","E01031823","50-54 years","Male",69,72,74,74,71,360
"Worthing 004D","E01031823","55-59 years","Male",56,57,55,53,64,285
"Worthing 004D","E01031823","60-64 years","Male",52,54,58,60,53,277
"Worthing 004D","E01031823","65-69 years","Male",70,60,56,54,49,289
"Worthing 004D","E01031823","70-74 years","Male",30,40,51,56,62,239
"Worthing 004D","E01031823","75-79 years","Male",29,30,29,22,20,130
"Worthing 004D","E01031823","80-84 years","Male",28,24,24,30,31,137
"Worthing 004D","E01031823","85+ years","Male",20,23,19,17,17,96
"Worthing 004D","E01031823","0-4 years","Female",37,39,32,29,20,157
"Worthing 004D","E01031823","5-9 years","Female",47,45,50,48,45,235
"Worthing 004D","E01031823","10-14 years","Female",65,56,56,53,63,293
"Worthing 004D","E01031823","15-19 years","Female",56,56,61,51,53,277
"Worthing 004D","E01031823","20-24 years","Female",33,28,26,28,27,142
"Worthing 004D","E01031823","25-29 years","Female",21,25,27,30,27,130
"Worthing 004D","E01031823","30-34 years","Female",27,25,27,20,18,117
"Worthing 004D","E01031823","35-39 years","Female",46,49,47,54,48,244
"Worthing 004D","E01031823","40-44 years","Female",61,52,54,44,50,261
"Worthing 004D","E01031823","45-49 years","Female",83,85,73,68,65,374
"Worthing 004D","E01031823","50-54 years","Female",59,54,61,74,73,321
"Worthing 004D","E01031823","55-59 years","Female",63,73,73,62,66,337
"Worthing 004D","E01031823","60-64 years","Female",57,56,52,55,57,277
"Worthing 004D","E01031823","65-69 years","Female",53,58,67,69,62,309
"Worthing 004D","E01031823","70-74 years","Female",22,20,22,24,24,112
"Worthing 004D","E01031823","75-79 years","Female",24,25,24,22,21,116
"Worthing 004D","E01031823","80-84 years","Female",29,23,21,24,24,121
"Worthing 004D","E01031823","85+ years","Female",25,30,30,30,39,154
"Worthing 004E","E01031824","0-4 years","Male",27,18,15,13,10,83
"Worthing 004E","E01031824","5-9 years","Male",40,41,43,40,39,203
"Worthing 004E","E01031824","10-14 years","Male",49,47,45,53,54,248
"Worthing 004E","E01031824","15-19 years","Male",64,64,58,52,50,288
"Worthing 004E","E01031824","20-24 years","Male",19,18,18,19,22,96
"Worthing 004E","E01031824","25-29 years","Male",35,31,25,24,23,138
"Worthing 004E","E01031824","30-34 years","Male",21,24,20,24,24,113
"Worthing 004E","E01031824","35-39 years","Male",19,23,22,22,20,106
"Worthing 004E","E01031824","40-44 years","Male",42,37,40,36,40,195
"Worthing 004E","E01031824","45-49 years","Male",70,77,62,62,60,331
"Worthing 004E","E01031824","50-54 years","Male",62,56,63,64,68,313
"Worthing 004E","E01031824","55-59 years","Male",46,44,40,44,46,220
"Worthing 004E","E01031824","60-64 years","Male",39,38,45,46,40,208
"Worthing 004E","E01031824","65-69 years","Male",34,33,28,27,29,151
"Worthing 004E","E01031824","70-74 years","Male",39,41,42,38,36,196
"Worthing 004E","E01031824","75-79 years","Male",20,18,18,23,25,104
"Worthing 004E","E01031824","80-84 years","Male",12,14,17,18,18,79
"Worthing 004E","E01031824","85+ years","Male",7,10,11,11,13,52
"Worthing 004E","E01031824","0-4 years","Female",20,21,14,19,20,94
"Worthing 004E","E01031824","5-9 years","Female",39,36,34,35,35,179
"Worthing 004E","E01031824","10-14 years","Female",59,65,64,55,58,301
"Worthing 004E","E01031824","15-19 years","Female",43,43,35,47,48,216
"Worthing 004E","E01031824","20-24 years","Female",26,27,27,27,25,132
"Worthing 004E","E01031824","25-29 years","Female",26,26,29,32,32,145
"Worthing 004E","E01031824","30-34 years","Female",14,13,10,12,12,61
"Worthing 004E","E01031824","35-39 years","Female",35,31,31,32,35,164
"Worthing 004E","E01031824","40-44 years","Female",54,55,46,34,34,223
"Worthing 004E","E01031824","45-49 years","Female",54,54,60,65,61,294
"Worthing 004E","E01031824","50-54 years","Female",73,68,60,64,64,329
"Worthing 004E","E01031824","55-59 years","Female",45,49,55,55,62,266
"Worthing 004E","E01031824","60-64 years","Female",35,37,39,39,32,182
"Worthing 004E","E01031824","65-69 years","Female",49,41,41,35,32,198
"Worthing 004E","E01031824","70-74 years","Female",36,42,41,36,43,198
"Worthing 004E","E01031824","75-79 years","Female",21,22,22,30,26,121
"Worthing 004E","E01031824","80-84 years","Female",18,19,23,23,27,110
"Worthing 004E","E01031824","85+ years","Female",12,12,13,16,17,70
"Worthing 005A","E01031776","0-4 years","Male",56,55,55,55,51,272
"Worthing 005A","E01031776","5-9 years","Male",79,80,64,65,58,346
"Worthing 005A","E01031776","10-14 years","Male",49,56,62,54,73,294
"Worthing 005A","E01031776","15-19 years","Male",40,38,34,38,33,183
"Worthing 005A","E01031776","20-24 years","Male",28,28,27,29,38,150
"Worthing 005A","E01031776","25-29 years","Male",38,33,36,41,38,186
"Worthing 005A","E01031776","30-34 years","Male",51,57,57,44,44,253
"Worthing 005A","E01031776","35-39 years","Male",82,63,57,58,54,314
"Worthing 005A","E01031776","40-44 years","Male",73,89,85,67,69,383
"Worthing 005A","E01031776","45-49 years","Male",61,64,65,75,68,333
"Worthing 005A","E01031776","50-54 years","Male",53,56,51,50,54,264
"Worthing 005A","E01031776","55-59 years","Male",49,43,47,42,46,227
"Worthing 005A","E01031776","60-64 years","Male",28,31,35,36,35,165
"Worthing 005A","E01031776","65-69 years","Male",33,37,29,24,25,148
"Worthing 005A","E01031776","70-74 years","Male",19,20,28,30,29,126
"Worthing 005A","E01031776","75-79 years","Male",19,20,15,18,18,90
"Worthing 005A","E01031776","80-84 years","Male",12,10,13,12,9,56
"Worthing 005A","E01031776","85+ years","Male",8,11,7,11,13,50
"Worthing 005A","E01031776","0-4 years","Female",56,48,42,39,35,220
"Worthing 005A","E01031776","5-9 years","Female",71,75,68,55,45,314
"Worthing 005A","E01031776","10-14 years","Female",44,49,53,51,60,257
"Worthing 005A","E01031776","15-19 years","Female",55,46,46,53,48,248
"Worthing 005A","E01031776","20-24 years","Female",36,38,38,38,33,183
"Worthing 005A","E01031776","25-29 years","Female",72,72,82,75,68,369
"Worthing 005A","E01031776","30-34 years","Female",80,73,63,58,65,339
"Worthing 005A","E01031776","35-39 years","Female",79,79,75,70,69,372
"Worthing 005A","E01031776","40-44 years","Female",76,72,68,68,64,348
"Worthing 005A","E01031776","45-49 years","Female",84,82,83,81,91,421
"Worthing 005A","E01031776","50-54 years","Female",72,73,83,88,74,390
"Worthing 005A","E01031776","55-59 years","Female",44,49,50,52,63,258
"Worthing 005A","E01031776","60-64 years","Female",31,29,31,34,34,159
"Worthing 005A","E01031776","65-69 years","Female",42,42,36,28,23,171
"Worthing 005A","E01031776","70-74 years","Female",26,26,33,30,32,147
"Worthing 005A","E01031776","75-79 years","Female",29,28,29,29,25,140
"Worthing 005A","E01031776","80-84 years","Female",12,15,10,18,24,79
"Worthing 005A","E01031776","85+ years","Female",25,21,27,25,23,121
"Worthing 005B","E01031777","0-4 years","Male",48,56,65,61,64,294
"Worthing 005B","E01031777","5-9 years","Male",68,63,60,66,58,315
"Worthing 005B","E01031777","10-14 years","Male",42,43,45,46,53,229
"Worthing 005B","E01031777","15-19 years","Male",57,51,40,40,43,231
"Worthing 005B","E01031777","20-24 years","Male",44,48,51,53,44,240
"Worthing 005B","E01031777","25-29 years","Male",53,50,49,43,41,236
"Worthing 005B","E01031777","30-34 years","Male",57,58,49,50,43,257
"Worthing 005B","E01031777","35-39 years","Male",66,61,66,59,63,315
"Worthing 005B","E01031777","40-44 years","Male",69,63,51,54,56,293
"Worthing 005B","E01031777","45-49 years","Male",69,59,57,57,65,307
"Worthing 005B","E01031777","50-54 years","Male",46,54,52,51,46,249
"Worthing 005B","E01031777","55-59 years","Male",61,50,57,61,63,292
"Worthing 005B","E01031777","60-64 years","Male",35,43,41,45,46,210
"Worthing 005B","E01031777","65-69 years","Male",36,36,41,31,30,174
"Worthing 005B","E01031777","70-74 years","Male",29,28,27,35,31,150
"Worthing 005B","E01031777","75-79 years","Male",26,30,25,21,20,122
"Worthing 005B","E01031777","80-84 years","Male",11,10,10,13,14,58
"Worthing 005B","E01031777","85+ years","Male",13,13,19,13,13,71
"Worthing 005B","E01031777","0-4 years","Female",55,52,44,49,55,255
"Worthing 005B","E01031777","5-9 years","Female",61,56,54,57,50,278
"Worthing 005B","E01031777","10-14 years","Female",48,43,43,32,40,206
"Worthing 005B","E01031777","15-19 years","Female",56,47,43,45,41,232
"Worthing 005B","E01031777","20-24 years","Female",36,30,31,29,31,157
"Worthing 005B","E01031777","25-29 years","Female",54,61,57,43,41,256
"Worthing 005B","E01031777","30-34 years","Female",50,49,50,49,50,248
"Worthing 005B","E01031777","35-39 years","Female",61,59,65,59,60,304
"Worthing 005B","E01031777","40-44 years","Female",62,70,71,70,69,342
"Worthing 005B","E01031777","45-49 years","Female",73,71,64,71,68,347
"Worthing 005B","E01031777","50-54 years","Female",71,71,73,68,60,343
"Worthing 005B","E01031777","55-59 years","Female",50,54,55,60,63,282
"Worthing 005B","E01031777","60-64 years","Female",28,28,32,33,37,158
"Worthing 005B","E01031777","65-69 years","Female",45,40,39,33,31,188
"Worthing 005B","E01031777","70-74 years","Female",39,38,35,36,41,189
"Worthing 005B","E01031777","75-79 years","Female",22,26,33,39,37,157
"Worthing 005B","E01031777","80-84 years","Female",38,39,40,34,22,173
"Worthing 005B","E01031777","85+ years","Female",22,20,21,26,33,122
"Worthing 005C","E01031780","0-4 years","Male",51,51,43,36,28,209
"Worthing 005C","E01031780","5-9 years","Male",51,47,47,50,47,242
"Worthing 005C","E01031780","10-14 years","Male",71,71,63,61,55,321
"Worthing 005C","E01031780","15-19 years","Male",75,74,78,81,79,387
"Worthing 005C","E01031780","20-24 years","Male",47,44,38,35,42,206
"Worthing 005C","E01031780","25-29 years","Male",54,56,57,61,54,282
"Worthing 005C","E01031780","30-34 years","Male",32,30,27,28,27,144
"Worthing 005C","E01031780","35-39 years","Male",55,56,49,48,43,251
"Worthing 005C","E01031780","40-44 years","Male",56,54,52,52,48,262
"Worthing 005C","E01031780","45-49 years","Male",63,58,60,59,60,300
"Worthing 005C","E01031780","50-54 years","Male",69,72,70,64,62,337
"Worthing 005C","E01031780","55-59 years","Male",40,48,53,61,64,266
"Worthing 005C","E01031780","60-64 years","Male",37,42,40,37,39,195
"Worthing 005C","E01031780","65-69 years","Male",46,36,33,31,38,184
"Worthing 005C","E01031780","70-74 years","Male",13,17,23,27,27,107
"Worthing 005C","E01031780","75-79 years","Male",13,10,12,11,10,56
"Worthing 005C","E01031780","80-84 years","Male",14,13,15,13,13,68
"Worthing 005C","E01031780","85+ years","Male",9,11,11,9,5,45
"Worthing 005C","E01031780","0-4 years","Female",42,37,34,35,33,181
"Worthing 005C","E01031780","5-9 years","Female",67,60,49,51,57,284
"Worthing 005C","E01031780","10-14 years","Female",53,56,64,72,68,313
"Worthing 005C","E01031780","15-19 years","Female",49,44,43,35,36,207
"Worthing 005C","E01031780","20-24 years","Female",41,45,37,43,36,202
"Worthing 005C","E01031780","25-29 years","Female",32,37,41,33,34,177
"Worthing 005C","E01031780","30-34 years","Female",38,33,31,30,28,160
"Worthing 005C","E01031780","35-39 years","Female",52,55,59,61,55,282
"Worthing 005C","E01031780","40-44 years","Female",71,69,62,62,65,329
"Worthing 005C","E01031780","45-49 years","Female",79,83,83,71,65,381
"Worthing 005C","E01031780","50-54 years","Female",62,65,64,62,73,326
"Worthing 005C","E01031780","55-59 years","Female",66,62,59,58,55,300
"Worthing 005C","E01031780","60-64 years","Female",30,36,42,43,47,198
"Worthing 005C","E01031780","65-69 years","Female",33,34,30,35,32,164
"Worthing 005C","E01031780","70-74 years","Female",37,31,35,30,24,157
"Worthing 005C","E01031780","75-79 years","Female",13,17,12,13,17,72
"Worthing 005C","E01031780","80-84 years","Female",26,23,21,20,15,105
"Worthing 005C","E01031780","85+ years","Female",10,12,21,21,22,86
"Worthing 005D","E01031781","0-4 years","Male",60,56,52,53,45,266
"Worthing 005D","E01031781","5-9 years","Male",70,71,60,64,69,334
"Worthing 005D","E01031781","10-14 years","Male",52,48,60,51,52,263
"Worthing 005D","E01031781","15-19 years","Male",53,52,51,51,39,246
"Worthing 005D","E01031781","20-24 years","Male",38,37,40,43,44,202
"Worthing 005D","E01031781","25-29 years","Male",43,41,37,35,41,197
"Worthing 005D","E01031781","30-34 years","Male",61,63,56,56,54,290
"Worthing 005D","E01031781","35-39 years","Male",53,48,52,60,50,263
"Worthing 005D","E01031781","40-44 years","Male",58,58,59,62,54,291
"Worthing 005D","E01031781","45-49 years","Male",59,49,59,53,57,277
"Worthing 005D","E01031781","50-54 years","Male",98,96,81,71,69,415
"Worthing 005D","E01031781","55-59 years","Male",48,53,59,69,71,300
"Worthing 005D","E01031781","60-64 years","Male",36,42,48,44,43,213
"Worthing 005D","E01031781","65-69 years","Male",37,33,34,44,46,194
"Worthing 005D","E01031781","70-74 years","Male",24,30,25,23,30,132
"Worthing 005D","E01031781","75-79 years","Male",21,20,20,20,19,100
"Worthing 005D","E01031781","80-84 years","Male",16,12,10,13,9,60
"Worthing 005D","E01031781","85+ years","Male",11,10,14,17,16,68
"Worthing 005D","E01031781","0-4 years","Female",53,53,67,70,58,301
"Worthing 005D","E01031781","5-9 years","Female",59,65,75,58,70,327
"Worthing 005D","E01031781","10-14 years","Female",62,61,56,59,60,298
"Worthing 005D","E01031781","15-19 years","Female",54,47,36,40,46,223
"Worthing 005D","E01031781","20-24 years","Female",32,31,27,31,31,152
"Worthing 005D","E01031781","25-29 years","Female",47,53,48,42,43,233
"Worthing 005D","E01031781","30-34 years","Female",73,68,67,60,50,318
"Worthing 005D","E01031781","35-39 years","Female",57,49,69,62,63,300
"Worthing 005D","E01031781","40-44 years","Female",65,63,59,61,68,316
"Worthing 005D","E01031781","45-49 years","Female",82,76,73,67,70,368
"Worthing 005D","E01031781","50-54 years","Female",76,79,75,77,68,375
"Worthing 005D","E01031781","55-59 years","Female",40,42,43,49,59,233
"Worthing 005D","E01031781","60-64 years","Female",36,41,46,41,40,204
"Worthing 005D","E01031781","65-69 years","Female",44,36,38,33,33,184
"Worthing 005D","E01031781","70-74 years","Female",33,42,46,44,47,212
"Worthing 005D","E01031781","75-79 years","Female",31,34,28,29,39,161
"Worthing 005D","E01031781","80-84 years","Female",10,10,8,13,11,52
"Worthing 005D","E01031781","85+ years","Female",25,19,25,20,17,106
"Worthing 005E","E01031798","0-4 years","Male",36,33,32,37,32,170
"Worthing 005E","E01031798","5-9 years","Male",65,62,65,64,63,319
"Worthing 005E","E01031798","10-14 years","Male",58,69,72,66,68,333
"Worthing 005E","E01031798","15-19 years","Male",56,50,43,47,52,248
"Worthing 005E","E01031798","20-24 years","Male",41,36,34,33,34,178
"Worthing 005E","E01031798","25-29 years","Male",37,36,26,26,27,152
"Worthing 005E","E01031798","30-34 years","Male",50,59,59,50,41,259
"Worthing 005E","E01031798","35-39 years","Male",55,62,60,57,63,297
"Worthing 005E","E01031798","40-44 years","Male",62,63,60,67,65,317
"Worthing 005E","E01031798","45-49 years","Male",84,88,71,64,66,373
"Worthing 005E","E01031798","50-54 years","Male",65,56,64,70,72,327
"Worthing 005E","E01031798","55-59 years","Male",70,66,73,68,66,343
"Worthing 005E","E01031798","60-64 years","Male",39,49,46,51,54,239
"Worthing 005E","E01031798","65-69 years","Male",33,27,30,33,31,154
"Worthing 005E","E01031798","70-74 years","Male",21,26,24,31,40,142
"Worthing 005E","E01031798","75-79 years","Male",31,28,23,17,13,112
"Worthing 005E","E01031798","80-84 years","Male",5,4,8,9,9,35
"Worthing 005E","E01031798","85+ years","Male",18,13,9,9,8,57
"Worthing 005E","E01031798","0-4 years","Female",42,37,38,32,31,180
"Worthing 005E","E01031798","5-9 years","Female",39,38,35,38,35,185
"Worthing 005E","E01031798","10-14 years","Female",36,34,42,37,33,182
"Worthing 005E","E01031798","15-19 years","Female",42,43,40,38,45,208
"Worthing 005E","E01031798","20-24 years","Female",54,49,48,37,36,224
"Worthing 005E","E01031798","25-29 years","Female",51,49,42,41,34,217
"Worthing 005E","E01031798","30-34 years","Female",46,56,47,50,47,246
"Worthing 005E","E01031798","35-39 years","Female",60,65,73,69,64,331
"Worthing 005E","E01031798","40-44 years","Female",72,65,74,58,55,324
"Worthing 005E","E01031798","45-49 years","Female",62,66,65,66,75,334
"Worthing 005E","E01031798","50-54 years","Female",70,72,69,64,63,338
"Worthing 005E","E01031798","55-59 years","Female",60,59,50,54,51,274
"Worthing 005E","E01031798","60-64 years","Female",59,57,62,69,69,316
"Worthing 005E","E01031798","65-69 years","Female",32,34,35,34,39,174
"Worthing 005E","E01031798","70-74 years","Female",19,19,21,20,22,101
"Worthing 005E","E01031798","75-79 years","Female",16,12,13,22,20,83
"Worthing 005E","E01031798","80-84 years","Female",13,15,16,14,12,70
"Worthing 005E","E01031798","85+ years","Female",13,14,13,11,14,65
"Worthing 006A","E01031783","0-4 years","Male",51,46,38,34,33,202
"Worthing 006A","E01031783","5-9 years","Male",70,67,69,73,64,343
"Worthing 006A","E01031783","10-14 years","Male",62,58,54,63,66,303
"Worthing 006A","E01031783","15-19 years","Male",53,56,51,53,48,261
"Worthing 006A","E01031783","20-24 years","Male",35,33,30,31,30,159
"Worthing 006A","E01031783","25-29 years","Male",53,54,49,38,38,232
"Worthing 006A","E01031783","30-34 years","Male",39,40,36,38,35,188
"Worthing 006A","E01031783","35-39 years","Male",50,52,59,66,59,286
"Worthing 006A","E01031783","40-44 years","Male",47,46,41,48,61,243
"Worthing 006A","E01031783","45-49 years","Male",72,68,60,51,45,296
"Worthing 006A","E01031783","50-54 years","Male",49,55,61,65,61,291
"Worthing 006A","E01031783","55-59 years","Male",53,53,54,54,57,271
"Worthing 006A","E01031783","60-64 years","Male",32,32,39,41,43,187
"Worthing 006A","E01031783","65-69 years","Male",29,38,37,40,40,184
"Worthing 006A","E01031783","70-74 years","Male",22,22,19,18,15,96
"Worthing 006A","E01031783","75-79 years","Male",19,14,26,26,25,110
"Worthing 006A","E01031783","80-84 years","Male",16,17,15,13,12,73
"Worthing 006A","E01031783","85+ years","Male",20,18,20,15,15,88
"Worthing 006A","E01031783","0-4 years","Female",56,69,71,59,58,313
"Worthing 006A","E01031783","5-9 years","Female",61,51,54,52,63,281
"Worthing 006A","E01031783","10-14 years","Female",57,62,61,69,64,313
"Worthing 006A","E01031783","15-19 years","Female",50,48,50,51,53,252
"Worthing 006A","E01031783","20-24 years","Female",34,34,35,37,33,173
"Worthing 006A","E01031783","25-29 years","Female",44,40,39,36,35,194
"Worthing 006A","E01031783","30-34 years","Female",59,60,51,59,55,284
"Worthing 006A","E01031783","35-39 years","Female",64,62,65,55,62,308
"Worthing 006A","E01031783","40-44 years","Female",50,47,51,47,47,242
"Worthing 006A","E01031783","45-49 years","Female",55,58,61,58,61,293
"Worthing 006A","E01031783","50-54 years","Female",59,60,55,60,54,288
"Worthing 006A","E01031783","55-59 years","Female",40,48,54,56,49,247
"Worthing 006A","E01031783","60-64 years","Female",45,43,50,50,57,245
"Worthing 006A","E01031783","65-69 years","Female",47,41,40,38,38,204
"Worthing 006A","E01031783","70-74 years","Female",34,49,45,45,52,225
"Worthing 006A","E01031783","75-79 years","Female",26,25,24,27,26,128
"Worthing 006A","E01031783","80-84 years","Female",22,14,18,16,11,81
"Worthing 006A","E01031783","85+ years","Female",27,28,24,23,22,124
"Worthing 006B","E01031785","0-4 years","Male",51,50,49,56,50,256
"Worthing 006B","E01031785","5-9 years","Male",68,67,70,71,63,339
"Worthing 006B","E01031785","10-14 years","Male",39,39,48,51,50,227
"Worthing 006B","E01031785","15-19 years","Male",34,32,32,41,39,178
"Worthing 006B","E01031785","20-24 years","Male",51,51,46,41,37,226
"Worthing 006B","E01031785","25-29 years","Male",57,58,53,46,41,255
"Worthing 006B","E01031785","30-34 years","Male",44,44,44,47,41,220
"Worthing 006B","E01031785","35-39 years","Male",40,42,58,57,50,247
"Worthing 006B","E01031785","40-44 years","Male",47,45,47,45,44,228
"Worthing 006B","E01031785","45-49 years","Male",53,52,46,44,49,244
"Worthing 006B","E01031785","50-54 years","Male",42,46,47,49,46,230
"Worthing 006B","E01031785","55-59 years","Male",36,37,42,46,44,205
"Worthing 006B","E01031785","60-64 years","Male",55,51,42,40,38,226
"Worthing 006B","E01031785","65-69 years","Male",43,39,42,43,45,212
"Worthing 006B","E01031785","70-74 years","Male",33,35,42,46,39,195
"Worthing 006B","E01031785","75-79 years","Male",19,14,16,16,18,83
"Worthing 006B","E01031785","80-84 years","Male",13,12,11,10,10,56
"Worthing 006B","E01031785","85+ years","Male",8,6,5,4,5,28
"Worthing 006B","E01031785","0-4 years","Female",49,48,53,49,47,246
"Worthing 006B","E01031785","5-9 years","Female",41,47,51,40,47,226
"Worthing 006B","E01031785","10-14 years","Female",39,39,46,52,58,234
"Worthing 006B","E01031785","15-19 years","Female",45,45,35,34,30,189
"Worthing 006B","E01031785","20-24 years","Female",39,27,36,44,48,194
"Worthing 006B","E01031785","25-29 years","Female",48,62,45,36,35,226
"Worthing 006B","E01031785","30-34 years","Female",44,42,42,40,37,205
"Worthing 006B","E01031785","35-39 years","Female",40,41,46,57,51,235
"Worthing 006B","E01031785","40-44 years","Female",58,50,48,43,48,247
"Worthing 006B","E01031785","45-49 years","Female",54,61,63,63,55,296
"Worthing 006B","E01031785","50-54 years","Female",64,63,64,64,52,307
"Worthing 006B","E01031785","55-59 years","Female",43,47,48,49,59,246
"Worthing 006B","E01031785","60-64 years","Female",29,29,30,30,30,148
"Worthing 006B","E01031785","65-69 years","Female",59,54,49,44,41,247
"Worthing 006B","E01031785","70-74 years","Female",44,40,44,49,47,224
"Worthing 006B","E01031785","75-79 years","Female",23,23,31,28,36,141
"Worthing 006B","E01031785","80-84 years","Female",20,17,18,19,18,92
"Worthing 006B","E01031785","85+ years","Female",18,21,15,11,11,76
"Worthing 006C","E01031786","0-4 years","Male",68,58,63,51,48,288
"Worthing 006C","E01031786","5-9 years","Male",62,63,65,71,78,339
"Worthing 006C","E01031786","10-14 years","Male",43,42,48,51,45,229
"Worthing 006C","E01031786","15-19 years","Male",32,37,36,36,37,178
"Worthing 006C","E01031786","20-24 years","Male",30,27,22,22,22,123
"Worthing 006C","E01031786","25-29 years","Male",56,54,53,49,44,256
"Worthing 006C","E01031786","30-34 years","Male",52,43,47,51,57,250
"Worthing 006C","E01031786","35-39 years","Male",47,52,54,54,56,263
"Worthing 006C","E01031786","40-44 years","Male",41,40,42,46,49,218
"Worthing 006C","E01031786","45-49 years","Male",53,52,46,44,45,240
"Worthing 006C","E01031786","50-54 years","Male",56,62,51,53,53,275
"Worthing 006C","E01031786","55-59 years","Male",52,49,53,44,54,252
"Worthing 006C","E01031786","60-64 years","Male",53,50,51,55,53,262
"Worthing 006C","E01031786","65-69 years","Male",49,51,49,57,57,263
"Worthing 006C","E01031786","70-74 years","Male",24,30,36,35,37,162
"Worthing 006C","E01031786","75-79 years","Male",21,22,17,14,16,90
"Worthing 006C","E01031786","80-84 years","Male",13,12,11,11,9,56
"Worthing 006C","E01031786","85+ years","Male",20,22,12,15,15,84
"Worthing 006C","E01031786","0-4 years","Female",58,63,63,59,61,304
"Worthing 006C","E01031786","5-9 years","Female",84,69,66,69,58,346
"Worthing 006C","E01031786","10-14 years","Female",34,38,48,54,57,231
"Worthing 006C","E01031786","15-19 years","Female",40,35,32,30,30,167
"Worthing 006C","E01031786","20-24 years","Female",31,26,23,24,22,126
"Worthing 006C","E01031786","25-29 years","Female",66,63,73,67,67,336
"Worthing 006C","E01031786","30-34 years","Female",68,68,68,67,70,341
"Worthing 006C","E01031786","35-39 years","Female",45,51,53,42,41,232
"Worthing 006C","E01031786","40-44 years","Female",50,49,48,59,69,275
"Worthing 006C","E01031786","45-49 years","Female",72,61,57,60,58,308
"Worthing 006C","E01031786","50-54 years","Female",37,44,45,50,46,222
"Worthing 006C","E01031786","55-59 years","Female",60,57,48,50,45,260
"Worthing 006C","E01031786","60-64 years","Female",46,54,56,47,63,266
"Worthing 006C","E01031786","65-69 years","Female",53,51,46,55,53,258
"Worthing 006C","E01031786","70-74 years","Female",29,26,35,36,44,170
"Worthing 006C","E01031786","75-79 years","Female",28,26,25,29,24,132
"Worthing 006C","E01031786","80-84 years","Female",19,26,26,25,24,120
"Worthing 006C","E01031786","85+ years","Female",12,10,10,10,15,57
"Worthing 006D","E01031817","0-4 years","Male",87,84,70,65,55,361
"Worthing 006D","E01031817","5-9 years","Male",61,56,68,65,66,316
"Worthing 006D","E01031817","10-14 years","Male",56,61,56,61,64,298
"Worthing 006D","E01031817","15-19 years","Male",69,72,67,65,63,336
"Worthing 006D","E01031817","20-24 years","Male",43,42,40,35,36,196
"Worthing 006D","E01031817","25-29 years","Male",48,50,52,49,44,243
"Worthing 006D","E01031817","30-34 years","Male",54,57,57,59,48,275
"Worthing 006D","E01031817","35-39 years","Male",63,63,68,73,62,329
"Worthing 006D","E01031817","40-44 years","Male",75,84,74,75,85,393
"Worthing 006D","E01031817","45-49 years","Male",73,66,75,69,72,355
"Worthing 006D","E01031817","50-54 years","Male",59,64,72,75,69,339
"Worthing 006D","E01031817","55-59 years","Male",61,57,58,50,51,277
"Worthing 006D","E01031817","60-64 years","Male",32,31,35,45,48,191
"Worthing 006D","E01031817","65-69 years","Male",44,35,39,41,32,191
"Worthing 006D","E01031817","70-74 years","Male",25,32,31,33,34,155
"Worthing 006D","E01031817","75-79 years","Male",27,25,25,20,24,121
"Worthing 006D","E01031817","80-84 years","Male",10,7,12,15,16,60
"Worthing 006D","E01031817","85+ years","Male",11,16,22,16,19,84
"Worthing 006D","E01031817","0-4 years","Female",59,63,66,63,61,312
"Worthing 006D","E01031817","5-9 years","Female",61,57,57,67,59,301
"Worthing 006D","E01031817","10-14 years","Female",75,74,76,66,67,358
"Worthing 006D","E01031817","15-19 years","Female",53,52,55,66,74,300
"Worthing 006D","E01031817","20-24 years","Female",49,50,43,36,35,213
"Worthing 006D","E01031817","25-29 years","Female",62,63,70,58,64,317
"Worthing 006D","E01031817","30-34 years","Female",64,72,72,71,60,339
"Worthing 006D","E01031817","35-39 years","Female",61,62,59,66,64,312
"Worthing 006D","E01031817","40-44 years","Female",79,68,68,56,57,328
"Worthing 006D","E01031817","45-49 years","Female",53,57,63,64,59,296
"Worthing 006D","E01031817","50-54 years","Female",90,90,77,81,78,416
"Worthing 006D","E01031817","55-59 years","Female",53,55,61,59,67,295
"Worthing 006D","E01031817","60-64 years","Female",45,50,53,60,61,269
"Worthing 006D","E01031817","65-69 years","Female",33,34,37,44,41,189
"Worthing 006D","E01031817","70-74 years","Female",40,40,37,37,34,188
"Worthing 006D","E01031817","75-79 years","Female",23,22,18,20,28,111
"Worthing 006D","E01031817","80-84 years","Female",14,20,22,26,21,103
"Worthing 006D","E01031817","85+ years","Female",39,36,33,37,36,181
"Worthing 006E","E01031819","0-4 years","Male",49,85,138,190,218,680
"Worthing 006E","E01031819","5-9 years","Male",50,69,94,113,143,469
"Worthing 006E","E01031819","10-14 years","Male",61,78,98,118,126,481
"Worthing 006E","E01031819","15-19 years","Male",57,61,67,78,108,371
"Worthing 006E","E01031819","20-24 years","Male",36,41,41,46,58,222
"Worthing 006E","E01031819","25-29 years","Male",29,32,36,46,44,187
"Worthing 006E","E01031819","30-34 years","Male",53,82,104,122,124,485
"Worthing 006E","E01031819","35-39 years","Male",30,48,67,85,113,343
"Worthing 006E","E01031819","40-44 years","Male",41,50,71,108,118,388
"Worthing 006E","E01031819","45-49 years","Male",55,60,67,82,95,359
"Worthing 006E","E01031819","50-54 years","Male",52,59,60,67,74,312
"Worthing 006E","E01031819","55-59 years","Male",42,47,52,57,57,255
"Worthing 006E","E01031819","60-64 years","Male",40,45,53,68,71,277
"Worthing 006E","E01031819","65-69 years","Male",24,22,28,32,36,142
"Worthing 006E","E01031819","70-74 years","Male",13,23,24,31,37,128
"Worthing 006E","E01031819","75-79 years","Male",9,6,14,15,12,56
"Worthing 006E","E01031819","80-84 years","Male",5,8,9,9,15,46
"Worthing 006E","E01031819","85+ years","Male",3,4,7,7,8,29
"Worthing 006E","E01031819","0-4 years","Female",58,90,120,159,190,617
"Worthing 006E","E01031819","5-9 years","Female",67,84,116,155,176,598
"Worthing 006E","E01031819","10-14 years","Female",48,58,70,96,124,396
"Worthing 006E","E01031819","15-19 years","Female",70,67,72,69,70,348
"Worthing 006E","E01031819","20-24 years","Female",40,54,56,64,73,287
"Worthing 006E","E01031819","25-29 years","Female",43,70,91,115,118,437
"Worthing 006E","E01031819","30-34 years","Female",68,94,132,160,188,642
"Worthing 006E","E01031819","35-39 years","Female",74,108,158,177,205,722
"Worthing 006E","E01031819","40-44 years","Female",47,60,71,97,117,392
"Worthing 006E","E01031819","45-49 years","Female",66,71,79,86,98,400
"Worthing 006E","E01031819","50-54 years","Female",57,64,75,90,90,376
"Worthing 006E","E01031819","55-59 years","Female",60,72,75,84,88,379
"Worthing 006E","E01031819","60-64 years","Female",33,45,57,65,67,267
"Worthing 006E","E01031819","65-69 years","Female",20,17,28,35,44,144
"Worthing 006E","E01031819","70-74 years","Female",10,13,18,21,22,84
"Worthing 006E","E01031819","75-79 years","Female",14,16,15,15,18,78
"Worthing 006E","E01031819","80-84 years","Female",9,8,12,12,10,51
"Worthing 006E","E01031819","85+ years","Female",3,6,4,4,5,22
"Worthing 007A","E01031782","0-4 years","Male",33,33,33,34,34,167
"Worthing 007A","E01031782","5-9 years","Male",31,39,46,45,53,214
"Worthing 007A","E01031782","10-14 years","Male",46,43,47,45,57,238
"Worthing 007A","E01031782","15-19 years","Male",45,36,33,37,40,191
"Worthing 007A","E01031782","20-24 years","Male",34,32,35,28,25,154
"Worthing 007A","E01031782","25-29 years","Male",13,14,17,17,19,80
"Worthing 007A","E01031782","30-34 years","Male",26,24,19,20,20,109
"Worthing 007A","E01031782","35-39 years","Male",38,45,41,44,42,210
"Worthing 007A","E01031782","40-44 years","Male",43,32,35,31,39,180
"Worthing 007A","E01031782","45-49 years","Male",50,49,47,42,46,234
"Worthing 007A","E01031782","50-54 years","Male",61,65,71,71,68,336
"Worthing 007A","E01031782","55-59 years","Male",55,53,52,57,54,271
"Worthing 007A","E01031782","60-64 years","Male",40,36,35,39,47,197
"Worthing 007A","E01031782","65-69 years","Male",80,76,69,59,59,343
"Worthing 007A","E01031782","70-74 years","Male",75,80,91,83,74,403
"Worthing 007A","E01031782","75-79 years","Male",39,38,36,50,59,222
"Worthing 007A","E01031782","80-84 years","Male",43,41,36,31,24,175
"Worthing 007A","E01031782","85+ years","Male",33,38,42,43,43,199
"Worthing 007A","E01031782","0-4 years","Female",24,29,29,24,26,132
"Worthing 007A","E01031782","5-9 years","Female",41,40,43,34,38,196
"Worthing 007A","E01031782","10-14 years","Female",53,42,44,47,50,236
"Worthing 007A","E01031782","15-19 years","Female",46,55,47,44,42,234
"Worthing 007A","E01031782","20-24 years","Female",19,16,23,22,26,106
"Worthing 007A","E01031782","25-29 years","Female",12,13,14,12,10,61
"Worthing 007A","E01031782","30-34 years","Female",24,26,28,26,36,140
"Worthing 007A","E01031782","35-39 years","Female",50,44,47,33,35,209
"Worthing 007A","E01031782","40-44 years","Female",48,53,54,65,64,284
"Worthing 007A","E01031782","45-49 years","Female",69,65,68,65,57,324
"Worthing 007A","E01031782","50-54 years","Female",66,66,63,63,67,325
"Worthing 007A","E01031782","55-59 years","Female",46,50,55,52,58,261
"Worthing 007A","E01031782","60-64 years","Female",70,64,58,61,60,313
"Worthing 007A","E01031782","65-69 years","Female",82,80,76,71,73,382
"Worthing 007A","E01031782","70-74 years","Female",77,89,92,89,89,436
"Worthing 007A","E01031782","75-79 years","Female",68,56,59,56,59,298
"Worthing 007A","E01031782","80-84 years","Female",44,55,55,55,59,268
"Worthing 007A","E01031782","85+ years","Female",50,48,53,47,43,241
"Worthing 007B","E01031784","0-4 years","Male",79,93,101,104,110,487
"Worthing 007B","E01031784","5-9 years","Male",74,76,84,83,80,397
"Worthing 007B","E01031784","10-14 years","Male",52,50,64,67,66,299
"Worthing 007B","E01031784","15-19 years","Male",71,73,75,74,77,370
"Worthing 007B","E01031784","20-24 years","Male",54,51,61,69,61,296
"Worthing 007B","E01031784","25-29 years","Male",64,81,91,91,90,417
"Worthing 007B","E01031784","30-34 years","Male",74,77,79,87,98,415
"Worthing 007B","E01031784","35-39 years","Male",78,94,97,94,91,454
"Worthing 007B","E01031784","40-44 years","Male",70,84,91,107,118,470
"Worthing 007B","E01031784","45-49 years","Male",83,82,83,76,78,402
"Worthing 007B","E01031784","50-54 years","Male",54,64,72,86,92,368
"Worthing 007B","E01031784","55-59 years","Male",63,63,72,72,70,340
"Worthing 007B","E01031784","60-64 years","Male",48,39,31,39,48,205
"Worthing 007B","E01031784","65-69 years","Male",64,61,60,56,58,299
"Worthing 007B","E01031784","70-74 years","Male",60,66,72,77,75,350
"Worthing 007B","E01031784","75-79 years","Male",38,40,44,39,46,207
"Worthing 007B","E01031784","80-84 years","Male",25,21,19,21,28,114
"Worthing 007B","E01031784","85+ years","Male",33,38,42,39,42,194
"Worthing 007B","E01031784","0-4 years","Female",80,85,94,92,92,443
"Worthing 007B","E01031784","5-9 years","Female",98,112,105,108,102,525
"Worthing 007B","E01031784","10-14 years","Female",55,68,84,91,96,394
"Worthing 007B","E01031784","15-19 years","Female",65,68,58,54,62,307
"Worthing 007B","E01031784","20-24 years","Female",58,55,64,74,70,321
"Worthing 007B","E01031784","25-29 years","Female",92,111,119,121,119,562
"Worthing 007B","E01031784","30-34 years","Female",82,94,104,116,110,506
"Worthing 007B","E01031784","35-39 years","Female",84,94,107,115,115,515
"Worthing 007B","E01031784","40-44 years","Female",62,75,79,77,89,382
"Worthing 007B","E01031784","45-49 years","Female",89,80,84,95,91,439
"Worthing 007B","E01031784","50-54 years","Female",68,76,81,78,85,388
"Worthing 007B","E01031784","55-59 years","Female",77,74,86,84,93,414
"Worthing 007B","E01031784","60-64 years","Female",47,55,53,57,69,281
"Worthing 007B","E01031784","65-69 years","Female",64,58,51,50,47,270
"Worthing 007B","E01031784","70-74 years","Female",53,57,64,71,66,311
"Worthing 007B","E01031784","75-79 years","Female",47,50,45,36,37,215
"Worthing 007B","E01031784","80-84 years","Female",40,34,40,39,39,192
"Worthing 007B","E01031784","85+ years","Female",51,54,49,50,48,252
"Worthing 007C","E01031836","0-4 years","Male",50,46,46,40,44,226
"Worthing 007C","E01031836","5-9 years","Male",58,57,51,44,50,260
"Worthing 007C","E01031836","10-14 years","Male",55,59,63,71,66,314
"Worthing 007C","E01031836","15-19 years","Male",61,59,58,57,52,287
"Worthing 007C","E01031836","20-24 years","Male",28,35,30,39,43,175
"Worthing 007C","E01031836","25-29 years","Male",51,49,49,45,39,233
"Worthing 007C","E01031836","30-34 years","Male",55,58,50,49,52,264
"Worthing 007C","E01031836","35-39 years","Male",69,62,69,56,54,310
"Worthing 007C","E01031836","40-44 years","Male",65,65,55,52,66,303
"Worthing 007C","E01031836","45-49 years","Male",67,65,62,58,47,299
"Worthing 007C","E01031836","50-54 years","Male",65,72,71,70,64,342
"Worthing 007C","E01031836","55-59 years","Male",51,51,46,55,54,257
"Worthing 007C","E01031836","60-64 years","Male",35,38,41,36,48,198
"Worthing 007C","E01031836","65-69 years","Male",39,34,35,31,32,171
"Worthing 007C","E01031836","70-74 years","Male",28,35,29,31,26,149
"Worthing 007C","E01031836","75-79 years","Male",17,20,20,22,29,108
"Worthing 007C","E01031836","80-84 years","Male",20,17,15,19,17,88
"Worthing 007C","E01031836","85+ years","Male",8,7,9,8,10,42
"Worthing 007C","E01031836","0-4 years","Female",42,45,46,41,35,209
"Worthing 007C","E01031836","5-9 years","Female",53,49,43,50,54,249
"Worthing 007C","E01031836","10-14 years","Female",65,60,68,64,61,318
"Worthing 007C","E01031836","15-19 years","Female",44,46,48,46,51,235
"Worthing 007C","E01031836","20-24 years","Female",31,29,29,35,27,151
"Worthing 007C","E01031836","25-29 years","Female",48,46,39,32,34,199
"Worthing 007C","E01031836","30-34 years","Female",71,72,70,67,66,346
"Worthing 007C","E01031836","35-39 years","Female",45,51,55,65,66,282
"Worthing 007C","E01031836","40-44 years","Female",69,64,65,60,56,314
"Worthing 007C","E01031836","45-49 years","Female",74,74,70,69,65,352
"Worthing 007C","E01031836","50-54 years","Female",71,76,72,65,78,362
"Worthing 007C","E01031836","55-59 years","Female",60,55,59,65,66,305
"Worthing 007C","E01031836","60-64 years","Female",35,39,37,44,51,206
"Worthing 007C","E01031836","65-69 years","Female",47,39,41,35,30,192
"Worthing 007C","E01031836","70-74 years","Female",46,49,45,39,37,216
"Worthing 007C","E01031836","75-79 years","Female",24,22,23,34,36,139
"Worthing 007C","E01031836","80-84 years","Female",24,24,28,26,24,126
"Worthing 007C","E01031836","85+ years","Female",20,23,22,21,20,106
"Worthing 007D","E01031838","0-4 years","Male",39,38,37,34,33,181
"Worthing 007D","E01031838","5-9 years","Male",49,45,41,50,38,223
"Worthing 007D","E01031838","10-14 years","Male",44,54,59,56,54,267
"Worthing 007D","E01031838","15-19 years","Male",41,42,37,35,37,192
"Worthing 007D","E01031838","20-24 years","Male",42,36,40,38,38,194
"Worthing 007D","E01031838","25-29 years","Male",22,21,27,24,21,115
"Worthing 007D","E01031838","30-34 years","Male",49,41,35,30,31,186
"Worthing 007D","E01031838","35-39 years","Male",54,47,45,41,38,225
"Worthing 007D","E01031838","40-44 years","Male",47,53,44,42,41,227
"Worthing 007D","E01031838","45-49 years","Male",64,63,59,64,61,311
"Worthing 007D","E01031838","50-54 years","Male",64,58,69,64,63,318
"Worthing 007D","E01031838","55-59 years","Male",51,60,58,64,69,302
"Worthing 007D","E01031838","60-64 years","Male",51,51,48,43,42,235
"Worthing 007D","E01031838","65-69 years","Male",57,49,47,45,41,239
"Worthing 007D","E01031838","70-74 years","Male",49,56,51,53,56,265
"Worthing 007D","E01031838","75-79 years","Male",26,29,34,28,27,144
"Worthing 007D","E01031838","80-84 years","Male",18,17,14,19,21,89
"Worthing 007D","E01031838","85+ years","Male",22,10,11,12,11,66
"Worthing 007D","E01031838","0-4 years","Female",35,31,28,21,20,135
"Worthing 007D","E01031838","5-9 years","Female",35,29,26,24,22,136
"Worthing 007D","E01031838","10-14 years","Female",44,45,41,40,42,212
"Worthing 007D","E01031838","15-19 years","Female",33,40,36,43,45,197
"Worthing 007D","E01031838","20-24 years","Female",28,26,22,25,27,128
"Worthing 007D","E01031838","25-29 years","Female",52,51,57,48,40,248
"Worthing 007D","E01031838","30-34 years","Female",47,47,49,53,50,246
"Worthing 007D","E01031838","35-39 years","Female",44,49,45,42,46,226
"Worthing 007D","E01031838","40-44 years","Female",66,66,58,59,63,312
"Worthing 007D","E01031838","45-49 years","Female",54,47,52,45,44,242
"Worthing 007D","E01031838","50-54 years","Female",73,72,62,70,67,344
"Worthing 007D","E01031838","55-59 years","Female",60,56,63,68,71,318
"Worthing 007D","E01031838","60-64 years","Female",47,45,54,61,56,263
"Worthing 007D","E01031838","65-69 years","Female",50,50,47,49,55,251
"Worthing 007D","E01031838","70-74 years","Female",38,49,53,51,51,242
"Worthing 007D","E01031838","75-79 years","Female",36,27,25,27,36,151
"Worthing 007D","E01031838","80-84 years","Female",25,23,24,23,26,121
"Worthing 007D","E01031838","85+ years","Female",65,44,35,43,34,221
"Worthing 007E","E01031840","0-4 years","Male",57,60,57,52,46,272
"Worthing 007E","E01031840","5-9 years","Male",57,59,60,70,81,327
"Worthing 007E","E01031840","10-14 years","Male",39,35,38,37,40,189
"Worthing 007E","E01031840","15-19 years","Male",55,48,44,46,30,223
"Worthing 007E","E01031840","20-24 years","Male",40,46,54,45,47,232
"Worthing 007E","E01031840","25-29 years","Male",46,43,46,41,44,220
"Worthing 007E","E01031840","30-34 years","Male",49,48,36,48,45,226
"Worthing 007E","E01031840","35-39 years","Male",44,51,63,59,61,278
"Worthing 007E","E01031840","40-44 years","Male",49,46,41,45,51,232
"Worthing 007E","E01031840","45-49 years","Male",77,71,68,66,56,338
"Worthing 007E","E01031840","50-54 years","Male",62,59,54,53,64,292
"Worthing 007E","E01031840","55-59 years","Male",55,69,77,75,67,343
"Worthing 007E","E01031840","60-64 years","Male",46,43,44,43,46,222
"Worthing 007E","E01031840","65-69 years","Male",49,43,36,40,35,203
"Worthing 007E","E01031840","70-74 years","Male",50,51,48,51,46,246
"Worthing 007E","E01031840","75-79 years","Male",35,37,48,41,46,207
"Worthing 007E","E01031840","80-84 years","Male",19,23,25,29,29,125
"Worthing 007E","E01031840","85+ years","Male",21,20,20,24,23,108
"Worthing 007E","E01031840","0-4 years","Female",50,45,44,50,46,235
"Worthing 007E","E01031840","5-9 years","Female",41,46,49,36,51,223
"Worthing 007E","E01031840","10-14 years","Female",59,55,50,60,58,282
"Worthing 007E","E01031840","15-19 years","Female",33,30,40,35,38,176
"Worthing 007E","E01031840","20-24 years","Female",31,26,30,31,27,145
"Worthing 007E","E01031840","25-29 years","Female",39,37,35,37,40,188
"Worthing 007E","E01031840","30-34 years","Female",46,52,49,42,42,231
"Worthing 007E","E01031840","35-39 years","Female",47,54,53,48,56,258
"Worthing 007E","E01031840","40-44 years","Female",54,47,37,38,40,216
"Worthing 007E","E01031840","45-49 years","Female",70,60,66,63,56,315
"Worthing 007E","E01031840","50-54 years","Female",78,78,76,70,64,366
"Worthing 007E","E01031840","55-59 years","Female",63,58,59,62,74,316
"Worthing 007E","E01031840","60-64 years","Female",57,71,69,73,56,326
"Worthing 007E","E01031840","65-69 years","Female",70,61,61,50,56,298
"Worthing 007E","E01031840","70-74 years","Female",52,52,50,51,54,259
"Worthing 007E","E01031840","75-79 years","Female",43,49,51,50,49,242
"Worthing 007E","E01031840","80-84 years","Female",27,31,36,38,36,168
"Worthing 007E","E01031840","85+ years","Female",24,20,16,24,24,108
"Worthing 008A","E01031791","0-4 years","Male",91,105,87,80,74,437
"Worthing 008A","E01031791","5-9 years","Male",107,109,94,79,93,482
"Worthing 008A","E01031791","10-14 years","Male",56,60,68,74,77,335
"Worthing 008A","E01031791","15-19 years","Male",37,35,38,36,46,192
"Worthing 008A","E01031791","20-24 years","Male",47,48,46,51,47,239
"Worthing 008A","E01031791","25-29 years","Male",86,93,87,80,76,422
"Worthing 008A","E01031791","30-34 years","Male",84,87,81,81,84,417
"Worthing 008A","E01031791","35-39 years","Male",119,120,108,105,104,556
"Worthing 008A","E01031791","40-44 years","Male",79,78,84,86,90,417
"Worthing 008A","E01031791","45-49 years","Male",101,96,83,82,64,426
"Worthing 008A","E01031791","50-54 years","Male",61,71,76,85,89,382
"Worthing 008A","E01031791","55-59 years","Male",57,65,67,70,71,330
"Worthing 008A","E01031791","60-64 years","Male",33,36,45,49,56,219
"Worthing 008A","E01031791","65-69 years","Male",27,23,31,29,28,138
"Worthing 008A","E01031791","70-74 years","Male",25,29,26,29,30,139
"Worthing 008A","E01031791","75-79 years","Male",24,27,23,27,25,126
"Worthing 008A","E01031791","80-84 years","Male",11,10,14,18,20,73
"Worthing 008A","E01031791","85+ years","Male",14,11,9,8,7,49
"Worthing 008A","E01031791","0-4 years","Female",99,90,77,57,53,376
"Worthing 008A","E01031791","5-9 years","Female",81,88,79,81,73,402
"Worthing 008A","E01031791","10-14 years","Female",61,69,78,73,76,357
"Worthing 008A","E01031791","15-19 years","Female",42,37,41,53,50,223
"Worthing 008A","E01031791","20-24 years","Female",56,66,64,62,57,305
"Worthing 008A","E01031791","25-29 years","Female",89,87,79,72,77,404
"Worthing 008A","E01031791","30-34 years","Female",112,118,112,101,86,529
"Worthing 008A","E01031791","35-39 years","Female",115,109,95,99,113,531
"Worthing 008A","E01031791","40-44 years","Female",97,91,95,89,84,456
"Worthing 008A","E01031791","45-49 years","Female",104,100,100,93,99,496
"Worthing 008A","E01031791","50-54 years","Female",69,76,76,74,80,375
"Worthing 008A","E01031791","55-59 years","Female",62,63,67,73,75,340
"Worthing 008A","E01031791","60-64 years","Female",33,29,34,31,29,156
"Worthing 008A","E01031791","65-69 years","Female",40,40,25,25,34,164
"Worthing 008A","E01031791","70-74 years","Female",22,29,36,40,40,167
"Worthing 008A","E01031791","75-79 years","Female",25,25,31,24,28,133
"Worthing 008A","E01031791","80-84 years","Female",30,33,34,38,34,169
"Worthing 008A","E01031791","85+ years","Female",45,37,41,42,42,207
"Worthing 008B","E01031796","0-4 years","Male",64,52,56,52,49,273
"Worthing 008B","E01031796","5-9 years","Male",68,61,52,57,44,282
"Worthing 008B","E01031796","10-14 years","Male",59,56,58,60,61,294
"Worthing 008B","E01031796","15-19 years","Male",58,55,49,53,47,262
"Worthing 008B","E01031796","20-24 years","Male",37,35,40,39,41,192
"Worthing 008B","E01031796","25-29 years","Male",47,55,48,48,35,233
"Worthing 008B","E01031796","30-34 years","Male",53,45,54,61,62,275
"Worthing 008B","E01031796","35-39 years","Male",69,76,70,60,63,338
"Worthing 008B","E01031796","40-44 years","Male",48,44,50,51,48,241
"Worthing 008B","E01031796","45-49 years","Male",64,66,66,64,61,321
"Worthing 008B","E01031796","50-54 years","Male",60,67,69,66,66,328
"Worthing 008B","E01031796","55-59 years","Male",48,53,54,57,58,270
"Worthing 008B","E01031796","60-64 years","Male",35,34,27,28,33,157
"Worthing 008B","E01031796","65-69 years","Male",31,24,24,25,25,129
"Worthing 008B","E01031796","70-74 years","Male",13,22,22,22,26,105
"Worthing 008B","E01031796","75-79 years","Male",20,19,19,20,20,98
"Worthing 008B","E01031796","80-84 years","Male",4,6,7,10,11,38
"Worthing 008B","E01031796","85+ years","Male",3,3,4,6,6,22
"Worthing 008B","E01031796","0-4 years","Female",57,53,44,37,41,232
"Worthing 008B","E01031796","5-9 years","Female",68,66,61,63,59,317
"Worthing 008B","E01031796","10-14 years","Female",34,39,46,44,40,203
"Worthing 008B","E01031796","15-19 years","Female",62,63,54,44,42,265
"Worthing 008B","E01031796","20-24 years","Female",48,50,57,54,60,269
"Worthing 008B","E01031796","25-29 years","Female",50,52,41,42,40,225
"Worthing 008B","E01031796","30-34 years","Female",66,49,57,57,52,281
"Worthing 008B","E01031796","35-39 years","Female",81,94,98,95,91,459
"Worthing 008B","E01031796","40-44 years","Female",75,62,62,69,67,335
"Worthing 008B","E01031796","45-49 years","Female",75,73,63,63,58,332
"Worthing 008B","E01031796","50-54 years","Female",64,75,87,91,77,394
"Worthing 008B","E01031796","55-59 years","Female",41,41,39,44,56,221
"Worthing 008B","E01031796","60-64 years","Female",40,45,41,44,47,217
"Worthing 008B","E01031796","65-69 years","Female",25,31,34,42,40,172
"Worthing 008B","E01031796","70-74 years","Female",23,25,27,25,24,124
"Worthing 008B","E01031796","75-79 years","Female",13,16,16,19,16,80
"Worthing 008B","E01031796","80-84 years","Female",12,10,12,14,16,64
"Worthing 008B","E01031796","85+ years","Female",12,15,19,10,10,66
"Worthing 008C","E01031799","0-4 years","Male",54,55,56,54,56,275
"Worthing 008C","E01031799","5-9 years","Male",65,63,63,69,63,323
"Worthing 008C","E01031799","10-14 years","Male",70,72,77,73,74,366
"Worthing 008C","E01031799","15-19 years","Male",53,53,47,57,53,263
"Worthing 008C","E01031799","20-24 years","Male",44,47,42,37,49,219
"Worthing 008C","E01031799","25-29 years","Male",39,33,29,27,28,156
"Worthing 008C","E01031799","30-34 years","Male",55,53,51,46,40,245
"Worthing 008C","E01031799","35-39 years","Male",60,57,60,64,57,298
"Worthing 008C","E01031799","40-44 years","Male",41,39,41,41,44,206
"Worthing 008C","E01031799","45-49 years","Male",63,64,57,55,64,303
"Worthing 008C","E01031799","50-54 years","Male",57,61,69,67,56,310
"Worthing 008C","E01031799","55-59 years","Male",43,38,34,33,45,193
"Worthing 008C","E01031799","60-64 years","Male",40,42,47,40,43,212
"Worthing 008C","E01031799","65-69 years","Male",38,39,31,38,42,188
"Worthing 008C","E01031799","70-74 years","Male",20,26,28,27,23,124
"Worthing 008C","E01031799","75-79 years","Male",14,11,12,16,21,74
"Worthing 008C","E01031799","80-84 years","Male",19,18,20,19,13,89
"Worthing 008C","E01031799","85+ years","Male",5,7,9,11,12,44
"Worthing 008C","E01031799","0-4 years","Female",56,62,51,52,50,271
"Worthing 008C","E01031799","5-9 years","Female",54,57,56,46,42,255
"Worthing 008C","E01031799","10-14 years","Female",60,57,55,60,62,294
"Worthing 008C","E01031799","15-19 years","Female",54,57,65,75,79,330
"Worthing 008C","E01031799","20-24 years","Female",50,58,57,47,47,259
"Worthing 008C","E01031799","25-29 years","Female",48,44,32,31,37,192
"Worthing 008C","E01031799","30-34 years","Female",47,49,57,60,48,261
"Worthing 008C","E01031799","35-39 years","Female",75,81,83,74,72,385
"Worthing 008C","E01031799","40-44 years","Female",73,65,59,60,67,324
"Worthing 008C","E01031799","45-49 years","Female",59,71,81,79,71,361
"Worthing 008C","E01031799","50-54 years","Female",67,52,53,59,56,287
"Worthing 008C","E01031799","55-59 years","Female",57,61,69,62,65,314
"Worthing 008C","E01031799","60-64 years","Female",48,48,46,47,59,248
"Worthing 008C","E01031799","65-69 years","Female",31,29,28,30,31,149
"Worthing 008C","E01031799","70-74 years","Female",37,31,27,31,32,158
"Worthing 008C","E01031799","75-79 years","Female",28,23,28,30,31,140
"Worthing 008C","E01031799","80-84 years","Female",16,22,23,22,22,105
"Worthing 008C","E01031799","85+ years","Female",47,38,38,40,40,203
"Worthing 008D","E01031801","0-4 years","Male",70,68,60,64,69,331
"Worthing 008D","E01031801","5-9 years","Male",64,69,71,51,52,307
"Worthing 008D","E01031801","10-14 years","Male",66,61,62,78,75,342
"Worthing 008D","E01031801","15-19 years","Male",60,51,54,48,52,265
"Worthing 008D","E01031801","20-24 years","Male",70,68,65,58,62,323
"Worthing 008D","E01031801","25-29 years","Male",84,67,70,63,68,352
"Worthing 008D","E01031801","30-34 years","Male",71,82,69,61,58,341
"Worthing 008D","E01031801","35-39 years","Male",69,68,81,74,72,364
"Worthing 008D","E01031801","40-44 years","Male",73,67,62,61,63,326
"Worthing 008D","E01031801","45-49 years","Male",71,70,71,65,71,348
"Worthing 008D","E01031801","50-54 years","Male",74,76,68,81,77,376
"Worthing 008D","E01031801","55-59 years","Male",55,55,64,58,56,288
"Worthing 008D","E01031801","60-64 years","Male",23,22,18,25,29,117
"Worthing 008D","E01031801","65-69 years","Male",41,39,29,27,27,163
"Worthing 008D","E01031801","70-74 years","Male",33,36,40,44,49,202
"Worthing 008D","E01031801","75-79 years","Male",14,20,24,28,30,116
"Worthing 008D","E01031801","80-84 years","Male",14,8,6,3,8,39
"Worthing 008D","E01031801","85+ years","Male",28,31,27,30,25,141
"Worthing 008D","E01031801","0-4 years","Female",50,51,59,42,44,246
"Worthing 008D","E01031801","5-9 years","Female",74,75,64,62,50,325
"Worthing 008D","E01031801","10-14 years","Female",45,43,51,51,59,249
"Worthing 008D","E01031801","15-19 years","Female",63,62,63,57,49,294
"Worthing 008D","E01031801","20-24 years","Female",69,62,54,85,79,349
"Worthing 008D","E01031801","25-29 years","Female",76,71,61,55,53,316
"Worthing 008D","E01031801","30-34 years","Female",53,55,69,66,63,306
"Worthing 008D","E01031801","35-39 years","Female",58,65,66,58,56,303
"Worthing 008D","E01031801","40-44 years","Female",103,93,85,75,68,424
"Worthing 008D","E01031801","45-49 years","Female",68,68,79,78,86,379
"Worthing 008D","E01031801","50-54 years","Female",70,68,60,65,65,328
"Worthing 008D","E01031801","55-59 years","Female",37,44,56,61,65,263
"Worthing 008D","E01031801","60-64 years","Female",43,41,38,45,42,209
"Worthing 008D","E01031801","65-69 years","Female",22,27,28,32,28,137
"Worthing 008D","E01031801","70-74 years","Female",25,22,24,28,35,134
"Worthing 008D","E01031801","75-79 years","Female",26,23,24,21,14,108
"Worthing 008D","E01031801","80-84 years","Female",25,23,21,15,25,109
"Worthing 008D","E01031801","85+ years","Female",23,24,19,23,21,110
"Worthing 008E","E01031837","0-4 years","Male",84,83,81,75,77,400
"Worthing 008E","E01031837","5-9 years","Male",70,73,78,80,76,377
"Worthing 008E","E01031837","10-14 years","Male",61,62,64,68,73,328
"Worthing 008E","E01031837","15-19 years","Male",57,56,48,48,55,264
"Worthing 008E","E01031837","20-24 years","Male",54,46,58,56,48,262
"Worthing 008E","E01031837","25-29 years","Male",55,54,44,42,41,236
"Worthing 008E","E01031837","30-34 years","Male",73,67,69,57,48,314
"Worthing 008E","E01031837","35-39 years","Male",78,81,81,79,71,390
"Worthing 008E","E01031837","40-44 years","Male",77,75,84,82,93,411
"Worthing 008E","E01031837","45-49 years","Male",75,84,73,65,69,366
"Worthing 008E","E01031837","50-54 years","Male",69,68,72,80,75,364
"Worthing 008E","E01031837","55-59 years","Male",53,51,52,54,58,268
"Worthing 008E","E01031837","60-64 years","Male",46,47,45,48,53,239
"Worthing 008E","E01031837","65-69 years","Male",39,41,35,39,36,190
"Worthing 008E","E01031837","70-74 years","Male",23,24,30,25,29,131
"Worthing 008E","E01031837","75-79 years","Male",10,9,11,13,11,54
"Worthing 008E","E01031837","80-84 years","Male",8,8,10,10,9,45
"Worthing 008E","E01031837","85+ years","Male",12,7,7,4,2,32
"Worthing 008E","E01031837","0-4 years","Female",54,65,66,62,57,304
"Worthing 008E","E01031837","5-9 years","Female",74,74,79,86,82,395
"Worthing 008E","E01031837","10-14 years","Female",57,60,59,56,61,293
"Worthing 008E","E01031837","15-19 years","Female",55,58,49,49,57,268
"Worthing 008E","E01031837","20-24 years","Female",45,49,51,48,42,235
"Worthing 008E","E01031837","25-29 years","Female",78,70,58,49,43,298
"Worthing 008E","E01031837","30-34 years","Female",82,69,65,67,68,351
"Worthing 008E","E01031837","35-39 years","Female",92,96,106,103,95,492
"Worthing 008E","E01031837","40-44 years","Female",86,99,86,87,95,453
"Worthing 008E","E01031837","45-49 years","Female",74,77,82,79,75,387
"Worthing 008E","E01031837","50-54 years","Female",85,82,84,82,87,420
"Worthing 008E","E01031837","55-59 years","Female",54,55,58,65,63,295
"Worthing 008E","E01031837","60-64 years","Female",39,40,42,39,37,197
"Worthing 008E","E01031837","65-69 years","Female",40,45,40,40,45,210
"Worthing 008E","E01031837","70-74 years","Female",36,34,37,44,42,193
"Worthing 008E","E01031837","75-79 years","Female",22,26,27,24,20,119
"Worthing 008E","E01031837","80-84 years","Female",18,15,14,18,18,83
"Worthing 008E","E01031837","85+ years","Female",9,10,14,15,19,67
"Worthing 009A","E01031779","0-4 years","Male",53,53,47,38,40,231
"Worthing 009A","E01031779","5-9 years","Male",104,94,85,68,74,425
"Worthing 009A","E01031779","10-14 years","Male",70,79,85,92,91,417
"Worthing 009A","E01031779","15-19 years","Male",48,49,58,59,58,272
"Worthing 009A","E01031779","20-24 years","Male",39,37,37,37,39,189
"Worthing 009A","E01031779","25-29 years","Male",42,41,39,34,30,186
"Worthing 009A","E01031779","30-34 years","Male",37,37,39,30,33,176
"Worthing 009A","E01031779","35-39 years","Male",32,32,29,39,32,164
"Worthing 009A","E01031779","40-44 years","Male",45,40,40,38,39,202
"Worthing 009A","E01031779","45-49 years","Male",47,48,54,59,59,267
"Worthing 009A","E01031779","50-54 years","Male",47,44,43,42,47,223
"Worthing 009A","E01031779","55-59 years","Male",42,45,42,43,44,216
"Worthing 009A","E01031779","60-64 years","Male",20,21,27,28,29,125
"Worthing 009A","E01031779","65-69 years","Male",23,22,17,15,14,91
"Worthing 009A","E01031779","70-74 years","Male",16,10,19,23,29,97
"Worthing 009A","E01031779","75-79 years","Male",10,10,11,10,9,50
"Worthing 009A","E01031779","80-84 years","Male",7,7,6,4,5,29
"Worthing 009A","E01031779","85+ years","Male",16,16,13,13,13,71
"Worthing 009A","E01031779","0-4 years","Female",38,36,34,30,32,170
"Worthing 009A","E01031779","5-9 years","Female",55,53,46,43,43,240
"Worthing 009A","E01031779","10-14 years","Female",57,57,71,75,64,324
"Worthing 009A","E01031779","15-19 years","Female",47,43,40,42,40,212
"Worthing 009A","E01031779","20-24 years","Female",42,51,46,40,43,222
"Worthing 009A","E01031779","25-29 years","Female",38,40,40,35,29,182
"Worthing 009A","E01031779","30-34 years","Female",50,53,42,38,42,225
"Worthing 009A","E01031779","35-39 years","Female",62,67,71,69,66,335
"Worthing 009A","E01031779","40-44 years","Female",46,51,49,55,62,263
"Worthing 009A","E01031779","45-49 years","Female",66,65,64,48,39,282
"Worthing 009A","E01031779","50-54 years","Female",42,40,45,45,55,227
"Worthing 009A","E01031779","55-59 years","Female",39,44,40,44,41,208
"Worthing 009A","E01031779","60-64 years","Female",28,30,34,40,36,168
"Worthing 009A","E01031779","65-69 years","Female",32,28,29,27,23,139
"Worthing 009A","E01031779","70-74 years","Female",18,19,21,23,28,109
"Worthing 009A","E01031779","75-79 years","Female",15,16,15,18,15,79
"Worthing 009A","E01031779","80-84 years","Female",21,21,14,12,13,81
"Worthing 009A","E01031779","85+ years","Female",10,10,9,7,11,47
"Worthing 009B","E01031831","0-4 years","Male",52,40,31,39,36,198
"Worthing 009B","E01031831","5-9 years","Male",49,55,47,45,47,243
"Worthing 009B","E01031831","10-14 years","Male",44,43,49,45,46,227
"Worthing 009B","E01031831","15-19 years","Male",44,43,51,48,49,235
"Worthing 009B","E01031831","20-24 years","Male",42,43,38,40,32,195
"Worthing 009B","E01031831","25-29 years","Male",52,52,44,43,38,229
"Worthing 009B","E01031831","30-34 years","Male",48,43,46,49,50,236
"Worthing 009B","E01031831","35-39 years","Male",49,55,48,55,62,269
"Worthing 009B","E01031831","40-44 years","Male",48,39,40,37,34,198
"Worthing 009B","E01031831","45-49 years","Male",72,67,64,61,66,330
"Worthing 009B","E01031831","50-54 years","Male",73,67,68,65,69,342
"Worthing 009B","E01031831","55-59 years","Male",55,54,49,58,63,279
"Worthing 009B","E01031831","60-64 years","Male",39,45,52,48,46,230
"Worthing 009B","E01031831","65-69 years","Male",34,23,26,21,24,128
"Worthing 009B","E01031831","70-74 years","Male",37,44,40,43,44,208
"Worthing 009B","E01031831","75-79 years","Male",18,19,19,16,17,89
"Worthing 009B","E01031831","80-84 years","Male",23,22,16,20,18,99
"Worthing 009B","E01031831","85+ years","Male",28,28,33,34,38,161
"Worthing 009B","E01031831","0-4 years","Female",45,47,44,45,35,216
"Worthing 009B","E01031831","5-9 years","Female",55,58,61,67,67,308
"Worthing 009B","E01031831","10-14 years","Female",42,44,43,41,47,217
"Worthing 009B","E01031831","15-19 years","Female",37,35,33,36,34,175
"Worthing 009B","E01031831","20-24 years","Female",28,32,26,36,37,159
"Worthing 009B","E01031831","25-29 years","Female",45,39,40,41,33,198
"Worthing 009B","E01031831","30-34 years","Female",57,64,51,56,54,282
"Worthing 009B","E01031831","35-39 years","Female",44,48,46,43,48,229
"Worthing 009B","E01031831","40-44 years","Female",86,80,73,70,66,375
"Worthing 009B","E01031831","45-49 years","Female",71,71,78,81,76,377
"Worthing 009B","E01031831","50-54 years","Female",87,85,72,78,86,408
"Worthing 009B","E01031831","55-59 years","Female",48,54,62,57,62,283
"Worthing 009B","E01031831","60-64 years","Female",36,31,31,39,37,174
"Worthing 009B","E01031831","65-69 years","Female",46,43,47,41,44,221
"Worthing 009B","E01031831","70-74 years","Female",53,46,42,41,43,225
"Worthing 009B","E01031831","75-79 years","Female",52,61,57,52,51,273
"Worthing 009B","E01031831","80-84 years","Female",35,40,45,43,48,211
"Worthing 009B","E01031831","85+ years","Female",85,75,63,80,80,383
"Worthing 009C","E01031832","0-4 years","Male",37,45,49,47,46,224
"Worthing 009C","E01031832","5-9 years","Male",26,33,30,32,42,163
"Worthing 009C","E01031832","10-14 years","Male",29,31,26,27,28,141
"Worthing 009C","E01031832","15-19 years","Male",29,34,34,32,28,157
"Worthing 009C","E01031832","20-24 years","Male",29,29,33,30,36,157
"Worthing 009C","E01031832","25-29 years","Male",43,42,41,44,32,202
"Worthing 009C","E01031832","30-34 years","Male",46,50,52,48,49,245
"Worthing 009C","E01031832","35-39 years","Male",52,55,55,57,44,263
"Worthing 009C","E01031832","40-44 years","Male",36,38,38,41,46,199
"Worthing 009C","E01031832","45-49 years","Male",47,47,41,33,35,203
"Worthing 009C","E01031832","50-54 years","Male",70,63,61,61,58,313
"Worthing 009C","E01031832","55-59 years","Male",58,79,73,79,84,373
"Worthing 009C","E01031832","60-64 years","Male",57,44,48,51,48,248
"Worthing 009C","E01031832","65-69 years","Male",60,53,55,56,54,278
"Worthing 009C","E01031832","70-74 years","Male",41,51,51,47,43,233
"Worthing 009C","E01031832","75-79 years","Male",53,50,41,46,48,238
"Worthing 009C","E01031832","80-84 years","Male",32,29,36,38,42,177
"Worthing 009C","E01031832","85+ years","Male",21,25,28,22,23,119
"Worthing 009C","E01031832","0-4 years","Female",56,49,47,41,47,240
"Worthing 009C","E01031832","5-9 years","Female",29,38,38,34,32,171
"Worthing 009C","E01031832","10-14 years","Female",24,21,25,30,31,131
"Worthing 009C","E01031832","15-19 years","Female",36,37,35,29,26,163
"Worthing 009C","E01031832","20-24 years","Female",44,46,50,42,49,231
"Worthing 009C","E01031832","25-29 years","Female",52,42,49,46,38,227
"Worthing 009C","E01031832","30-34 years","Female",44,47,41,35,30,197
"Worthing 009C","E01031832","35-39 years","Female",49,51,59,59,58,276
"Worthing 009C","E01031832","40-44 years","Female",42,43,51,48,51,235
"Worthing 009C","E01031832","45-49 years","Female",54,61,55,51,48,269
"Worthing 009C","E01031832","50-54 years","Female",65,62,62,53,60,302
"Worthing 009C","E01031832","55-59 years","Female",58,51,58,65,62,294
"Worthing 009C","E01031832","60-64 years","Female",65,67,59,72,70,333
"Worthing 009C","E01031832","65-69 years","Female",79,86,88,77,71,401
"Worthing 009C","E01031832","70-74 years","Female",60,64,67,75,72,338
"Worthing 009C","E01031832","75-79 years","Female",44,42,37,45,52,220
"Worthing 009C","E01031832","80-84 years","Female",41,35,37,30,31,174
"Worthing 009C","E01031832","85+ years","Female",30,34,37,39,40,180
"Worthing 009D","E01031833","0-4 years","Male",45,51,48,46,39,229
"Worthing 009D","E01031833","5-9 years","Male",69,69,68,60,65,331
"Worthing 009D","E01031833","10-14 years","Male",55,44,46,52,49,246
"Worthing 009D","E01031833","15-19 years","Male",50,55,57,64,57,283
"Worthing 009D","E01031833","20-24 years","Male",49,45,46,42,51,233
"Worthing 009D","E01031833","25-29 years","Male",50,53,49,43,37,232
"Worthing 009D","E01031833","30-34 years","Male",40,39,44,43,45,211
"Worthing 009D","E01031833","35-39 years","Male",64,63,57,64,66,314
"Worthing 009D","E01031833","40-44 years","Male",59,49,54,53,49,264
"Worthing 009D","E01031833","45-49 years","Male",85,86,81,79,83,414
"Worthing 009D","E01031833","50-54 years","Male",61,66,71,76,76,350
"Worthing 009D","E01031833","55-59 years","Male",44,50,48,56,54,252
"Worthing 009D","E01031833","60-64 years","Male",51,49,50,44,44,238
"Worthing 009D","E01031833","65-69 years","Male",27,27,25,26,35,140
"Worthing 009D","E01031833","70-74 years","Male",14,17,21,20,19,91
"Worthing 009D","E01031833","75-79 years","Male",26,32,32,25,28,143
"Worthing 009D","E01031833","80-84 years","Male",12,13,14,21,18,78
"Worthing 009D","E01031833","85+ years","Male",9,12,8,9,7,45
"Worthing 009D","E01031833","0-4 years","Female",43,40,35,48,44,210
"Worthing 009D","E01031833","5-9 years","Female",70,64,63,61,60,318
"Worthing 009D","E01031833","10-14 years","Female",56,50,52,59,56,273
"Worthing 009D","E01031833","15-19 years","Female",55,56,50,52,59,272
"Worthing 009D","E01031833","20-24 years","Female",38,34,30,41,38,181
"Worthing 009D","E01031833","25-29 years","Female",45,46,52,50,55,248
"Worthing 009D","E01031833","30-34 years","Female",50,50,53,49,41,243
"Worthing 009D","E01031833","35-39 years","Female",56,59,51,56,47,269
"Worthing 009D","E01031833","40-44 years","Female",72,74,82,69,62,359
"Worthing 009D","E01031833","45-49 years","Female",79,71,76,81,92,399
"Worthing 009D","E01031833","50-54 years","Female",67,61,59,53,53,293
"Worthing 009D","E01031833","55-59 years","Female",56,60,57,66,67,306
"Worthing 009D","E01031833","60-64 years","Female",28,28,39,40,46,181
"Worthing 009D","E01031833","65-69 years","Female",35,32,27,27,21,142
"Worthing 009D","E01031833","70-74 years","Female",37,39,37,42,44,199
"Worthing 009D","E01031833","75-79 years","Female",24,18,23,25,27,117
"Worthing 009D","E01031833","80-84 years","Female",11,17,26,24,23,101
"Worthing 009D","E01031833","85+ years","Female",26,27,20,22,20,115
"Worthing 009E","E01031834","0-4 years","Male",51,45,40,46,44,226
"Worthing 009E","E01031834","5-9 years","Male",59,56,57,55,53,280
"Worthing 009E","E01031834","10-14 years","Male",61,68,63,59,63,314
"Worthing 009E","E01031834","15-19 years","Male",62,54,49,62,72,299
"Worthing 009E","E01031834","20-24 years","Male",43,45,44,49,51,232
"Worthing 009E","E01031834","25-29 years","Male",33,35,34,31,33,166
"Worthing 009E","E01031834","30-34 years","Male",39,35,33,31,27,165
"Worthing 009E","E01031834","35-39 years","Male",40,35,42,42,47,206
"Worthing 009E","E01031834","40-44 years","Male",55,55,43,39,42,234
"Worthing 009E","E01031834","45-49 years","Male",68,62,70,68,68,336
"Worthing 009E","E01031834","50-54 years","Male",59,60,52,57,51,279
"Worthing 009E","E01031834","55-59 years","Male",45,53,68,62,70,298
"Worthing 009E","E01031834","60-64 years","Male",24,28,36,37,45,170
"Worthing 009E","E01031834","65-69 years","Male",50,44,34,41,32,201
"Worthing 009E","E01031834","70-74 years","Male",31,29,31,32,38,161
"Worthing 009E","E01031834","75-79 years","Male",12,18,14,12,14,70
"Worthing 009E","E01031834","80-84 years","Male",12,8,8,6,5,39
"Worthing 009E","E01031834","85+ years","Male",8,13,13,11,10,55
"Worthing 009E","E01031834","0-4 years","Female",39,38,40,33,34,184
"Worthing 009E","E01031834","5-9 years","Female",51,51,49,55,53,259
"Worthing 009E","E01031834","10-14 years","Female",50,49,56,64,63,282
"Worthing 009E","E01031834","15-19 years","Female",58,57,51,44,52,262
"Worthing 009E","E01031834","20-24 years","Female",33,37,36,46,49,201
"Worthing 009E","E01031834","25-29 years","Female",34,32,30,27,27,150
"Worthing 009E","E01031834","30-34 years","Female",46,41,34,27,26,174
"Worthing 009E","E01031834","35-39 years","Female",63,58,62,57,56,296
"Worthing 009E","E01031834","40-44 years","Female",81,68,60,65,72,346
"Worthing 009E","E01031834","45-49 years","Female",83,85,93,101,101,463
"Worthing 009E","E01031834","50-54 years","Female",68,68,60,55,57,308
"Worthing 009E","E01031834","55-59 years","Female",47,45,59,62,57,270
"Worthing 009E","E01031834","60-64 years","Female",54,50,51,52,48,255
"Worthing 009E","E01031834","65-69 years","Female",46,46,47,49,50,238
"Worthing 009E","E01031834","70-74 years","Female",34,34,45,42,44,199
"Worthing 009E","E01031834","75-79 years","Female",17,17,16,22,16,88
"Worthing 009E","E01031834","80-84 years","Female",14,9,9,9,11,52
"Worthing 009E","E01031834","85+ years","Female",10,10,7,9,9,45
"Worthing 010A","E01031790","0-4 years","Male",44,42,30,29,36,181
"Worthing 010A","E01031790","5-9 years","Male",37,33,38,34,38,180
"Worthing 010A","E01031790","10-14 years","Male",19,19,21,25,27,111
"Worthing 010A","E01031790","15-19 years","Male",27,33,34,33,31,158
"Worthing 010A","E01031790","20-24 years","Male",54,48,51,45,49,247
"Worthing 010A","E01031790","25-29 years","Male",71,68,60,60,53,312
"Worthing 010A","E01031790","30-34 years","Male",71,74,80,68,57,350
"Worthing 010A","E01031790","35-39 years","Male",56,75,63,66,74,334
"Worthing 010A","E01031790","40-44 years","Male",59,55,59,47,50,270
"Worthing 010A","E01031790","45-49 years","Male",50,54,61,68,58,291
"Worthing 010A","E01031790","50-54 years","Male",66,72,73,83,77,371
"Worthing 010A","E01031790","55-59 years","Male",65,69,70,66,74,344
"Worthing 010A","E01031790","60-64 years","Male",68,61,67,61,58,315
"Worthing 010A","E01031790","65-69 years","Male",48,52,55,66,65,286
"Worthing 010A","E01031790","70-74 years","Male",39,48,50,48,55,240
"Worthing 010A","E01031790","75-79 years","Male",47,49,54,49,42,241
"Worthing 010A","E01031790","80-84 years","Male",25,17,20,34,31,127
"Worthing 010A","E01031790","85+ years","Male",48,52,45,46,49,240
"Worthing 010A","E01031790","0-4 years","Female",50,47,41,42,35,215
"Worthing 010A","E01031790","5-9 years","Female",31,31,32,32,32,158
"Worthing 010A","E01031790","10-14 years","Female",16,21,24,26,31,118
"Worthing 010A","E01031790","15-19 years","Female",36,34,25,22,21,138
"Worthing 010A","E01031790","20-24 years","Female",57,48,44,48,55,252
"Worthing 010A","E01031790","25-29 years","Female",77,78,72,65,54,346
"Worthing 010A","E01031790","30-34 years","Female",80,67,59,58,63,327
"Worthing 010A","E01031790","35-39 years","Female",69,66,59,50,60,304
"Worthing 010A","E01031790","40-44 years","Female",70,68,63,70,65,336
"Worthing 010A","E01031790","45-49 years","Female",62,56,64,76,75,333
"Worthing 010A","E01031790","50-54 years","Female",92,87,83,67,69,398
"Worthing 010A","E01031790","55-59 years","Female",49,56,65,67,67,304
"Worthing 010A","E01031790","60-64 years","Female",45,48,49,49,45,236
"Worthing 010A","E01031790","65-69 years","Female",53,51,50,56,63,273
"Worthing 010A","E01031790","70-74 years","Female",51,54,60,56,56,277
"Worthing 010A","E01031790","75-79 years","Female",52,42,45,43,35,217
"Worthing 010A","E01031790","80-84 years","Female",47,55,48,59,60,269
"Worthing 010A","E01031790","85+ years","Female",139,135,146,135,123,678
"Worthing 010B","E01031807","0-4 years","Male",39,45,53,49,48,234
"Worthing 010B","E01031807","5-9 years","Male",47,45,47,48,51,238
"Worthing 010B","E01031807","10-14 years","Male",25,28,26,33,32,144
"Worthing 010B","E01031807","15-19 years","Male",21,20,23,24,21,109
"Worthing 010B","E01031807","20-24 years","Male",38,26,31,23,22,140
"Worthing 010B","E01031807","25-29 years","Male",45,51,45,50,56,247
"Worthing 010B","E01031807","30-34 years","Male",41,43,44,43,42,213
"Worthing 010B","E01031807","35-39 years","Male",53,49,53,48,44,247
"Worthing 010B","E01031807","40-44 years","Male",47,49,43,42,54,235
"Worthing 010B","E01031807","45-49 years","Male",41,45,47,51,52,236
"Worthing 010B","E01031807","50-54 years","Male",69,65,65,56,63,318
"Worthing 010B","E01031807","55-59 years","Male",58,66,61,62,51,298
"Worthing 010B","E01031807","60-64 years","Male",50,57,53,64,82,306
"Worthing 010B","E01031807","65-69 years","Male",72,49,55,47,43,266
"Worthing 010B","E01031807","70-74 years","Male",34,53,50,55,60,252
"Worthing 010B","E01031807","75-79 years","Male",46,41,48,39,38,212
"Worthing 010B","E01031807","80-84 years","Male",36,44,43,46,48,217
"Worthing 010B","E01031807","85+ years","Male",62,62,58,60,57,299
"Worthing 010B","E01031807","0-4 years","Female",40,37,39,46,39,201
"Worthing 010B","E01031807","5-9 years","Female",19,28,31,31,37,146
"Worthing 010B","E01031807","10-14 years","Female",23,21,19,21,20,104
"Worthing 010B","E01031807","15-19 years","Female",19,17,17,17,21,91
"Worthing 010B","E01031807","20-24 years","Female",41,39,36,40,41,197
"Worthing 010B","E01031807","25-29 years","Female",58,57,62,50,43,270
"Worthing 010B","E01031807","30-34 years","Female",60,57,58,68,69,312
"Worthing 010B","E01031807","35-39 years","Female",45,50,45,47,47,234
"Worthing 010B","E01031807","40-44 years","Female",45,45,49,44,55,238
"Worthing 010B","E01031807","45-49 years","Female",28,21,23,26,28,126
"Worthing 010B","E01031807","50-54 years","Female",67,78,60,59,48,312
"Worthing 010B","E01031807","55-59 years","Female",54,55,64,67,76,316
"Worthing 010B","E01031807","60-64 years","Female",57,56,60,56,54,283
"Worthing 010B","E01031807","65-69 years","Female",63,59,51,49,54,276
"Worthing 010B","E01031807","70-74 years","Female",66,72,83,105,111,437
"Worthing 010B","E01031807","75-79 years","Female",48,55,57,62,71,293
"Worthing 010B","E01031807","80-84 years","Female",58,54,64,66,54,296
"Worthing 010B","E01031807","85+ years","Female",155,161,149,137,124,726
"Worthing 010C","E01031809","0-4 years","Male",44,43,45,41,40,213
"Worthing 010C","E01031809","5-9 years","Male",36,28,30,34,32,160
"Worthing 010C","E01031809","10-14 years","Male",13,16,12,14,13,68
"Worthing 010C","E01031809","15-19 years","Male",22,25,17,19,16,99
"Worthing 010C","E01031809","20-24 years","Male",44,51,50,44,41,230
"Worthing 010C","E01031809","25-29 years","Male",91,72,84,86,84,417
"Worthing 010C","E01031809","30-34 years","Male",37,49,59,61,63,269
"Worthing 010C","E01031809","35-39 years","Male",72,70,66,69,75,352
"Worthing 010C","E01031809","40-44 years","Male",43,43,39,36,37,198
"Worthing 010C","E01031809","45-49 years","Male",74,68,72,69,60,343
"Worthing 010C","E01031809","50-54 years","Male",54,66,72,55,65,312
"Worthing 010C","E01031809","55-59 years","Male",62,61,71,83,89,366
"Worthing 010C","E01031809","60-64 years","Male",45,45,48,47,45,230
"Worthing 010C","E01031809","65-69 years","Male",53,44,43,40,49,229
"Worthing 010C","E01031809","70-74 years","Male",56,61,66,61,61,305
"Worthing 010C","E01031809","75-79 years","Male",43,44,51,57,60,255
"Worthing 010C","E01031809","80-84 years","Male",19,18,21,26,30,114
"Worthing 010C","E01031809","85+ years","Male",21,20,21,22,32,116
"Worthing 010C","E01031809","0-4 years","Female",39,39,47,53,50,228
"Worthing 010C","E01031809","5-9 years","Female",18,18,16,13,14,79
"Worthing 010C","E01031809","10-14 years","Female",18,16,17,19,14,84
"Worthing 010C","E01031809","15-19 years","Female",21,19,14,12,13,79
"Worthing 010C","E01031809","20-24 years","Female",45,36,43,48,43,215
"Worthing 010C","E01031809","25-29 years","Female",56,63,75,66,62,322
"Worthing 010C","E01031809","30-34 years","Female",76,74,64,67,59,340
"Worthing 010C","E01031809","35-39 years","Female",49,52,54,58,55,268
"Worthing 010C","E01031809","40-44 years","Female",52,49,51,48,45,245
"Worthing 010C","E01031809","45-49 years","Female",50,59,47,55,60,271
"Worthing 010C","E01031809","50-54 years","Female",60,56,66,73,75,330
"Worthing 010C","E01031809","55-59 years","Female",53,63,66,69,80,331
"Worthing 010C","E01031809","60-64 years","Female",46,45,46,48,47,232
"Worthing 010C","E01031809","65-69 years","Female",52,50,49,42,41,234
"Worthing 010C","E01031809","70-74 years","Female",69,69,71,75,64,348
"Worthing 010C","E01031809","75-79 years","Female",45,47,48,55,68,263
"Worthing 010C","E01031809","80-84 years","Female",33,29,31,37,46,176
"Worthing 010C","E01031809","85+ years","Female",44,38,47,47,54,230
"Worthing 010D","E01031810","0-4 years","Male",61,52,40,40,46,239
"Worthing 010D","E01031810","5-9 years","Male",44,44,50,44,52,234
"Worthing 010D","E01031810","10-14 years","Male",44,46,40,27,22,179
"Worthing 010D","E01031810","15-19 years","Male",30,25,36,40,45,176
"Worthing 010D","E01031810","20-24 years","Male",56,57,47,42,42,244
"Worthing 010D","E01031810","25-29 years","Male",62,65,62,52,50,291
"Worthing 010D","E01031810","30-34 years","Male",73,79,77,75,74,378
"Worthing 010D","E01031810","35-39 years","Male",51,58,54,55,50,268
"Worthing 010D","E01031810","40-44 years","Male",56,57,67,66,68,314
"Worthing 010D","E01031810","45-49 years","Male",89,90,71,66,79,395
"Worthing 010D","E01031810","50-54 years","Male",60,67,78,73,63,341
"Worthing 010D","E01031810","55-59 years","Male",38,35,38,49,54,214
"Worthing 010D","E01031810","60-64 years","Male",24,31,33,33,34,155
"Worthing 010D","E01031810","65-69 years","Male",37,32,29,32,33,163
"Worthing 010D","E01031810","70-74 years","Male",23,26,29,22,28,128
"Worthing 010D","E01031810","75-79 years","Male",19,22,24,28,26,119
"Worthing 010D","E01031810","80-84 years","Male",7,9,13,13,16,58
"Worthing 010D","E01031810","85+ years","Male",22,19,15,16,17,89
"Worthing 010D","E01031810","0-4 years","Female",52,46,55,53,51,257
"Worthing 010D","E01031810","5-9 years","Female",45,45,42,44,44,220
"Worthing 010D","E01031810","10-14 years","Female",41,48,45,43,46,223
"Worthing 010D","E01031810","15-19 years","Female",34,40,42,40,47,203
"Worthing 010D","E01031810","20-24 years","Female",41,31,36,40,38,186
"Worthing 010D","E01031810","25-29 years","Female",55,52,51,47,47,252
"Worthing 010D","E01031810","30-34 years","Female",76,82,82,67,79,386
"Worthing 010D","E01031810","35-39 years","Female",67,74,75,68,73,357
"Worthing 010D","E01031810","40-44 years","Female",78,71,65,67,58,339
"Worthing 010D","E01031810","45-49 years","Female",60,66,61,62,71,320
"Worthing 010D","E01031810","50-54 years","Female",63,62,68,66,54,313
"Worthing 010D","E01031810","55-59 years","Female",53,55,60,69,80,317
"Worthing 010D","E01031810","60-64 years","Female",38,37,43,45,49,212
"Worthing 010D","E01031810","65-69 years","Female",44,40,38,41,34,197
"Worthing 010D","E01031810","70-74 years","Female",33,42,42,41,45,203
"Worthing 010D","E01031810","75-79 years","Female",28,32,28,29,37,154
"Worthing 010D","E01031810","80-84 years","Female",14,14,16,12,17,73
"Worthing 010D","E01031810","85+ years","Female",38,30,29,34,34,165
"Worthing 010E","E01031811","0-4 years","Male",24,21,23,21,27,116
"Worthing 010E","E01031811","5-9 years","Male",35,34,34,36,20,159
"Worthing 010E","E01031811","10-14 years","Male",18,26,23,19,31,117
"Worthing 010E","E01031811","15-19 years","Male",14,17,12,16,14,73
"Worthing 010E","E01031811","20-24 years","Male",48,37,40,42,37,204
"Worthing 010E","E01031811","25-29 years","Male",68,66,60,67,64,325
"Worthing 010E","E01031811","30-34 years","Male",54,67,68,57,57,303
"Worthing 010E","E01031811","35-39 years","Male",58,70,76,69,71,344
"Worthing 010E","E01031811","40-44 years","Male",61,74,66,59,49,309
"Worthing 010E","E01031811","45-49 years","Male",39,42,41,45,48,215
"Worthing 010E","E01031811","50-54 years","Male",60,57,55,60,66,298
"Worthing 010E","E01031811","55-59 years","Male",55,64,56,58,58,291
"Worthing 010E","E01031811","60-64 years","Male",51,47,57,53,56,264
"Worthing 010E","E01031811","65-69 years","Male",26,26,24,34,33,143
"Worthing 010E","E01031811","70-74 years","Male",42,43,52,53,53,243
"Worthing 010E","E01031811","75-79 years","Male",23,21,20,22,20,106
"Worthing 010E","E01031811","80-84 years","Male",19,23,22,30,21,115
"Worthing 010E","E01031811","85+ years","Male",38,41,30,33,34,176
"Worthing 010E","E01031811","0-4 years","Female",42,35,27,26,32,162
"Worthing 010E","E01031811","5-9 years","Female",31,31,35,25,33,155
"Worthing 010E","E01031811","10-14 years","Female",20,21,26,31,27,125
"Worthing 010E","E01031811","15-19 years","Female",26,26,24,23,23,122
"Worthing 010E","E01031811","20-24 years","Female",55,47,32,39,36,209
"Worthing 010E","E01031811","25-29 years","Female",68,69,75,80,75,367
"Worthing 010E","E01031811","30-34 years","Female",46,51,44,41,47,229
"Worthing 010E","E01031811","35-39 years","Female",57,52,41,43,43,236
"Worthing 010E","E01031811","40-44 years","Female",33,37,40,36,42,188
"Worthing 010E","E01031811","45-49 years","Female",41,47,40,45,37,210
"Worthing 010E","E01031811","50-54 years","Female",46,47,42,44,54,233
"Worthing 010E","E01031811","55-59 years","Female",36,42,50,51,50,229
"Worthing 010E","E01031811","60-64 years","Female",35,34,33,41,47,190
"Worthing 010E","E01031811","65-69 years","Female",53,55,47,43,34,232
"Worthing 010E","E01031811","70-74 years","Female",43,42,47,46,48,226
"Worthing 010E","E01031811","75-79 years","Female",26,34,37,36,44,177
"Worthing 010E","E01031811","80-84 years","Female",44,38,46,47,51,226
"Worthing 010E","E01031811","85+ years","Female",126,120,121,112,102,581
"Worthing 011A","E01031787","0-4 years","Male",56,62,66,60,47,291
"Worthing 011A","E01031787","5-9 years","Male",52,45,47,55,50,249
"Worthing 011A","E01031787","10-14 years","Male",30,29,28,25,27,139
"Worthing 011A","E01031787","15-19 years","Male",25,22,24,24,28,123
"Worthing 011A","E01031787","20-24 years","Male",89,90,74,84,81,418
"Worthing 011A","E01031787","25-29 years","Male",123,109,108,107,95,542
"Worthing 011A","E01031787","30-34 years","Male",139,126,117,119,110,611
"Worthing 011A","E01031787","35-39 years","Male",85,95,92,90,94,456
"Worthing 011A","E01031787","40-44 years","Male",90,74,73,75,67,379
"Worthing 011A","E01031787","45-49 years","Male",68,74,81,75,74,372
"Worthing 011A","E01031787","50-54 years","Male",81,78,66,80,76,381
"Worthing 011A","E01031787","55-59 years","Male",62,64,72,71,82,351
"Worthing 011A","E01031787","60-64 years","Male",42,46,46,49,56,239
"Worthing 011A","E01031787","65-69 years","Male",44,41,37,30,31,183
"Worthing 011A","E01031787","70-74 years","Male",35,41,45,51,46,218
"Worthing 011A","E01031787","75-79 years","Male",13,12,13,11,15,64
"Worthing 011A","E01031787","80-84 years","Male",18,16,18,20,16,88
"Worthing 011A","E01031787","85+ years","Male",27,24,19,22,26,118
"Worthing 011A","E01031787","0-4 years","Female",78,71,56,45,43,293
"Worthing 011A","E01031787","5-9 years","Female",40,34,34,36,32,176
"Worthing 011A","E01031787","10-14 years","Female",17,23,18,27,27,112
"Worthing 011A","E01031787","15-19 years","Female",40,34,32,24,25,155
"Worthing 011A","E01031787","20-24 years","Female",74,72,69,62,50,327
"Worthing 011A","E01031787","25-29 years","Female",102,113,98,106,84,503
"Worthing 011A","E01031787","30-34 years","Female",123,114,110,92,106,545
"Worthing 011A","E01031787","35-39 years","Female",81,79,82,89,86,417
"Worthing 011A","E01031787","40-44 years","Female",62,68,58,64,66,318
"Worthing 011A","E01031787","45-49 years","Female",71,71,84,78,70,374
"Worthing 011A","E01031787","50-54 years","Female",46,52,51,48,63,260
"Worthing 011A","E01031787","55-59 years","Female",40,40,38,45,49,212
"Worthing 011A","E01031787","60-64 years","Female",47,48,43,46,45,229
"Worthing 011A","E01031787","65-69 years","Female",35,40,46,41,41,203
"Worthing 011A","E01031787","70-74 years","Female",49,50,43,46,41,229
"Worthing 011A","E01031787","75-79 years","Female",43,46,45,48,52,234
"Worthing 011A","E01031787","80-84 years","Female",32,32,40,38,34,176
"Worthing 011A","E01031787","85+ years","Female",58,54,57,54,62,285
"Worthing 011B","E01031788","0-4 years","Male",97,84,83,87,80,431
"Worthing 011B","E01031788","5-9 years","Male",70,69,65,72,73,349
"Worthing 011B","E01031788","10-14 years","Male",48,58,59,48,52,265
"Worthing 011B","E01031788","15-19 years","Male",70,71,65,63,71,340
"Worthing 011B","E01031788","20-24 years","Male",81,83,75,69,62,370
"Worthing 011B","E01031788","25-29 years","Male",120,99,102,112,106,539
"Worthing 011B","E01031788","30-34 years","Male",89,79,87,89,102,446
"Worthing 011B","E01031788","35-39 years","Male",96,97,94,87,86,460
"Worthing 011B","E01031788","40-44 years","Male",76,69,80,82,78,385
"Worthing 011B","E01031788","45-49 years","Male",95,98,85,85,80,443
"Worthing 011B","E01031788","50-54 years","Male",68,77,75,84,82,386
"Worthing 011B","E01031788","55-59 years","Male",63,69,71,70,65,338
"Worthing 011B","E01031788","60-64 years","Male",37,33,39,42,47,198
"Worthing 011B","E01031788","65-69 years","Male",36,33,28,28,33,158
"Worthing 011B","E01031788","70-74 years","Male",37,41,42,33,32,185
"Worthing 011B","E01031788","75-79 years","Male",32,28,24,36,38,158
"Worthing 011B","E01031788","80-84 years","Male",17,23,31,24,33,128
"Worthing 011B","E01031788","85+ years","Male",20,18,24,28,19,109
"Worthing 011B","E01031788","0-4 years","Female",90,85,84,82,71,412
"Worthing 011B","E01031788","5-9 years","Female",85,94,89,85,80,433
"Worthing 011B","E01031788","10-14 years","Female",46,54,51,49,52,252
"Worthing 011B","E01031788","15-19 years","Female",34,39,38,46,43,200
"Worthing 011B","E01031788","20-24 years","Female",57,68,55,60,43,283
"Worthing 011B","E01031788","25-29 years","Female",93,95,104,88,87,467
"Worthing 011B","E01031788","30-34 years","Female",100,109,104,119,114,546
"Worthing 011B","E01031788","35-39 years","Female",99,87,89,77,80,432
"Worthing 011B","E01031788","40-44 years","Female",88,101,95,77,85,446
"Worthing 011B","E01031788","45-49 years","Female",65,68,66,85,79,363
"Worthing 011B","E01031788","50-54 years","Female",77,77,73,71,68,366
"Worthing 011B","E01031788","55-59 years","Female",61,62,66,76,83,348
"Worthing 011B","E01031788","60-64 years","Female",31,30,34,36,40,171
"Worthing 011B","E01031788","65-69 years","Female",36,34,34,31,33,168
"Worthing 011B","E01031788","70-74 years","Female",39,42,38,42,42,203
"Worthing 011B","E01031788","75-79 years","Female",25,30,33,31,36,155
"Worthing 011B","E01031788","80-84 years","Female",32,38,36,42,44,192
"Worthing 011B","E01031788","85+ years","Female",78,69,68,59,59,333
"Worthing 011C","E01031789","0-4 years","Male",68,58,52,59,54,291
"Worthing 011C","E01031789","5-9 years","Male",37,47,38,35,31,188
"Worthing 011C","E01031789","10-14 years","Male",40,40,52,54,49,235
"Worthing 011C","E01031789","15-19 years","Male",40,45,44,45,45,219
"Worthing 011C","E01031789","20-24 years","Male",67,80,70,68,57,342
"Worthing 011C","E01031789","25-29 years","Male",80,94,102,105,99,480
"Worthing 011C","E01031789","30-34 years","Male",89,90,99,108,104,490
"Worthing 011C","E01031789","35-39 years","Male",83,81,67,75,76,382
"Worthing 011C","E01031789","40-44 years","Male",121,113,108,101,110,553
"Worthing 011C","E01031789","45-49 years","Male",95,94,105,99,121,514
"Worthing 011C","E01031789","50-54 years","Male",74,76,83,97,91,421
"Worthing 011C","E01031789","55-59 years","Male",52,60,57,56,64,289
"Worthing 011C","E01031789","60-64 years","Male",51,54,58,67,75,305
"Worthing 011C","E01031789","65-69 years","Male",75,73,64,54,55,321
"Worthing 011C","E01031789","70-74 years","Male",43,60,60,66,69,298
"Worthing 011C","E01031789","75-79 years","Male",28,25,25,27,25,130
"Worthing 011C","E01031789","80-84 years","Male",27,26,26,25,20,124
"Worthing 011C","E01031789","85+ years","Male",31,34,26,21,25,137
"Worthing 011C","E01031789","0-4 years","Female",68,65,60,63,57,313
"Worthing 011C","E01031789","5-9 years","Female",47,47,52,40,44,230
"Worthing 011C","E01031789","10-14 years","Female",38,40,38,54,50,220
"Worthing 011C","E01031789","15-19 years","Female",30,33,35,34,39,171
"Worthing 011C","E01031789","20-24 years","Female",80,70,78,74,73,375
"Worthing 011C","E01031789","25-29 years","Female",112,110,98,109,105,534
"Worthing 011C","E01031789","30-34 years","Female",83,79,93,102,111,468
"Worthing 011C","E01031789","35-39 years","Female",99,88,76,64,66,393
"Worthing 011C","E01031789","40-44 years","Female",70,72,60,62,54,318
"Worthing 011C","E01031789","45-49 years","Female",80,80,87,86,94,427
"Worthing 011C","E01031789","50-54 years","Female",76,93,91,100,106,466
"Worthing 011C","E01031789","55-59 years","Female",42,46,53,62,72,275
"Worthing 011C","E01031789","60-64 years","Female",39,45,41,45,44,214
"Worthing 011C","E01031789","65-69 years","Female",56,52,51,55,51,265
"Worthing 011C","E01031789","70-74 years","Female",60,64,63,61,61,309
"Worthing 011C","E01031789","75-79 years","Female",46,42,42,51,53,234
"Worthing 011C","E01031789","80-84 years","Female",37,41,41,44,45,208
"Worthing 011C","E01031789","85+ years","Female",46,48,39,38,38,209
"Worthing 011D","E01031808","0-4 years","Male",49,31,31,34,35,180
"Worthing 011D","E01031808","5-9 years","Male",21,28,31,27,27,134
"Worthing 011D","E01031808","10-14 years","Male",8,9,11,13,18,59
"Worthing 011D","E01031808","15-19 years","Male",28,25,22,24,23,122
"Worthing 011D","E01031808","20-24 years","Male",34,38,40,44,38,194
"Worthing 011D","E01031808","25-29 years","Male",84,104,101,86,75,450
"Worthing 011D","E01031808","30-34 years","Male",83,73,80,83,63,382
"Worthing 011D","E01031808","35-39 years","Male",91,98,105,98,99,491
"Worthing 011D","E01031808","40-44 years","Male",83,77,75,88,96,419
"Worthing 011D","E01031808","45-49 years","Male",73,68,72,67,58,338
"Worthing 011D","E01031808","50-54 years","Male",61,64,66,76,82,349
"Worthing 011D","E01031808","55-59 years","Male",55,65,69,67,68,324
"Worthing 011D","E01031808","60-64 years","Male",23,26,28,26,29,132
"Worthing 011D","E01031808","65-69 years","Male",27,24,21,24,27,123
"Worthing 011D","E01031808","70-74 years","Male",25,28,22,23,27,125
"Worthing 011D","E01031808","75-79 years","Male",33,29,31,29,31,153
"Worthing 011D","E01031808","80-84 years","Male",11,19,18,23,21,92
"Worthing 011D","E01031808","85+ years","Male",38,34,33,39,31,175
"Worthing 011D","E01031808","0-4 years","Female",33,39,28,26,23,149
"Worthing 011D","E01031808","5-9 years","Female",15,11,15,17,17,75
"Worthing 011D","E01031808","10-14 years","Female",21,27,22,28,26,124
"Worthing 011D","E01031808","15-19 years","Female",16,15,23,32,26,112
"Worthing 011D","E01031808","20-24 years","Female",52,56,49,45,50,252
"Worthing 011D","E01031808","25-29 years","Female",89,76,71,83,65,384
"Worthing 011D","E01031808","30-34 years","Female",62,60,61,61,65,309
"Worthing 011D","E01031808","35-39 years","Female",45,57,59,66,78,305
"Worthing 011D","E01031808","40-44 years","Female",50,39,41,48,45,223
"Worthing 011D","E01031808","45-49 years","Female",45,49,44,39,44,221
"Worthing 011D","E01031808","50-54 years","Female",33,37,46,54,51,221
"Worthing 011D","E01031808","55-59 years","Female",51,51,44,48,54,248
"Worthing 011D","E01031808","60-64 years","Female",30,31,25,28,24,138
"Worthing 011D","E01031808","65-69 years","Female",34,30,34,24,31,153
"Worthing 011D","E01031808","70-74 years","Female",28,36,31,32,30,157
"Worthing 011D","E01031808","75-79 years","Female",41,39,32,37,35,184
"Worthing 011D","E01031808","80-84 years","Female",39,40,42,40,34,195
"Worthing 011D","E01031808","85+ years","Female",85,96,89,93,84,447
"Worthing 011E","E01031835","0-4 years","Male",65,54,54,46,46,265
"Worthing 011E","E01031835","5-9 years","Male",30,36,39,41,38,184
"Worthing 011E","E01031835","10-14 years","Male",45,39,38,38,41,201
"Worthing 011E","E01031835","15-19 years","Male",32,33,34,27,33,159
"Worthing 011E","E01031835","20-24 years","Male",79,78,74,65,71,367
"Worthing 011E","E01031835","25-29 years","Male",72,80,80,85,74,391
"Worthing 011E","E01031835","30-34 years","Male",109,120,126,111,125,591
"Worthing 011E","E01031835","35-39 years","Male",106,100,97,89,102,494
"Worthing 011E","E01031835","40-44 years","Male",78,86,88,84,83,419
"Worthing 011E","E01031835","45-49 years","Male",91,83,83,84,72,413
"Worthing 011E","E01031835","50-54 years","Male",58,70,80,77,80,365
"Worthing 011E","E01031835","55-59 years","Male",50,51,51,62,68,282
"Worthing 011E","E01031835","60-64 years","Male",61,59,58,66,58,302
"Worthing 011E","E01031835","65-69 years","Male",55,59,51,46,51,262
"Worthing 011E","E01031835","70-74 years","Male",40,47,52,62,60,261
"Worthing 011E","E01031835","75-79 years","Male",20,18,18,15,18,89
"Worthing 011E","E01031835","80-84 years","Male",11,12,14,14,11,62
"Worthing 011E","E01031835","85+ years","Male",16,12,12,13,15,68
"Worthing 011E","E01031835","0-4 years","Female",63,55,61,51,48,278
"Worthing 011E","E01031835","5-9 years","Female",29,33,31,32,36,161
"Worthing 011E","E01031835","10-14 years","Female",27,30,23,27,33,140
"Worthing 011E","E01031835","15-19 years","Female",32,24,22,28,26,132
"Worthing 011E","E01031835","20-24 years","Female",55,49,55,50,57,266
"Worthing 011E","E01031835","25-29 years","Female",76,82,85,77,66,386
"Worthing 011E","E01031835","30-34 years","Female",85,87,86,95,95,448
"Worthing 011E","E01031835","35-39 years","Female",78,69,74,78,78,377
"Worthing 011E","E01031835","40-44 years","Female",93,91,90,80,84,438
"Worthing 011E","E01031835","45-49 years","Female",60,58,57,59,55,289
"Worthing 011E","E01031835","50-54 years","Female",69,70,72,73,70,354
"Worthing 011E","E01031835","55-59 years","Female",72,72,71,74,78,367
"Worthing 011E","E01031835","60-64 years","Female",46,48,63,60,62,279
"Worthing 011E","E01031835","65-69 years","Female",76,61,55,50,51,293
"Worthing 011E","E01031835","70-74 years","Female",33,42,45,49,46,215
"Worthing 011E","E01031835","75-79 years","Female",17,22,27,29,32,127
"Worthing 011E","E01031835","80-84 years","Female",23,23,16,16,17,95
"Worthing 011E","E01031835","85+ years","Female",24,28,27,25,23,127
"Worthing 012A","E01031812","0-4 years","Male",16,14,15,19,20,84
"Worthing 012A","E01031812","5-9 years","Male",31,25,19,16,12,103
"Worthing 012A","E01031812","10-14 years","Male",26,29,27,27,30,139
"Worthing 012A","E01031812","15-19 years","Male",35,33,34,32,24,158
"Worthing 012A","E01031812","20-24 years","Male",53,53,42,51,59,258
"Worthing 012A","E01031812","25-29 years","Male",64,60,58,56,49,287
"Worthing 012A","E01031812","30-34 years","Male",58,60,58,57,57,290
"Worthing 012A","E01031812","35-39 years","Male",29,30,36,42,41,178
"Worthing 012A","E01031812","40-44 years","Male",45,38,41,37,41,202
"Worthing 012A","E01031812","45-49 years","Male",57,55,52,52,41,257
"Worthing 012A","E01031812","50-54 years","Male",39,52,49,53,47,240
"Worthing 012A","E01031812","55-59 years","Male",47,50,52,43,43,235
"Worthing 012A","E01031812","60-64 years","Male",49,52,41,58,61,261
"Worthing 012A","E01031812","65-69 years","Male",40,33,37,39,34,183
"Worthing 012A","E01031812","70-74 years","Male",55,60,59,61,58,293
"Worthing 012A","E01031812","75-79 years","Male",42,44,50,52,61,249
"Worthing 012A","E01031812","80-84 years","Male",36,41,45,50,45,217
"Worthing 012A","E01031812","85+ years","Male",42,39,43,47,41,212
"Worthing 012A","E01031812","0-4 years","Female",27,29,31,32,23,142
"Worthing 012A","E01031812","5-9 years","Female",28,26,27,29,28,138
"Worthing 012A","E01031812","10-14 years","Female",15,16,19,19,20,89
"Worthing 012A","E01031812","15-19 years","Female",37,35,27,30,32,161
"Worthing 012A","E01031812","20-24 years","Female",40,36,36,29,32,173
"Worthing 012A","E01031812","25-29 years","Female",32,42,37,37,36,184
"Worthing 012A","E01031812","30-34 years","Female",53,54,43,38,29,217
"Worthing 012A","E01031812","35-39 years","Female",45,39,46,57,51,238
"Worthing 012A","E01031812","40-44 years","Female",40,47,40,42,50,219
"Worthing 012A","E01031812","45-49 years","Female",37,33,30,34,36,170
"Worthing 012A","E01031812","50-54 years","Female",62,61,54,53,53,283
"Worthing 012A","E01031812","55-59 years","Female",47,48,49,43,44,231
"Worthing 012A","E01031812","60-64 years","Female",56,63,74,80,81,354
"Worthing 012A","E01031812","65-69 years","Female",57,51,48,45,49,250
"Worthing 012A","E01031812","70-74 years","Female",62,64,66,70,65,327
"Worthing 012A","E01031812","75-79 years","Female",59,53,51,50,53,266
"Worthing 012A","E01031812","80-84 years","Female",63,75,78,70,71,357
"Worthing 012A","E01031812","85+ years","Female",107,106,97,110,103,523
"Worthing 012B","E01031813","0-4 years","Male",57,63,50,48,39,257
"Worthing 012B","E01031813","5-9 years","Male",49,53,61,55,60,278
"Worthing 012B","E01031813","10-14 years","Male",40,40,39,41,44,204
"Worthing 012B","E01031813","15-19 years","Male",52,46,48,48,52,246
"Worthing 012B","E01031813","20-24 years","Male",63,54,54,47,47,265
"Worthing 012B","E01031813","25-29 years","Male",44,47,38,50,47,226
"Worthing 012B","E01031813","30-34 years","Male",27,23,26,24,22,122
"Worthing 012B","E01031813","35-39 years","Male",42,52,39,41,47,221
"Worthing 012B","E01031813","40-44 years","Male",56,64,65,65,60,310
"Worthing 012B","E01031813","45-49 years","Male",71,58,65,62,65,321
"Worthing 012B","E01031813","50-54 years","Male",65,65,63,68,62,323
"Worthing 012B","E01031813","55-59 years","Male",82,77,73,70,62,364
"Worthing 012B","E01031813","60-64 years","Male",49,59,56,67,74,305
"Worthing 012B","E01031813","65-69 years","Male",50,45,46,45,46,232
"Worthing 012B","E01031813","70-74 years","Male",47,55,50,51,60,263
"Worthing 012B","E01031813","75-79 years","Male",16,17,23,25,27,108
"Worthing 012B","E01031813","80-84 years","Male",19,14,15,15,16,79
"Worthing 012B","E01031813","85+ years","Male",19,15,15,16,9,74
"Worthing 012B","E01031813","0-4 years","Female",51,49,42,29,31,202
"Worthing 012B","E01031813","5-9 years","Female",61,56,50,46,45,258
"Worthing 012B","E01031813","10-14 years","Female",53,53,59,56,53,274
"Worthing 012B","E01031813","15-19 years","Female",46,39,35,36,34,190
"Worthing 012B","E01031813","20-24 years","Female",52,49,47,55,48,251
"Worthing 012B","E01031813","25-29 years","Female",35,27,33,38,36,169
"Worthing 012B","E01031813","30-34 years","Female",59,52,43,39,38,231
"Worthing 012B","E01031813","35-39 years","Female",51,54,52,50,48,255
"Worthing 012B","E01031813","40-44 years","Female",57,53,49,49,51,259
"Worthing 012B","E01031813","45-49 years","Female",75,75,81,77,81,389
"Worthing 012B","E01031813","50-54 years","Female",74,72,69,64,55,334
"Worthing 012B","E01031813","55-59 years","Female",67,77,77,81,76,378
"Worthing 012B","E01031813","60-64 years","Female",52,50,53,51,51,257
"Worthing 012B","E01031813","65-69 years","Female",69,75,66,59,59,328
"Worthing 012B","E01031813","70-74 years","Female",45,67,80,92,102,386
"Worthing 012B","E01031813","75-79 years","Female",27,21,22,28,26,124
"Worthing 012B","E01031813","80-84 years","Female",43,45,33,31,31,183
"Worthing 012B","E01031813","85+ years","Female",50,48,47,47,49,241
"Worthing 012C","E01031814","0-4 years","Male",39,41,38,38,35,191
"Worthing 012C","E01031814","5-9 years","Male",41,37,36,31,31,176
"Worthing 012C","E01031814","10-14 years","Male",32,43,44,40,44,203
"Worthing 012C","E01031814","15-19 years","Male",40,36,37,38,32,183
"Worthing 012C","E01031814","20-24 years","Male",26,31,23,27,35,142
"Worthing 012C","E01031814","25-29 years","Male",50,46,50,51,41,238
"Worthing 012C","E01031814","30-34 years","Male",37,48,58,43,51,237
"Worthing 012C","E01031814","35-39 years","Male",33,33,32,33,29,160
"Worthing 012C","E01031814","40-44 years","Male",64,54,61,52,51,282
"Worthing 012C","E01031814","45-49 years","Male",47,48,47,62,64,268
"Worthing 012C","E01031814","50-54 years","Male",74,74,71,60,56,335
"Worthing 012C","E01031814","55-59 years","Male",49,50,62,64,65,290
"Worthing 012C","E01031814","60-64 years","Male",54,60,50,62,62,288
"Worthing 012C","E01031814","65-69 years","Male",63,58,55,53,55,284
"Worthing 012C","E01031814","70-74 years","Male",42,48,48,54,51,243
"Worthing 012C","E01031814","75-79 years","Male",57,51,37,33,37,215
"Worthing 012C","E01031814","80-84 years","Male",24,26,37,40,43,170
"Worthing 012C","E01031814","85+ years","Male",26,31,29,28,33,147
"Worthing 012C","E01031814","0-4 years","Female",31,30,34,35,35,165
"Worthing 012C","E01031814","5-9 years","Female",31,29,29,36,28,153
"Worthing 012C","E01031814","10-14 years","Female",31,33,35,31,38,168
"Worthing 012C","E01031814","15-19 years","Female",28,29,23,35,30,145
"Worthing 012C","E01031814","20-24 years","Female",37,38,31,29,25,160
"Worthing 012C","E01031814","25-29 years","Female",43,40,38,27,29,177
"Worthing 012C","E01031814","30-34 years","Female",44,40,50,57,54,245
"Worthing 012C","E01031814","35-39 years","Female",39,44,38,30,27,178
"Worthing 012C","E01031814","40-44 years","Female",37,36,37,36,41,187
"Worthing 012C","E01031814","45-49 years","Female",55,57,59,57,54,282
"Worthing 012C","E01031814","50-54 years","Female",70,74,63,72,63,342
"Worthing 012C","E01031814","55-59 years","Female",84,79,83,78,90,414
"Worthing 012C","E01031814","60-64 years","Female",70,77,77,77,80,381
"Worthing 012C","E01031814","65-69 years","Female",65,62,58,67,63,315
"Worthing 012C","E01031814","70-74 years","Female",50,63,70,74,80,337
"Worthing 012C","E01031814","75-79 years","Female",56,49,53,54,54,266
"Worthing 012C","E01031814","80-84 years","Female",36,41,35,37,38,187
"Worthing 012C","E01031814","85+ years","Female",32,30,28,26,26,142
"Worthing 012D","E01031815","0-4 years","Male",21,33,30,29,33,146
"Worthing 012D","E01031815","5-9 years","Male",34,31,41,38,40,184
"Worthing 012D","E01031815","10-14 years","Male",21,26,28,25,24,124
"Worthing 012D","E01031815","15-19 years","Male",33,31,21,22,17,124
"Worthing 012D","E01031815","20-24 years","Male",27,28,25,24,31,135
"Worthing 012D","E01031815","25-29 years","Male",14,15,17,19,16,81
"Worthing 012D","E01031815","30-34 years","Male",30,29,29,28,29,145
"Worthing 012D","E01031815","35-39 years","Male",28,28,33,35,30,154
"Worthing 012D","E01031815","40-44 years","Male",36,27,30,27,31,151
"Worthing 012D","E01031815","45-49 years","Male",37,38,32,43,37,187
"Worthing 012D","E01031815","50-54 years","Male",55,49,56,49,42,251
"Worthing 012D","E01031815","55-59 years","Male",55,58,61,45,48,267
"Worthing 012D","E01031815","60-64 years","Male",70,60,54,71,69,324
"Worthing 012D","E01031815","65-69 years","Male",52,56,57,57,52,274
"Worthing 012D","E01031815","70-74 years","Male",46,49,53,58,61,267
"Worthing 012D","E01031815","75-79 years","Male",42,49,54,56,58,259
"Worthing 012D","E01031815","80-84 years","Male",37,37,39,38,45,196
"Worthing 012D","E01031815","85+ years","Male",48,56,49,49,49,251
"Worthing 012D","E01031815","0-4 years","Female",31,29,27,35,27,149
"Worthing 012D","E01031815","5-9 years","Female",22,23,24,23,25,117
"Worthing 012D","E01031815","10-14 years","Female",21,23,22,23,20,109
"Worthing 012D","E01031815","15-19 years","Female",18,20,23,22,21,104
"Worthing 012D","E01031815","20-24 years","Female",17,18,20,18,15,88
"Worthing 012D","E01031815","25-29 years","Female",37,32,21,24,32,146
"Worthing 012D","E01031815","30-34 years","Female",31,34,36,35,34,170
"Worthing 012D","E01031815","35-39 years","Female",34,31,35,42,41,183
"Worthing 012D","E01031815","40-44 years","Female",29,33,33,36,34,165
"Worthing 012D","E01031815","45-49 years","Female",48,55,51,48,39,241
"Worthing 012D","E01031815","50-54 years","Female",48,44,46,43,44,225
"Worthing 012D","E01031815","55-59 years","Female",58,56,55,46,44,259
"Worthing 012D","E01031815","60-64 years","Female",71,67,71,84,84,377
"Worthing 012D","E01031815","65-69 years","Female",68,71,66,55,44,304
"Worthing 012D","E01031815","70-74 years","Female",72,77,93,87,97,426
"Worthing 012D","E01031815","75-79 years","Female",55,49,48,68,67,287
"Worthing 012D","E01031815","80-84 years","Female",61,61,51,52,58,283
"Worthing 012D","E01031815","85+ years","Female",84,76,75,73,61,369
"Worthing 012E","E01031816","0-4 years","Male",45,43,42,49,46,225
"Worthing 012E","E01031816","5-9 years","Male",82,86,72,79,55,374
"Worthing 012E","E01031816","10-14 years","Male",68,75,80,78,88,389
"Worthing 012E","E01031816","15-19 years","Male",48,50,52,55,54,259
"Worthing 012E","E01031816","20-24 years","Male",27,24,26,26,30,133
"Worthing 012E","E01031816","25-29 years","Male",23,23,23,19,17,105
"Worthing 012E","E01031816","30-34 years","Male",43,45,47,41,43,219
"Worthing 012E","E01031816","35-39 years","Male",70,64,66,67,55,322
"Worthing 012E","E01031816","40-44 years","Male",58,55,49,59,60,281
"Worthing 012E","E01031816","45-49 years","Male",67,73,64,59,64,327
"Worthing 012E","E01031816","50-54 years","Male",50,59,54,57,63,283
"Worthing 012E","E01031816","55-59 years","Male",56,57,66,54,59,292
"Worthing 012E","E01031816","60-64 years","Male",43,36,44,56,52,231
"Worthing 012E","E01031816","65-69 years","Male",43,41,44,34,29,191
"Worthing 012E","E01031816","70-74 years","Male",33,38,36,43,46,196
"Worthing 012E","E01031816","75-79 years","Male",16,16,19,18,16,85
"Worthing 012E","E01031816","80-84 years","Male",10,9,10,13,10,52
"Worthing 012E","E01031816","85+ years","Male",15,18,21,17,17,88
"Worthing 012E","E01031816","0-4 years","Female",69,52,62,61,55,299
"Worthing 012E","E01031816","5-9 years","Female",56,60,46,48,49,259
"Worthing 012E","E01031816","10-14 years","Female",57,65,63,64,73,322
"Worthing 012E","E01031816","15-19 years","Female",47,51,60,59,52,269
"Worthing 012E","E01031816","20-24 years","Female",28,25,28,26,27,134
"Worthing 012E","E01031816","25-29 years","Female",36,31,34,29,29,159
"Worthing 012E","E01031816","30-34 years","Female",45,45,40,39,45,214
"Worthing 012E","E01031816","35-39 years","Female",71,73,65,65,58,332
"Worthing 012E","E01031816","40-44 years","Female",77,72,63,67,69,348
"Worthing 012E","E01031816","45-49 years","Female",72,79,90,91,80,412
"Worthing 012E","E01031816","50-54 years","Female",77,70,71,66,67,351
"Worthing 012E","E01031816","55-59 years","Female",42,54,59,61,68,284
"Worthing 012E","E01031816","60-64 years","Female",42,41,36,45,33,197
"Worthing 012E","E01031816","65-69 years","Female",41,40,40,38,44,203
"Worthing 012E","E01031816","70-74 years","Female",29,36,36,39,34,174
"Worthing 012E","E01031816","75-79 years","Female",25,24,23,23,25,120
"Worthing 012E","E01031816","80-84 years","Female",15,13,13,12,14,67
"Worthing 012E","E01031816","85+ years","Female",21,31,27,31,34,144
"Worthing 013A","E01031802","0-4 years","Male",25,22,18,19,19,103
"Worthing 013A","E01031802","5-9 years","Male",28,26,29,24,26,133
"Worthing 013A","E01031802","10-14 years","Male",29,28,24,25,25,131
"Worthing 013A","E01031802","15-19 years","Male",22,21,18,23,23,107
"Worthing 013A","E01031802","20-24 years","Male",25,24,23,24,24,120
"Worthing 013A","E01031802","25-29 years","Male",22,25,31,32,25,135
"Worthing 013A","E01031802","30-34 years","Male",15,19,14,18,26,92
"Worthing 013A","E01031802","35-39 years","Male",33,29,21,22,25,130
"Worthing 013A","E01031802","40-44 years","Male",32,34,40,39,34,179
"Worthing 013A","E01031802","45-49 years","Male",39,35,35,39,47,195
"Worthing 013A","E01031802","50-54 years","Male",35,38,36,33,33,175
"Worthing 013A","E01031802","55-59 years","Male",55,57,48,46,41,247
"Worthing 013A","E01031802","60-64 years","Male",60,62,59,58,50,289
"Worthing 013A","E01031802","65-69 years","Male",92,65,64,61,60,342
"Worthing 013A","E01031802","70-74 years","Male",88,112,110,114,110,534
"Worthing 013A","E01031802","75-79 years","Male",57,69,73,67,73,339
"Worthing 013A","E01031802","80-84 years","Male",60,56,60,66,57,299
"Worthing 013A","E01031802","85+ years","Male",55,51,45,47,55,253
"Worthing 013A","E01031802","0-4 years","Female",24,24,25,24,36,133
"Worthing 013A","E01031802","5-9 years","Female",24,28,29,30,33,144
"Worthing 013A","E01031802","10-14 years","Female",13,15,11,13,21,73
"Worthing 013A","E01031802","15-19 years","Female",27,24,20,18,18,107
"Worthing 013A","E01031802","20-24 years","Female",11,11,13,12,10,57
"Worthing 013A","E01031802","25-29 years","Female",17,22,24,29,25,117
"Worthing 013A","E01031802","30-34 years","Female",31,24,26,21,28,130
"Worthing 013A","E01031802","35-39 years","Female",39,33,35,35,37,179
"Worthing 013A","E01031802","40-44 years","Female",28,29,30,35,33,155
"Worthing 013A","E01031802","45-49 years","Female",35,33,25,18,18,129
"Worthing 013A","E01031802","50-54 years","Female",52,58,58,52,45,265
"Worthing 013A","E01031802","55-59 years","Female",58,54,61,66,70,309
"Worthing 013A","E01031802","60-64 years","Female",74,82,74,77,71,378
"Worthing 013A","E01031802","65-69 years","Female",88,80,76,76,82,402
"Worthing 013A","E01031802","70-74 years","Female",95,113,127,129,114,578
"Worthing 013A","E01031802","75-79 years","Female",102,97,92,92,111,494
"Worthing 013A","E01031802","80-84 years","Female",92,89,94,90,83,448
"Worthing 013A","E01031802","85+ years","Female",70,75,73,85,89,392
"Worthing 013B","E01031803","0-4 years","Male",14,13,18,19,14,78
"Worthing 013B","E01031803","5-9 years","Male",42,36,28,35,34,175
"Worthing 013B","E01031803","10-14 years","Male",44,44,47,39,34,208
"Worthing 013B","E01031803","15-19 years","Male",44,46,40,44,53,227
"Worthing 013B","E01031803","20-24 years","Male",26,25,26,27,24,128
"Worthing 013B","E01031803","25-29 years","Male",15,18,18,15,14,80
"Worthing 013B","E01031803","30-34 years","Male",20,17,20,20,19,96
"Worthing 013B","E01031803","35-39 years","Male",18,18,20,17,15,88
"Worthing 013B","E01031803","40-44 years","Male",33,35,33,32,32,165
"Worthing 013B","E01031803","45-49 years","Male",59,50,56,50,49,264
"Worthing 013B","E01031803","50-54 years","Male",64,62,60,66,55,307
"Worthing 013B","E01031803","55-59 years","Male",50,55,59,61,67,292
"Worthing 013B","E01031803","60-64 years","Male",62,64,64,65,67,322
"Worthing 013B","E01031803","65-69 years","Male",82,68,60,54,45,309
"Worthing 013B","E01031803","70-74 years","Male",54,61,60,64,66,305
"Worthing 013B","E01031803","75-79 years","Male",37,41,50,54,55,237
"Worthing 013B","E01031803","80-84 years","Male",28,30,25,30,34,147
"Worthing 013B","E01031803","85+ years","Male",25,21,25,23,25,119
"Worthing 013B","E01031803","0-4 years","Female",25,13,17,18,19,92
"Worthing 013B","E01031803","5-9 years","Female",33,38,36,36,37,180
"Worthing 013B","E01031803","10-14 years","Female",46,37,38,39,38,198
"Worthing 013B","E01031803","15-19 years","Female",28,34,40,38,39,179
"Worthing 013B","E01031803","20-24 years","Female",24,25,27,33,28,137
"Worthing 013B","E01031803","25-29 years","Female",17,15,15,15,16,78
"Worthing 013B","E01031803","30-34 years","Female",12,13,12,12,14,63
"Worthing 013B","E01031803","35-39 years","Female",21,15,16,18,18,88
"Worthing 013B","E01031803","40-44 years","Female",48,51,46,41,44,230
"Worthing 013B","E01031803","45-49 years","Female",59,59,53,53,52,276
"Worthing 013B","E01031803","50-54 years","Female",69,70,82,81,71,373
"Worthing 013B","E01031803","55-59 years","Female",61,69,77,86,85,378
"Worthing 013B","E01031803","60-64 years","Female",58,61,53,52,57,281
"Worthing 013B","E01031803","65-69 years","Female",72,72,68,60,52,324
"Worthing 013B","E01031803","70-74 years","Female",52,57,65,76,83,333
"Worthing 013B","E01031803","75-79 years","Female",59,53,49,50,54,265
"Worthing 013B","E01031803","80-84 years","Female",47,42,40,41,38,208
"Worthing 013B","E01031803","85+ years","Female",54,52,50,43,45,244
"Worthing 013C","E01031804","0-4 years","Male",26,19,25,21,22,113
"Worthing 013C","E01031804","5-9 years","Male",43,38,41,36,33,191
"Worthing 013C","E01031804","10-14 years","Male",54,55,53,50,50,262
"Worthing 013C","E01031804","15-19 years","Male",37,40,33,31,35,176
"Worthing 013C","E01031804","20-24 years","Male",26,23,25,23,23,120
"Worthing 013C","E01031804","25-29 years","Male",16,19,21,24,28,108
"Worthing 013C","E01031804","30-34 years","Male",15,10,13,19,17,74
"Worthing 013C","E01031804","35-39 years","Male",27,32,27,27,22,135
"Worthing 013C","E01031804","40-44 years","Male",44,45,37,35,41,202
"Worthing 013C","E01031804","45-49 years","Male",48,47,44,48,37,224
"Worthing 013C","E01031804","50-54 years","Male",57,53,62,58,62,292
"Worthing 013C","E01031804","55-59 years","Male",62,68,67,73,74,344
"Worthing 013C","E01031804","60-64 years","Male",67,63,60,64,68,322
"Worthing 013C","E01031804","65-69 years","Male",75,68,52,58,58,311
"Worthing 013C","E01031804","70-74 years","Male",72,82,88,86,83,411
"Worthing 013C","E01031804","75-79 years","Male",48,48,53,52,50,251
"Worthing 013C","E01031804","80-84 years","Male",46,51,44,46,43,230
"Worthing 013C","E01031804","85+ years","Male",43,46,50,48,38,225
"Worthing 013C","E01031804","0-4 years","Female",42,40,40,35,32,189
"Worthing 013C","E01031804","5-9 years","Female",28,29,22,24,29,132
"Worthing 013C","E01031804","10-14 years","Female",29,30,30,34,27,150
"Worthing 013C","E01031804","15-19 years","Female",38,38,29,27,25,157
"Worthing 013C","E01031804","20-24 years","Female",20,20,21,22,24,107
"Worthing 013C","E01031804","25-29 years","Female",16,19,16,14,15,80
"Worthing 013C","E01031804","30-34 years","Female",24,28,26,16,16,110
"Worthing 013C","E01031804","35-39 years","Female",36,33,36,36,29,170
"Worthing 013C","E01031804","40-44 years","Female",44,43,43,46,50,226
"Worthing 013C","E01031804","45-49 years","Female",51,45,46,48,46,236
"Worthing 013C","E01031804","50-54 years","Female",51,56,58,57,54,276
"Worthing 013C","E01031804","55-59 years","Female",75,76,64,74,66,355
"Worthing 013C","E01031804","60-64 years","Female",82,77,82,75,84,400
"Worthing 013C","E01031804","65-69 years","Female",86,93,90,84,80,433
"Worthing 013C","E01031804","70-74 years","Female",77,79,83,91,81,411
"Worthing 013C","E01031804","75-79 years","Female",60,64,73,81,73,351
"Worthing 013C","E01031804","80-84 years","Female",65,63,58,52,58,296
"Worthing 013C","E01031804","85+ years","Female",76,76,70,72,67,361
"Worthing 013D","E01031805","0-4 years","Male",13,12,12,9,8,54
"Worthing 013D","E01031805","5-9 years","Male",30,27,25,18,18,118
"Worthing 013D","E01031805","10-14 years","Male",36,31,24,42,39,172
"Worthing 013D","E01031805","15-19 years","Male",39,36,41,37,44,197
"Worthing 013D","E01031805","20-24 years","Male",24,22,17,23,18,104
"Worthing 013D","E01031805","25-29 years","Male",24,26,27,27,28,132
"Worthing 013D","E01031805","30-34 years","Male",23,25,23,24,26,121
"Worthing 013D","E01031805","35-39 years","Male",23,22,19,16,19,99
"Worthing 013D","E01031805","40-44 years","Male",37,41,31,30,23,162
"Worthing 013D","E01031805","45-49 years","Male",35,27,38,41,37,178
"Worthing 013D","E01031805","50-54 years","Male",57,56,51,59,57,280
"Worthing 013D","E01031805","55-59 years","Male",58,60,62,60,69,309
"Worthing 013D","E01031805","60-64 years","Male",44,48,56,55,59,262
"Worthing 013D","E01031805","65-69 years","Male",66,58,54,54,53,285
"Worthing 013D","E01031805","70-74 years","Male",96,95,101,111,100,503
"Worthing 013D","E01031805","75-79 years","Male",43,51,54,65,78,291
"Worthing 013D","E01031805","80-84 years","Male",53,45,38,34,36,206
"Worthing 013D","E01031805","85+ years","Male",51,45,37,33,39,205
"Worthing 013D","E01031805","0-4 years","Female",19,18,14,13,13,77
"Worthing 013D","E01031805","5-9 years","Female",32,37,31,29,26,155
"Worthing 013D","E01031805","10-14 years","Female",37,28,30,29,24,148
"Worthing 013D","E01031805","15-19 years","Female",25,24,21,20,23,113
"Worthing 013D","E01031805","20-24 years","Female",19,17,19,25,24,104
"Worthing 013D","E01031805","25-29 years","Female",25,18,22,22,20,107
"Worthing 013D","E01031805","30-34 years","Female",22,21,17,16,24,100
"Worthing 013D","E01031805","35-39 years","Female",25,25,21,18,17,106
"Worthing 013D","E01031805","40-44 years","Female",38,37,39,34,32,180
"Worthing 013D","E01031805","45-49 years","Female",52,59,44,52,55,262
"Worthing 013D","E01031805","50-54 years","Female",50,46,53,54,50,253
"Worthing 013D","E01031805","55-59 years","Female",52,51,55,57,65,280
"Worthing 013D","E01031805","60-64 years","Female",78,73,71,72,73,367
"Worthing 013D","E01031805","65-69 years","Female",94,80,81,83,88,426
"Worthing 013D","E01031805","70-74 years","Female",92,105,106,112,111,526
"Worthing 013D","E01031805","75-79 years","Female",70,64,62,67,76,339
"Worthing 013D","E01031805","80-84 years","Female",63,75,76,66,67,347
"Worthing 013D","E01031805","85+ years","Female",91,76,72,70,72,381
"Worthing 013E","E01031806","0-4 years","Male",52,62,55,54,51,274
"Worthing 013E","E01031806","5-9 years","Male",44,40,51,52,54,241
"Worthing 013E","E01031806","10-14 years","Male",66,56,48,47,50,267
"Worthing 013E","E01031806","15-19 years","Male",56,54,65,59,64,298
"Worthing 013E","E01031806","20-24 years","Male",36,35,28,34,32,165
"Worthing 013E","E01031806","25-29 years","Male",30,32,36,35,39,172
"Worthing 013E","E01031806","30-34 years","Male",61,56,58,52,48,275
"Worthing 013E","E01031806","35-39 years","Male",46,49,39,42,46,222
"Worthing 013E","E01031806","40-44 years","Male",51,55,60,56,62,284
"Worthing 013E","E01031806","45-49 years","Male",58,43,45,36,41,223
"Worthing 013E","E01031806","50-54 years","Male",78,85,81,80,77,401
"Worthing 013E","E01031806","55-59 years","Male",63,60,67,69,67,326
"Worthing 013E","E01031806","60-64 years","Male",24,29,32,35,37,157
"Worthing 013E","E01031806","65-69 years","Male",42,40,35,35,36,188
"Worthing 013E","E01031806","70-74 years","Male",36,39,43,42,48,208
"Worthing 013E","E01031806","75-79 years","Male",28,28,32,32,26,146
"Worthing 013E","E01031806","80-84 years","Male",13,20,12,12,11,68
"Worthing 013E","E01031806","85+ years","Male",28,21,21,24,23,117
"Worthing 013E","E01031806","0-4 years","Female",39,42,37,30,24,172
"Worthing 013E","E01031806","5-9 years","Female",40,43,46,38,44,211
"Worthing 013E","E01031806","10-14 years","Female",55,52,56,56,65,284
"Worthing 013E","E01031806","15-19 years","Female",51,50,54,52,45,252
"Worthing 013E","E01031806","20-24 years","Female",39,42,41,36,46,204
"Worthing 013E","E01031806","25-29 years","Female",40,41,45,45,42,213
"Worthing 013E","E01031806","30-34 years","Female",64,54,48,41,33,240
"Worthing 013E","E01031806","35-39 years","Female",61,66,66,64,66,323
"Worthing 013E","E01031806","40-44 years","Female",61,54,63,61,70,309
"Worthing 013E","E01031806","45-49 years","Female",67,66,60,61,59,313
"Worthing 013E","E01031806","50-54 years","Female",56,59,70,69,63,317
"Worthing 013E","E01031806","55-59 years","Female",52,53,62,71,76,314
"Worthing 013E","E01031806","60-64 years","Female",48,51,49,49,54,251
"Worthing 013E","E01031806","65-69 years","Female",48,40,48,49,57,242
"Worthing 013E","E01031806","70-74 years","Female",30,42,38,39,38,187
"Worthing 013E","E01031806","75-79 years","Female",36,29,31,32,35,163
"Worthing 013E","E01031806","80-84 years","Female",34,31,33,31,32,161
"Worthing 013E","E01031806","85+ years","Female",31,31,28,32,26,148
